,Unnamed: 0,Unnamed: 0.1,Unnamed: 0.1.1,Unnamed: 0.1.1.1,Unnamed: 0.1.1.1.1,Unnamed: 0.1.1.1.1.1,Unnamed: 0.1.1.1.1.1.1,ObjectID,VaccinationDate,County,FirstDoseDaily,FirstDoseCumulative,SecondDoseDaily,SecondDoseCumulative,SingleDoseDaily,SingleDoseCumulative,AtLeastOneDose,FullyVaccinated,FullVaccinatedCumulative,AtLeastOneDoseCumulative,TotalCumulative
0,0,0,0,0,0,0,0,1,2021-01-08 15:00:00+00:00,,8000.0,8000,,0,,0,,,0,8000,8000
1,1,1,1,1,1,1,1,2,2021-01-10 15:00:00+00:00,,1.0,8001,,0,,0,,,0,8001,8001
2,2,2,2,2,2,2,2,3,2021-01-13 15:00:00+00:00,,1.0,8002,,0,,0,,,0,8002,8002
3,3,3,3,3,3,3,3,4,2021-01-22 15:00:00+00:00,,1.0,8003,,0,,0,,,0,8003,8003
4,4,4,4,4,4,4,4,5,2021-01-26 15:00:00+00:00,,1.0,8004,,0,,0,,,0,8004,8004
5,5,5,5,5,5,5,5,6,2021-02-06 15:00:00+00:00,,1.0,8005,8000.0,8000,,0,,,8000,8005,16005
6,6,6,6,6,6,6,6,7,2021-02-09 15:00:00+00:00,,,8005,1.0,8001,,0,,,8001,8005,16006
7,7,7,7,7,7,7,7,8,2021-02-10 15:00:00+00:00,,,8005,1.0,8002,,0,,,8002,8005,16007
8,8,8,8,8,8,8,8,9,2021-02-11 15:00:00+00:00,,1.0,8006,,8002,,0,,,8002,8006,16008
9,9,9,9,9,9,9,9,10,2021-02-13 15:00:00+00:00,,1.0,8007,,8002,,0,,,8002,8007,16009
10,10,10,10,10,10,10,10,11,2021-02-19 15:00:00+00:00,,,8007,1.0,8003,,0,,,8003,8007,16010
11,11,11,11,11,11,11,11,12,2021-02-23 15:00:00+00:00,,1.0,8008,1.0,8004,,0,,,8004,8008,16012
12,12,12,12,12,12,12,12,13,2021-03-06 15:00:00+00:00,,1.0,8009,1.0,8005,,0,,,8005,8009,16014
13,13,13,13,13,13,13,13,14,2021-03-08 15:00:00+00:00,,1.0,8010,,8005,,0,,,8005,8010,16015
14,14,14,14,14,14,14,14,15,2021-03-11 15:00:00+00:00,,,8010,1.0,8006,,0,,,8006,8010,16016
15,15,15,15,15,15,15,15,16,2021-03-14 15:00:00+00:00,,1.0,8011,,8006,,0,,,8006,8011,16017
16,16,16,16,16,16,16,16,17,2021-03-15 15:00:00+00:00,,,8011,1.0,8007,,0,,,8007,8011,16018
17,17,17,17,17,17,17,17,18,2021-03-18 15:00:00+00:00,,1.0,8012,,8007,,0,,,8007,8012,16019
18,18,18,18,18,18,18,18,19,2021-03-19 15:00:00+00:00,,2.0,8014,,8007,,0,,,8007,8014,16021
19,19,19,19,19,19,19,19,20,2021-03-21 15:00:00+00:00,,1.0,8015,,8007,,0,,,8007,8015,16022
20,20,20,20,20,20,20,20,21,2021-03-22 15:00:00+00:00,,1.0,8016,,8007,,0,,,8007,8016,16023
21,21,21,21,21,21,21,21,22,2021-03-24 15:00:00+00:00,,1.0,8017,,8007,,0,,,8007,8017,16024
22,22,22,22,22,22,22,22,23,2021-03-25 15:00:00+00:00,,1.0,8018,,8007,,0,,,8007,8018,16025
23,23,23,23,23,23,23,23,24,2021-03-27 15:00:00+00:00,,,8018,1.0,8008,1.0,1,,2.0,8009,8019,16026
24,24,24,24,24,24,24,24,25,2021-03-29 15:00:00+00:00,,1.0,8019,1.0,8009,,1,,,8010,8020,16028
25,25,25,25,25,25,25,25,26,2021-03-30 15:00:00+00:00,,2.0,8021,,8009,,1,,,8010,8022,16030
26,26,26,26,26,26,26,26,27,2021-03-31 15:00:00+00:00,,1.0,8022,,8009,,1,,,8010,8023,16031
27,27,27,27,27,27,27,27,28,2021-04-01 15:00:00+00:00,,1.0,8023,,8009,,1,,,8010,8024,16032
28,28,28,28,28,28,28,28,29,2021-04-02 15:00:00+00:00,,1.0,8024,,8009,,1,,,8010,8025,16033
29,29,29,29,29,29,29,29,30,2021-04-05 15:00:00+00:00,,1.0,8025,1.0,8010,,1,,,8011,8026,16035
30,30,30,30,30,30,30,30,31,2021-04-07 15:00:00+00:00,,2.0,8027,,8010,,1,,,8011,8028,16037
31,31,31,31,31,31,31,31,32,2021-04-08 15:00:00+00:00,,,8027,1.0,8011,,1,,,8012,8028,16038
32,32,32,32,32,32,32,32,33,2021-04-09 15:00:00+00:00,,,8027,1.0,8012,1.0,2,,2.0,8014,8029,16039
33,33,33,33,33,33,33,33,34,2021-04-10 15:00:00+00:00,,1.0,8028,,8012,,2,,,8014,8030,16040
34,34,34,34,34,34,34,34,35,2021-04-11 15:00:00+00:00,,1.0,8029,1.0,8013,1.0,3,2.0,2.0,8016,8032,16042
35,35,35,35,35,35,35,35,36,2021-04-13 15:00:00+00:00,,84295.0,92324,54201.0,62214,2952.0,2955,87247.0,57153.0,65169,95279,154538
36,36,36,36,36,36,36,36,37,2021-04-14 15:00:00+00:00,,559.0,92883,11.0,62225,1.0,2956,560.0,12.0,65181,95839,155108
37,37,37,37,37,37,37,37,38,2021-04-15 15:00:00+00:00,,623.0,93506,823.0,63048,19.0,2975,642.0,842.0,66023,96481,156554
38,38,38,38,38,38,38,38,39,2021-04-16 15:00:00+00:00,,782.0,94288,1017.0,64065,8.0,2983,790.0,1025.0,67048,97271,158353
39,39,39,39,39,39,39,39,40,2021-04-17 15:00:00+00:00,,1136.0,95424,1177.0,65242,6.0,2989,1142.0,1183.0,68231,98413,160666
40,40,40,40,40,40,40,40,41,2021-04-19 15:00:00+00:00,,1370.0,96794,2004.0,67246,9.0,2998,1379.0,2013.0,70244,99792,164040
41,41,41,41,41,41,41,41,42,2021-04-20 15:00:00+00:00,,3243.0,100037,2158.0,69404,19.0,3017,3262.0,2177.0,72421,103054,169441
42,42,42,42,42,42,42,42,43,2021-04-21 15:00:00+00:00,,906.0,100943,1207.0,70611,4.0,3021,910.0,1211.0,73632,103964,171554
43,43,43,43,43,43,43,43,44,2021-04-22 15:00:00+00:00,,1019.0,101962,459.0,71070,,3021,,,74091,104983,173032
44,44,44,44,44,44,44,44,45,2021-04-23 15:00:00+00:00,,760.0,102722,632.0,71702,1.0,3022,761.0,633.0,74724,105744,174424
45,45,45,45,45,45,45,45,46,2021-04-25 15:00:00+00:00,,992.0,103714,2492.0,74194,5.0,3027,997.0,2497.0,77221,106741,177908
46,46,46,46,46,46,46,46,47,2021-04-26 15:00:00+00:00,,1484.0,105198,1674.0,75868,1.0,3028,1485.0,1675.0,78896,108226,181066
47,47,47,47,47,47,47,47,48,2021-04-27 15:00:00+00:00,,,105198,1.0,75869,,3028,,,78897,108226,181067
48,48,48,48,48,48,48,48,49,2021-04-28 15:00:00+00:00,,,105198,3.0,75872,,3028,,,78900,108226,181070
49,49,49,49,49,49,49,49,50,2021-04-29 15:00:00+00:00,,223.0,105421,866.0,76738,4.0,3032,227.0,870.0,79770,108453,182159
50,50,50,50,50,50,50,50,51,2021-04-30 15:00:00+00:00,,1.0,105422,1.0,76739,,3032,,,79771,108454,182161
51,51,51,51,51,51,51,51,52,2021-05-01 15:00:00+00:00,,1556.0,106978,1974.0,78713,15.0,3047,1571.0,1989.0,81760,110025,185691
52,52,52,52,52,52,52,52,53,2021-05-02 15:00:00+00:00,,1071.0,108049,1875.0,80588,4.0,3051,1075.0,1879.0,83639,111100,188637
53,53,53,53,53,53,53,53,54,2021-05-03 15:00:00+00:00,,403.0,108452,2166.0,82754,4.0,3055,407.0,2170.0,85809,111507,191206
54,54,54,54,54,54,54,54,55,2021-05-04 15:00:00+00:00,,28.0,108480,25.0,82779,,3055,,,85834,111535,191259
55,55,55,55,55,55,55,55,56,2021-05-05 15:00:00+00:00,,365.0,108845,816.0,83595,,3055,,,86650,111900,192440
56,56,56,56,56,56,56,56,57,2021-05-06 15:00:00+00:00,,276.0,109121,880.0,84475,3.0,3058,279.0,883.0,87533,112179,193596
57,57,57,57,57,57,57,57,58,2021-05-07 15:00:00+00:00,,274.0,109395,966.0,85441,8.0,3066,282.0,974.0,88507,112461,194836
58,58,58,58,58,58,58,58,59,2021-05-08 15:00:00+00:00,,297.0,109692,1312.0,86753,6.0,3072,303.0,1318.0,89825,112764,196445
59,59,59,59,59,59,59,59,60,2021-05-10 15:00:00+00:00,,338.0,110030,1712.0,88465,1.0,3073,339.0,1713.0,91538,113103,198495
60,60,60,60,60,60,60,60,61,2021-05-11 15:00:00+00:00,,19.0,110049,13.0,88478,,3073,,,91551,113122,198527
61,61,61,61,61,61,61,61,62,2021-05-12 15:00:00+00:00,,244.0,110293,1124.0,89602,,3073,,,92675,113366,199895
62,62,62,62,62,62,62,62,63,2021-05-14 15:00:00+00:00,,290.0,110583,1024.0,90626,2.0,3075,292.0,1026.0,93701,113658,201209
63,63,63,63,63,63,63,63,64,2021-05-15 15:00:00+00:00,,611.0,111194,1701.0,92327,4.0,3079,615.0,1705.0,95406,114273,203521
64,64,64,64,64,64,64,64,65,2021-05-17 15:00:00+00:00,,565.0,111759,2507.0,94834,11.0,3090,576.0,2518.0,97924,114849,206593
65,65,65,65,65,65,65,65,66,2021-05-18 15:00:00+00:00,,164.0,111923,61.0,94895,2.0,3092,166.0,63.0,97987,115015,206818
66,66,66,66,66,66,66,66,67,2021-05-20 15:00:00+00:00,,885.0,112808,1025.0,95920,,3092,,,99012,115900,208728
67,67,67,67,67,67,67,67,68,2021-05-21 15:00:00+00:00,,,112808,1.0,95921,,3092,,,99013,115900,208729
68,68,68,68,68,68,68,68,69,2021-05-22 15:00:00+00:00,,911.0,113719,1359.0,97280,9.0,3101,920.0,1368.0,100381,116820,210999
69,69,69,69,69,69,69,69,70,2021-05-24 15:00:00+00:00,,514.0,114233,1032.0,98312,8.0,3109,522.0,1040.0,101421,117342,212545
70,70,70,70,70,70,70,70,71,2021-05-25 15:00:00+00:00,,5.0,114238,1.0,98313,2.0,3111,7.0,3.0,101424,117349,212551
71,71,71,71,71,71,71,71,72,2021-05-27 15:00:00+00:00,,425.0,114663,674.0,98987,1.0,3112,426.0,675.0,102099,117775,213650
72,72,72,72,72,72,72,72,73,2021-05-28 15:00:00+00:00,,419.0,115082,342.0,99329,,3112,,,102441,118194,214411
73,73,73,73,73,73,73,73,74,2021-05-29 15:00:00+00:00,,267.0,115349,344.0,99673,10.0,3122,277.0,354.0,102795,118471,215022
74,74,74,74,74,74,74,74,75,2021-05-31 15:00:00+00:00,,214.0,115563,243.0,99916,3.0,3125,217.0,246.0,103041,118688,215479
75,75,75,75,75,75,75,75,76,2021-06-01 15:00:00+00:00,,30.0,115593,48.0,99964,,3125,,,103089,118718,215557
76,76,76,76,76,76,76,76,77,2021-06-16 15:00:00+00:00,,2042.0,117635,3555.0,103519,37.0,3162,2079.0,3592.0,106681,120797,221154
77,77,77,77,77,77,77,77,78,2021-06-17 15:00:00+00:00,,22.0,117657,95.0,103614,,3162,,,106776,120819,221271
78,78,78,78,78,78,78,78,79,2021-06-18 15:00:00+00:00,,269.0,117926,457.0,104071,4.0,3166,273.0,461.0,107237,121092,221997
79,79,79,79,79,79,79,79,80,2021-06-19 15:00:00+00:00,,166.0,118092,338.0,104409,1.0,3167,167.0,339.0,107576,121259,222501
80,80,80,80,80,80,80,80,81,2021-06-20 15:00:00+00:00,,161.0,118253,284.0,104693,1.0,3168,162.0,285.0,107861,121421,222946
81,81,81,81,81,81,81,81,82,2021-06-21 15:00:00+00:00,,56.0,118309,120.0,104813,1.0,3169,57.0,121.0,107982,121478,223122
82,82,82,82,82,82,82,82,83,2021-06-22 15:00:00+00:00,,15.0,118324,8.0,104821,3.0,3172,18.0,11.0,107993,121496,223145
83,83,83,83,83,83,83,83,84,2021-06-23 15:00:00+00:00,,2.0,118326,2.0,104823,,3172,,,107995,121498,223149
84,84,84,84,84,84,84,84,85,2021-06-24 15:00:00+00:00,,304.0,118630,355.0,105178,5.0,3177,309.0,360.0,108355,121807,223808
85,85,85,85,85,85,85,85,86,2021-06-25 15:00:00+00:00,,124.0,118754,209.0,105387,1.0,3178,125.0,210.0,108565,121932,224141
86,86,86,86,86,86,86,86,87,2021-06-27 15:00:00+00:00,,124.0,118878,173.0,105560,2.0,3180,126.0,175.0,108740,122058,224438
87,87,87,87,87,87,87,87,88,2021-06-28 15:00:00+00:00,,146.0,119024,186.0,105746,4.0,3184,150.0,190.0,108930,122208,224770
88,88,88,88,88,88,88,88,89,2021-06-29 15:00:00+00:00,,2.0,119026,2.0,105748,1.0,3185,3.0,3.0,108933,122211,224774
89,89,89,89,89,89,89,89,90,2021-06-30 15:00:00+00:00,,1.0,119027,,105748,,3185,,,108933,122212,224775
90,90,90,90,90,90,90,90,91,2021-07-01 15:00:00+00:00,,313.0,119340,340.0,106088,8.0,3193,321.0,348.0,109281,122533,225428
91,91,91,91,91,91,91,91,92,2021-07-02 15:00:00+00:00,,209.0,119549,249.0,106337,6.0,3199,215.0,255.0,109536,122748,225886
92,92,92,92,92,92,92,92,93,2021-07-03 15:00:00+00:00,,97.0,119646,123.0,106460,4.0,3203,101.0,127.0,109663,122849,226106
93,93,93,93,93,93,93,93,94,2021-07-04 15:00:00+00:00,,75.0,119721,98.0,106558,6.0,3209,81.0,104.0,109767,122930,226279
94,94,94,94,94,94,94,94,95,2021-07-05 15:00:00+00:00,,8.0,119729,8.0,106566,,3209,,,109775,122938,226295
95,95,95,95,95,95,95,95,96,2021-07-06 15:00:00+00:00,,18.0,119747,22.0,106588,4.0,3213,22.0,26.0,109801,122960,226335
96,96,96,96,96,96,96,96,97,2021-07-08 15:00:00+00:00,,105.0,119852,155.0,106743,5.0,3218,110.0,160.0,109961,123070,226595
97,97,97,97,97,97,97,97,98,2021-07-09 15:00:00+00:00,,136.0,119988,203.0,106946,9.0,3227,145.0,212.0,110173,123215,226934
98,98,98,98,98,98,98,98,99,2021-07-10 15:00:00+00:00,,130.0,120118,140.0,107086,4.0,3231,134.0,144.0,110317,123349,227204
99,99,99,99,99,99,99,99,100,2021-07-11 15:00:00+00:00,,145.0,120263,137.0,107223,4.0,3235,149.0,141.0,110458,123498,227486
100,100,100,100,100,100,100,100,101,2021-07-13 15:00:00+00:00,,3.0,120266,2.0,107225,,3235,,,110460,123501,227491
101,101,101,101,101,101,101,101,102,2021-07-14 15:00:00+00:00,,57.0,120323,57.0,107282,3.0,3238,60.0,60.0,110520,123561,227605
102,102,102,102,102,102,102,102,103,2021-07-15 15:00:00+00:00,,56.0,120379,90.0,107372,4.0,3242,60.0,94.0,110614,123621,227751
103,103,103,103,103,103,103,103,104,2021-07-16 15:00:00+00:00,,1012.0,121391,526.0,107898,24.0,3266,1036.0,550.0,111164,124657,229289
104,104,104,104,104,104,104,104,105,2021-07-17 15:00:00+00:00,,86.0,121477,116.0,108014,4.0,3270,90.0,120.0,111284,124747,229491
105,105,105,105,105,105,105,105,106,2021-07-18 15:00:00+00:00,,152.0,121629,219.0,108233,10.0,3280,162.0,229.0,111513,124909,229862
106,106,106,106,106,106,106,106,107,2021-07-19 15:00:00+00:00,,11.0,121640,10.0,108243,5.0,3285,16.0,15.0,111528,124925,229883
107,107,107,107,107,107,107,107,108,2021-07-20 15:00:00+00:00,,1.0,121641,,108243,,3285,,,111528,124926,229884
108,108,108,108,108,108,108,108,109,2021-07-21 15:00:00+00:00,,4.0,121645,3.0,108246,,3285,,,111531,124930,229891
109,109,109,109,109,109,109,109,110,2021-07-22 15:00:00+00:00,,27.0,121672,35.0,108281,,3285,,,111566,124957,229953
110,110,110,110,110,110,110,110,111,2021-07-23 15:00:00+00:00,,12.0,121684,13.0,108294,,3285,,,111579,124969,229978
111,111,111,111,111,111,111,111,112,2021-07-25 15:00:00+00:00,,19.0,121703,7.0,108301,,3285,,,111586,124988,230004
112,112,112,112,112,112,112,112,113,2021-07-28 15:00:00+00:00,,,121703,2.0,108303,,3285,,,111588,124988,230006
113,113,113,113,113,113,113,113,114,2021-07-29 15:00:00+00:00,,33.0,121736,11.0,108314,,3285,,,111599,125021,230050
114,114,114,114,114,114,114,114,115,2021-07-30 15:00:00+00:00,,3.0,121739,2.0,108316,,3285,,,111601,125024,230055
115,115,115,115,115,115,115,115,116,2021-07-31 15:00:00+00:00,,61.0,121800,24.0,108340,3.0,3288,64.0,27.0,111628,125088,230140
116,116,116,116,116,116,116,116,117,2021-08-01 15:00:00+00:00,,1.0,121801,,108340,,3288,,,111628,125089,230141
117,117,117,117,117,117,117,117,118,2021-08-03 15:00:00+00:00,,4.0,121805,,108340,,3288,,,111628,125093,230145
118,118,118,118,118,118,118,118,119,2021-08-05 15:00:00+00:00,,35.0,121840,15.0,108355,,3288,,,111643,125128,230195
119,119,119,119,119,119,119,119,120,2021-08-06 15:00:00+00:00,,1.0,121841,30.0,108385,,3288,,,111673,125129,230226
120,120,120,120,120,120,120,120,121,2021-08-07 15:00:00+00:00,,,121841,15.0,108400,,3288,,,111688,125129,230241
121,121,121,121,121,121,121,121,122,2021-08-08 15:00:00+00:00,,69.0,121910,26.0,108426,,3288,,,111714,125198,230336
122,122,122,122,122,122,122,122,123,2021-08-10 15:00:00+00:00,,2.0,121912,3.0,108429,,3288,,,111717,125200,230341
123,123,123,123,123,123,123,123,124,2021-08-11 15:00:00+00:00,,3.0,121915,,108429,1.0,3289,4.0,,111718,125204,230344
124,124,124,124,124,124,124,124,125,2021-08-12 15:00:00+00:00,,1948.0,123863,201.0,108630,,3289,,,111919,127152,232493
125,125,125,125,125,125,125,125,126,2021-08-13 15:00:00+00:00,,7.0,123870,5.0,108635,,3289,,,111924,127159,232505
126,126,126,126,126,126,126,126,127,2021-08-14 15:00:00+00:00,,38.0,123908,17.0,108652,,3289,,,111941,127197,232560
127,127,127,127,127,127,127,127,128,2021-08-17 15:00:00+00:00,,9.0,123917,1.0,108653,,3289,,,111942,127206,232570
128,128,128,128,128,128,128,128,129,2021-08-18 15:00:00+00:00,,1.0,123918,,108653,,3289,,,111942,127207,232571
129,129,129,129,129,129,129,129,130,2021-08-19 15:00:00+00:00,,25.0,123943,24.0,108677,1.0,3290,26.0,25.0,111967,127233,232620
130,130,130,130,130,130,130,130,131,2021-08-20 15:00:00+00:00,,21.0,123964,9.0,108686,4.0,3294,25.0,13.0,111980,127258,232650
131,131,131,131,131,131,131,131,132,2021-08-21 15:00:00+00:00,,72.0,124036,44.0,108730,,3294,,,112024,127330,232766
132,132,132,132,132,132,132,132,133,2021-08-22 15:00:00+00:00,,6.0,124042,3.0,108733,,3294,,,112027,127336,232775
133,133,133,133,133,133,133,133,134,2021-08-23 15:00:00+00:00,,1.0,124043,,108733,,3294,,,112027,127337,232776
134,134,134,134,134,134,134,134,135,2021-08-24 15:00:00+00:00,,,124043,1.0,108734,,3294,,,112028,127337,232777
135,135,135,135,135,135,135,135,136,2021-08-27 15:00:00+00:00,,28.0,124071,36.0,108770,,3294,,,112064,127365,232841
136,136,136,136,136,136,136,136,137,2021-08-28 15:00:00+00:00,,2162.0,126233,1759.0,110529,85.0,3379,2247.0,1844.0,113908,129612,236762
137,137,137,137,137,137,137,137,138,2021-08-29 15:00:00+00:00,,315.0,126548,245.0,110774,530.0,3909,845.0,775.0,114683,130457,237322
138,138,138,138,138,138,138,138,139,2021-08-30 15:00:00+00:00,,3.0,126551,10.0,110784,671.0,4580,674.0,681.0,115364,131131,237335
139,139,139,139,139,139,139,139,140,2021-08-31 15:00:00+00:00,,9.0,126560,8.0,110792,629.0,5209,638.0,637.0,116001,131769,237352
140,140,140,140,140,140,140,140,141,2021-09-01 15:00:00+00:00,,129.0,126689,119.0,110911,523.0,5732,652.0,642.0,116643,132421,237600
141,141,141,141,141,141,141,141,142,2021-09-02 15:00:00+00:00,,183.0,126872,161.0,111072,384.0,6116,567.0,545.0,117188,132988,237944
142,142,142,142,142,142,142,142,143,2021-09-03 15:00:00+00:00,,273.0,127145,166.0,111238,686.0,6802,959.0,852.0,118040,133947,238383
143,143,143,143,143,143,143,143,144,2021-09-04 15:00:00+00:00,,228.0,127373,195.0,111433,735.0,7537,963.0,930.0,118970,134910,238806
144,144,144,144,144,144,144,144,145,2021-09-07 15:00:00+00:00,,338.0,127711,237.0,111670,2008.0,9545,2346.0,2245.0,121215,137256,239381
145,145,145,145,145,145,145,145,146,2021-09-09 15:00:00+00:00,,18.0,127729,35.0,111705,,9545,,,121250,137274,239434
146,146,146,146,146,146,146,146,147,2021-09-10 15:00:00+00:00,,818.0,128547,477.0,112182,1325.0,10870,2143.0,1802.0,123052,139417,240729
147,147,147,147,147,147,147,147,148,2021-09-11 15:00:00+00:00,,422.0,128969,251.0,112433,417.0,11287,839.0,668.0,123720,140256,241402
148,148,148,148,148,148,148,148,149,2021-09-12 15:00:00+00:00,,414.0,129383,299.0,112732,352.0,11639,766.0,651.0,124371,141022,242115
149,149,149,149,149,149,149,149,150,2021-09-13 15:00:00+00:00,,199.0,129582,87.0,112819,95.0,11734,294.0,182.0,124553,141316,242401
150,150,150,150,150,150,150,150,151,2021-09-14 15:00:00+00:00,,184.0,129766,59.0,112878,100.0,11834,284.0,159.0,124712,141600,242644
151,151,151,151,151,151,151,151,152,2021-09-15 15:00:00+00:00,,320.0,130086,163.0,113041,44.0,11878,364.0,207.0,124919,141964,243127
152,152,152,152,152,152,152,152,153,2021-09-16 15:00:00+00:00,,338.0,130424,208.0,113249,44.0,11922,382.0,252.0,125171,142346,243673
153,153,153,153,153,153,153,153,154,2021-09-17 15:00:00+00:00,,375.0,130799,277.0,113526,4.0,11926,379.0,281.0,125452,142725,244325
154,154,154,154,154,154,154,154,155,2021-09-18 15:00:00+00:00,,373.0,131172,234.0,113760,54.0,11980,427.0,288.0,125740,143152,244932
155,155,155,155,155,155,155,155,156,2021-09-19 15:00:00+00:00,,420.0,131592,329.0,114089,8.0,11988,428.0,337.0,126077,143580,245681
156,156,156,156,156,156,156,156,157,2021-09-20 15:00:00+00:00,,25.0,131617,18.0,114107,171.0,12159,196.0,189.0,126266,143776,245724
157,157,157,157,157,157,157,157,158,2021-09-21 15:00:00+00:00,,13.0,131630,5.0,114112,63.0,12222,76.0,68.0,126334,143852,245742
158,158,158,158,158,158,158,158,159,2021-09-22 15:00:00+00:00,,279.0,131909,182.0,114294,186.0,12408,465.0,368.0,126702,144317,246203
159,159,159,159,159,159,159,159,160,2021-09-23 15:00:00+00:00,,341.0,132250,224.0,114518,247.0,12655,588.0,471.0,127173,144905,246768
160,160,160,160,160,160,160,160,161,2021-09-24 15:00:00+00:00,,360.0,132610,316.0,114834,148.0,12803,508.0,464.0,127637,145413,247444
161,161,161,161,161,161,161,161,162,2021-09-25 15:00:00+00:00,,396.0,133006,287.0,115121,316.0,13119,712.0,603.0,128240,146125,248127
162,162,162,162,162,162,162,162,163,2021-09-26 15:00:00+00:00,,244.0,133250,242.0,115363,367.0,13486,611.0,609.0,128849,146736,248613
163,163,163,163,163,163,163,163,164,2021-09-27 15:00:00+00:00,,7.0,133257,9.0,115372,273.0,13759,280.0,282.0,129131,147016,248629
164,164,164,164,164,164,164,164,165,2021-09-29 15:00:00+00:00,,253.0,133510,211.0,115583,655.0,14414,908.0,866.0,129997,147924,249093
165,165,165,165,165,165,165,165,166,2021-09-30 15:00:00+00:00,,311.0,133821,222.0,115805,545.0,14959,856.0,767.0,130764,148780,249626
166,166,166,166,166,166,166,166,167,2021-10-01 15:00:00+00:00,,238.0,134059,276.0,116081,494.0,15453,732.0,770.0,131534,149512,250140
167,167,167,167,167,167,167,167,168,2021-10-02 15:00:00+00:00,,22.0,134081,22.0,116103,88.0,15541,110.0,110.0,131644,149622,250184
168,168,168,168,168,168,168,168,169,2021-10-03 15:00:00+00:00,,,134081,1.0,116104,1.0,15542,,2.0,131646,149623,250185
169,169,169,169,169,169,169,169,170,2021-10-05 15:00:00+00:00,,,134081,1.0,116105,,15542,,,131647,149623,250186
170,170,170,170,170,170,170,170,171,2021-10-06 15:00:00+00:00,,,134081,8.0,116113,9.0,15551,,17.0,131664,149632,250194
171,171,171,171,171,171,171,171,172,2021-10-07 15:00:00+00:00,,18.0,134099,26.0,116139,87.0,15638,105.0,113.0,131777,149737,250238
172,172,172,172,172,172,172,172,173,2021-10-08 15:00:00+00:00,,7.0,134106,6.0,116145,20.0,15658,27.0,26.0,131803,149764,250251
173,173,173,173,173,173,173,173,174,2021-10-09 15:00:00+00:00,,21.0,134127,32.0,116177,154.0,15812,175.0,186.0,131989,149939,250304
174,174,174,174,174,174,174,174,175,2021-10-10 15:00:00+00:00,,2.0,134129,1.0,116178,16.0,15828,18.0,17.0,132006,149957,250307
175,175,175,175,175,175,175,175,176,2021-10-14 15:00:00+00:00,,1364.0,135493,2089.0,118267,158.0,15986,1522.0,2247.0,134253,151479,253760
176,176,176,176,176,176,176,176,177,2021-10-15 15:00:00+00:00,,371.0,135864,606.0,118873,23.0,16009,394.0,629.0,134882,151873,254737
177,177,177,177,177,177,177,177,178,2021-10-16 15:00:00+00:00,,206.0,136070,253.0,119126,156.0,16165,362.0,409.0,135291,152235,255196
178,178,178,178,178,178,178,178,179,2021-10-17 15:00:00+00:00,,278.0,136348,290.0,119416,12.0,16177,290.0,302.0,135593,152525,255764
179,179,179,179,179,179,179,179,180,2021-10-18 15:00:00+00:00,,75.0,136423,88.0,119504,,16177,,,135681,152600,255927
180,180,180,180,180,180,180,180,181,2021-10-19 15:00:00+00:00,,941.0,137364,972.0,120476,5.0,16182,946.0,977.0,136658,153546,257840
181,181,181,181,181,181,181,181,182,2021-10-20 15:00:00+00:00,,246.0,137610,248.0,120724,13.0,16195,259.0,261.0,136919,153805,258334
182,182,182,182,182,182,182,182,183,2021-10-22 15:00:00+00:00,,247.0,137857,408.0,121132,194.0,16389,441.0,602.0,137521,154246,258989
183,183,183,183,183,183,183,183,184,2021-10-23 15:00:00+00:00,,154.0,138011,168.0,121300,188.0,16577,342.0,356.0,137877,154588,259311
184,184,184,184,184,184,184,184,185,2021-10-24 15:00:00+00:00,,184.0,138195,210.0,121510,11.0,16588,195.0,221.0,138098,154783,259705
185,185,185,185,185,185,185,185,186,2021-10-25 15:00:00+00:00,,8.0,138203,12.0,121522,,16588,,,138110,154791,259725
186,186,186,186,186,186,186,186,187,2021-10-26 15:00:00+00:00,,4.0,138207,10.0,121532,,16588,,,138120,154795,259739
187,187,187,187,187,187,187,187,188,2021-10-27 15:00:00+00:00,,182.0,138389,196.0,121728,5.0,16593,187.0,201.0,138321,154982,260117
188,188,188,188,188,188,188,188,189,2021-10-28 15:00:00+00:00,,150.0,138539,187.0,121915,168.0,16761,318.0,355.0,138676,155300,260454
189,189,189,189,189,189,189,189,190,2021-10-29 15:00:00+00:00,,314.0,138853,382.0,122297,14.0,16775,328.0,396.0,139072,155628,261150
190,190,190,190,190,190,190,190,191,2021-10-30 15:00:00+00:00,,20.0,138873,17.0,122314,159.0,16934,179.0,176.0,139248,155807,261187
191,191,191,191,191,191,191,191,192,2021-10-31 15:00:00+00:00,,141.0,139014,201.0,122515,17.0,16951,158.0,218.0,139466,155965,261529
192,192,192,192,192,192,192,192,193,2021-11-01 15:00:00+00:00,,147.0,139161,185.0,122700,2.0,16953,149.0,187.0,139653,156114,261861
193,193,193,193,193,193,193,193,194,2021-11-02 15:00:00+00:00,,4.0,139165,11.0,122711,2.0,16955,6.0,13.0,139666,156120,261876
194,194,194,194,194,194,194,194,195,2021-11-03 15:00:00+00:00,,89.0,139254,88.0,122799,1.0,16956,90.0,89.0,139755,156210,262053
195,195,195,195,195,195,195,195,196,2021-11-04 15:00:00+00:00,,169.0,139423,201.0,123000,165.0,17121,334.0,366.0,140121,156544,262423
196,196,196,196,196,196,196,196,197,2021-11-05 15:00:00+00:00,,103.0,139526,170.0,123170,18.0,17139,121.0,188.0,140309,156665,262696
197,197,197,197,197,197,197,197,198,2021-11-06 15:00:00+00:00,,138.0,139664,170.0,123340,145.0,17284,283.0,315.0,140624,156948,263004
198,198,198,198,198,198,198,198,199,2020-12-18 15:00:00+00:00,Allegany,4.0,4,,0,,0,,,0,4,4
199,199,199,199,199,199,199,199,200,2020-12-20 15:00:00+00:00,Allegany,1.0,5,,0,,0,,,0,5,5
200,200,200,200,200,200,200,200,201,2020-12-21 15:00:00+00:00,Allegany,22.0,27,,0,,0,,,0,27,27
201,201,201,201,201,201,201,201,202,2020-12-22 15:00:00+00:00,Allegany,56.0,83,,0,,0,,,0,83,83
202,202,202,202,202,202,202,202,203,2020-12-23 15:00:00+00:00,Allegany,114.0,197,,0,,0,,,0,197,197
203,203,203,203,203,203,203,203,204,2020-12-24 15:00:00+00:00,Allegany,2.0,199,,0,,0,,,0,199,199
204,204,204,204,204,204,204,204,205,2020-12-27 15:00:00+00:00,Allegany,1.0,200,,0,,0,,,0,200,200
205,205,205,205,205,205,205,205,206,2020-12-28 15:00:00+00:00,Allegany,212.0,412,,0,,0,,,0,412,412
206,206,206,206,206,206,206,206,207,2020-12-29 15:00:00+00:00,Allegany,216.0,628,,0,,0,,,0,628,628
207,207,207,207,207,207,207,207,208,2020-12-30 15:00:00+00:00,Allegany,282.0,910,1.0,1,,0,,,1,910,911
208,208,208,208,208,208,208,208,209,2020-12-31 15:00:00+00:00,Allegany,2.0,912,,1,,0,,,1,912,913
209,209,209,209,209,209,209,209,210,2021-01-01 15:00:00+00:00,Allegany,4.0,916,1.0,2,,0,,,2,916,918
210,210,210,210,210,210,210,210,211,2021-01-02 15:00:00+00:00,Allegany,2.0,918,,2,,0,,,2,918,920
211,211,211,211,211,211,211,211,212,2021-01-04 15:00:00+00:00,Allegany,172.0,1090,2.0,4,,0,,,4,1090,1094
212,212,212,212,212,212,212,212,213,2021-01-05 15:00:00+00:00,Allegany,266.0,1356,,4,,0,,,4,1356,1360
213,213,213,213,213,213,213,213,214,2021-01-06 15:00:00+00:00,Allegany,194.0,1550,,4,,0,,,4,1550,1554
214,214,214,214,214,214,214,214,215,2021-01-07 15:00:00+00:00,Allegany,253.0,1803,,4,,0,,,4,1803,1807
215,215,215,215,215,215,215,215,216,2021-01-08 15:00:00+00:00,Allegany,155.0,1958,5.0,9,,0,,,9,1958,1967
216,216,216,216,216,216,216,216,217,2021-01-09 15:00:00+00:00,Allegany,109.0,2067,1.0,10,,0,,,10,2067,2077
217,217,217,217,217,217,217,217,218,2021-01-10 15:00:00+00:00,Allegany,1.0,2068,,10,,0,,,10,2068,2078
218,218,218,218,218,218,218,218,219,2021-01-11 15:00:00+00:00,Allegany,286.0,2354,4.0,14,,0,,,14,2354,2368
219,219,219,219,219,219,219,219,220,2021-01-12 15:00:00+00:00,Allegany,437.0,2791,4.0,18,,0,,,18,2791,2809
220,220,220,220,220,220,220,220,221,2021-01-13 15:00:00+00:00,Allegany,212.0,3003,5.0,23,,0,,,23,3003,3026
221,221,221,221,221,221,221,221,222,2021-01-14 15:00:00+00:00,Allegany,330.0,3333,2.0,25,,0,,,25,3333,3358
222,222,222,222,222,222,222,222,223,2021-01-15 15:00:00+00:00,Allegany,320.0,3653,3.0,28,,0,,,28,3653,3681
223,223,223,223,223,223,223,223,224,2021-01-16 15:00:00+00:00,Allegany,9.0,3662,,28,,0,,,28,3662,3690
224,224,224,224,224,224,224,224,225,2021-01-17 15:00:00+00:00,Allegany,1.0,3663,1.0,29,,0,,,29,3663,3692
225,225,225,225,225,225,225,225,226,2021-01-18 15:00:00+00:00,Allegany,2.0,3665,17.0,46,,0,,,46,3665,3711
226,226,226,226,226,226,226,226,227,2021-01-19 15:00:00+00:00,Allegany,350.0,4015,192.0,238,,0,,,238,4015,4253
227,227,227,227,227,227,227,227,228,2021-01-20 15:00:00+00:00,Allegany,308.0,4323,163.0,401,,0,,,401,4323,4724
228,228,228,228,228,228,228,228,229,2021-01-21 15:00:00+00:00,Allegany,672.0,4995,5.0,406,,0,,,406,4995,5401
229,229,229,229,229,229,229,229,230,2021-01-22 15:00:00+00:00,Allegany,398.0,5393,4.0,410,,0,,,410,5393,5803
230,230,230,230,230,230,230,230,231,2021-01-23 15:00:00+00:00,Allegany,97.0,5490,2.0,412,,0,,,412,5490,5902
231,231,231,231,231,231,231,231,232,2021-01-24 15:00:00+00:00,Allegany,24.0,5514,2.0,414,,0,,,414,5514,5928
232,232,232,232,232,232,232,232,233,2021-01-25 15:00:00+00:00,Allegany,332.0,5846,210.0,624,,0,,,624,5846,6470
233,233,233,233,233,233,233,233,234,2021-01-26 15:00:00+00:00,Allegany,93.0,5939,161.0,785,,0,,,785,5939,6724
234,234,234,234,234,234,234,234,235,2021-01-27 15:00:00+00:00,Allegany,422.0,6361,272.0,1057,,0,,,1057,6361,7418
235,235,235,235,235,235,235,235,236,2021-01-28 15:00:00+00:00,Allegany,825.0,7186,11.0,1068,,0,,,1068,7186,8254
236,236,236,236,236,236,236,236,237,2021-01-29 15:00:00+00:00,Allegany,928.0,8114,147.0,1215,,0,,,1215,8114,9329
237,237,237,237,237,237,237,237,238,2021-01-30 15:00:00+00:00,Allegany,5.0,8119,1.0,1216,,0,,,1216,8119,9335
238,238,238,238,238,238,238,238,239,2021-01-31 15:00:00+00:00,Allegany,1.0,8120,2.0,1218,,0,,,1218,8120,9338
239,239,239,239,239,239,239,239,240,2021-02-01 15:00:00+00:00,Allegany,42.0,8162,190.0,1408,,0,,,1408,8162,9570
240,240,240,240,240,240,240,240,241,2021-02-02 15:00:00+00:00,Allegany,398.0,8560,360.0,1768,,0,,,1768,8560,10328
241,241,241,241,241,241,241,241,242,2021-02-03 15:00:00+00:00,Allegany,67.0,8627,192.0,1960,,0,,,1960,8627,10587
242,242,242,242,242,242,242,242,243,2021-02-04 15:00:00+00:00,Allegany,159.0,8786,294.0,2254,,0,,,2254,8786,11040
243,243,243,243,243,243,243,243,244,2021-02-05 15:00:00+00:00,Allegany,228.0,9014,110.0,2364,,0,,,2364,9014,11378
244,244,244,244,244,244,244,244,245,2021-02-06 15:00:00+00:00,Allegany,7.0,9021,3.0,2367,,0,,,2367,9021,11388
245,245,245,245,245,245,245,245,246,2021-02-07 15:00:00+00:00,Allegany,2.0,9023,,2367,,0,,,2367,9023,11390
246,246,246,246,246,246,246,246,247,2021-02-08 15:00:00+00:00,Allegany,110.0,9133,133.0,2500,,0,,,2500,9133,11633
247,247,247,247,247,247,247,247,248,2021-02-09 15:00:00+00:00,Allegany,305.0,9438,192.0,2692,,0,,,2692,9438,12130
248,248,248,248,248,248,248,248,249,2021-02-10 15:00:00+00:00,Allegany,152.0,9590,212.0,2904,,0,,,2904,9590,12494
249,249,249,249,249,249,249,249,250,2021-02-11 15:00:00+00:00,Allegany,84.0,9674,5.0,2909,,0,,,2909,9674,12583
250,250,250,250,250,250,250,250,251,2021-02-12 15:00:00+00:00,Allegany,317.0,9991,556.0,3465,,0,,,3465,9991,13456
251,251,251,251,251,251,251,251,252,2021-02-13 15:00:00+00:00,Allegany,56.0,10047,72.0,3537,,0,,,3537,10047,13584
252,252,252,252,252,252,252,252,253,2021-02-14 15:00:00+00:00,Allegany,5.0,10052,16.0,3553,,0,,,3553,10052,13605
253,253,253,253,253,253,253,253,254,2021-02-15 15:00:00+00:00,Allegany,58.0,10110,55.0,3608,,0,,,3608,10110,13718
254,254,254,254,254,254,254,254,255,2021-02-16 15:00:00+00:00,Allegany,122.0,10232,288.0,3896,,0,,,3896,10232,14128
255,255,255,255,255,255,255,255,256,2021-02-17 15:00:00+00:00,Allegany,68.0,10300,915.0,4811,,0,,,4811,10300,15111
256,256,256,256,256,256,256,256,257,2021-02-18 15:00:00+00:00,Allegany,25.0,10325,114.0,4925,,0,,,4925,10325,15250
257,257,257,257,257,257,257,257,258,2021-02-19 15:00:00+00:00,Allegany,32.0,10357,1028.0,5953,,0,,,5953,10357,16310
258,258,258,258,258,258,258,258,259,2021-02-20 15:00:00+00:00,Allegany,7.0,10364,16.0,5969,,0,,,5969,10364,16333
259,259,259,259,259,259,259,259,260,2021-02-21 15:00:00+00:00,Allegany,7.0,10371,26.0,5995,,0,,,5995,10371,16366
260,260,260,260,260,260,260,260,261,2021-02-22 15:00:00+00:00,Allegany,160.0,10531,672.0,6667,,0,,,6667,10531,17198
261,261,261,261,261,261,261,261,262,2021-02-23 15:00:00+00:00,Allegany,333.0,10864,53.0,6720,,0,,,6720,10864,17584
262,262,262,262,262,262,262,262,263,2021-02-24 15:00:00+00:00,Allegany,68.0,10932,418.0,7138,,0,,,7138,10932,18070
263,263,263,263,263,263,263,263,264,2021-02-25 15:00:00+00:00,Allegany,108.0,11040,382.0,7520,,0,,,7520,11040,18560
264,264,264,264,264,264,264,264,265,2021-02-26 15:00:00+00:00,Allegany,63.0,11103,424.0,7944,,0,,,7944,11103,19047
265,265,265,265,265,265,265,265,266,2021-02-27 15:00:00+00:00,Allegany,31.0,11134,1.0,7945,,0,,,7945,11134,19079
266,266,266,266,266,266,266,266,267,2021-02-28 15:00:00+00:00,Allegany,67.0,11201,59.0,8004,,0,,,8004,11201,19205
267,267,267,267,267,267,267,267,268,2021-03-01 15:00:00+00:00,Allegany,75.0,11276,35.0,8039,,0,,,8039,11276,19315
268,268,268,268,268,268,268,268,269,2021-03-02 15:00:00+00:00,Allegany,147.0,11423,554.0,8593,,0,,,8593,11423,20016
269,269,269,269,269,269,269,269,270,2021-03-03 15:00:00+00:00,Allegany,100.0,11523,46.0,8639,,0,,,8639,11523,20162
270,270,270,270,270,270,270,270,271,2021-03-04 15:00:00+00:00,Allegany,544.0,12067,139.0,8778,1.0,1,545.0,140.0,8779,12068,20845
271,271,271,271,271,271,271,271,272,2021-03-05 15:00:00+00:00,Allegany,465.0,12532,369.0,9147,314.0,315,779.0,683.0,9462,12847,21679
272,272,272,272,272,272,272,272,273,2021-03-06 15:00:00+00:00,Allegany,28.0,12560,9.0,9156,2.0,317,30.0,11.0,9473,12877,21716
273,273,273,273,273,273,273,273,274,2021-03-07 15:00:00+00:00,Allegany,44.0,12604,24.0,9180,2.0,319,46.0,26.0,9499,12923,21784
274,274,274,274,274,274,274,274,275,2021-03-08 15:00:00+00:00,Allegany,91.0,12695,15.0,9195,4.0,323,95.0,19.0,9518,13018,21890
275,275,275,275,275,275,275,275,276,2021-03-09 15:00:00+00:00,Allegany,191.0,12886,66.0,9261,23.0,346,214.0,89.0,9607,13232,22147
276,276,276,276,276,276,276,276,277,2021-03-10 15:00:00+00:00,Allegany,139.0,13025,122.0,9383,1.0,347,140.0,123.0,9730,13372,22408
277,277,277,277,277,277,277,277,278,2021-03-11 15:00:00+00:00,Allegany,1052.0,14077,100.0,9483,1.0,348,1053.0,101.0,9831,14425,23560
278,278,278,278,278,278,278,278,279,2021-03-12 15:00:00+00:00,Allegany,486.0,14563,188.0,9671,2.0,350,488.0,190.0,10021,14913,24234
279,279,279,279,279,279,279,279,280,2021-03-13 15:00:00+00:00,Allegany,17.0,14580,19.0,9690,2.0,352,19.0,21.0,10042,14932,24270
280,280,280,280,280,280,280,280,281,2021-03-14 15:00:00+00:00,Allegany,7.0,14587,48.0,9738,1.0,353,8.0,49.0,10091,14940,24325
281,281,281,281,281,281,281,281,282,2021-03-15 15:00:00+00:00,Allegany,79.0,14666,47.0,9785,,353,,,10138,15019,24451
282,282,282,282,282,282,282,282,283,2021-03-16 15:00:00+00:00,Allegany,83.0,14749,109.0,9894,54.0,407,137.0,163.0,10301,15156,24643
283,283,283,283,283,283,283,283,284,2021-03-17 15:00:00+00:00,Allegany,60.0,14809,46.0,9940,,407,,,10347,15216,24749
284,284,284,284,284,284,284,284,285,2021-03-18 15:00:00+00:00,Allegany,822.0,15631,44.0,9984,33.0,440,855.0,77.0,10424,16071,25615
285,285,285,285,285,285,285,285,286,2021-03-19 15:00:00+00:00,Allegany,498.0,16129,38.0,10022,1.0,441,499.0,39.0,10463,16570,26151
286,286,286,286,286,286,286,286,287,2021-03-20 15:00:00+00:00,Allegany,15.0,16144,3.0,10025,3.0,444,18.0,6.0,10469,16588,26169
287,287,287,287,287,287,287,287,288,2021-03-21 15:00:00+00:00,Allegany,47.0,16191,20.0,10045,3.0,447,50.0,23.0,10492,16638,26236
288,288,288,288,288,288,288,288,289,2021-03-22 15:00:00+00:00,Allegany,48.0,16239,35.0,10080,9.0,456,57.0,44.0,10536,16695,26319
289,289,289,289,289,289,289,289,290,2021-03-23 15:00:00+00:00,Allegany,169.0,16408,463.0,10543,50.0,506,219.0,513.0,11049,16914,26951
290,290,290,290,290,290,290,290,291,2021-03-24 15:00:00+00:00,Allegany,104.0,16512,82.0,10625,15.0,521,119.0,97.0,11146,17033,27137
291,291,291,291,291,291,291,291,292,2021-03-25 15:00:00+00:00,Allegany,275.0,16787,75.0,10700,54.0,575,329.0,129.0,11275,17362,27487
292,292,292,292,292,292,292,292,293,2021-03-26 15:00:00+00:00,Allegany,1074.0,17861,66.0,10766,8.0,583,1082.0,74.0,11349,18444,28627
293,293,293,293,293,293,293,293,294,2021-03-27 15:00:00+00:00,Allegany,6.0,17867,10.0,10776,9.0,592,15.0,19.0,11368,18459,28643
294,294,294,294,294,294,294,294,295,2021-03-28 15:00:00+00:00,Allegany,38.0,17905,66.0,10842,14.0,606,52.0,80.0,11448,18511,28747
295,295,295,295,295,295,295,295,296,2021-03-29 15:00:00+00:00,Allegany,30.0,17935,81.0,10923,7.0,613,37.0,88.0,11536,18548,28858
296,296,296,296,296,296,296,296,297,2021-03-30 15:00:00+00:00,Allegany,252.0,18187,112.0,11035,24.0,637,276.0,136.0,11672,18824,29222
297,297,297,297,297,297,297,297,298,2021-03-31 15:00:00+00:00,Allegany,699.0,18886,86.0,11121,26.0,663,725.0,112.0,11784,19549,30007
298,298,298,298,298,298,298,298,299,2021-04-01 15:00:00+00:00,Allegany,194.0,19080,519.0,11640,64.0,727,258.0,583.0,12367,19807,30720
299,299,299,299,299,299,299,299,300,2021-04-02 15:00:00+00:00,Allegany,751.0,19831,454.0,12094,38.0,765,789.0,492.0,12859,20596,31925
300,300,300,300,300,300,300,300,301,2021-04-03 15:00:00+00:00,Allegany,23.0,19854,15.0,12109,27.0,792,50.0,42.0,12901,20646,31963
301,301,301,301,301,301,301,301,302,2021-04-04 15:00:00+00:00,Allegany,97.0,19951,48.0,12157,3.0,795,100.0,51.0,12952,20746,32108
302,302,302,302,302,302,302,302,303,2021-04-05 15:00:00+00:00,Allegany,98.0,20049,75.0,12232,17.0,812,115.0,92.0,13044,20861,32281
303,303,303,303,303,303,303,303,304,2021-04-06 15:00:00+00:00,Allegany,36.0,20085,184.0,12416,109.0,921,145.0,293.0,13337,21006,32501
304,304,304,304,304,304,304,304,305,2021-04-07 15:00:00+00:00,Allegany,580.0,20665,145.0,12561,74.0,995,654.0,219.0,13556,21660,33226
305,305,305,305,305,305,305,305,306,2021-04-08 15:00:00+00:00,Allegany,214.0,20879,1025.0,13586,90.0,1085,304.0,1115.0,14671,21964,34465
306,306,306,306,306,306,306,306,307,2021-04-09 15:00:00+00:00,Allegany,89.0,20968,472.0,14058,779.0,1864,868.0,1251.0,15922,22832,35026
307,307,307,307,307,307,307,307,308,2021-04-10 15:00:00+00:00,Allegany,9.0,20977,37.0,14095,68.0,1932,77.0,105.0,16027,22909,35072
308,308,308,308,308,308,308,308,309,2021-04-11 15:00:00+00:00,Allegany,29.0,21006,12.0,14107,73.0,2005,102.0,85.0,16112,23011,35113
309,309,309,309,309,309,309,309,310,2021-04-12 15:00:00+00:00,Allegany,86.0,21092,65.0,14172,87.0,2092,173.0,152.0,16264,23184,35264
310,310,310,310,310,310,310,310,311,2021-04-13 15:00:00+00:00,Allegany,73.0,21165,162.0,14334,10.0,2102,83.0,172.0,16436,23267,35499
311,311,311,311,311,311,311,311,312,2021-04-14 15:00:00+00:00,Allegany,368.0,21533,81.0,14415,,2102,,,16517,23635,35948
312,312,312,312,312,312,312,312,313,2021-04-15 15:00:00+00:00,Allegany,188.0,21721,787.0,15202,,2102,,,17304,23823,36923
313,313,313,313,313,313,313,313,314,2021-04-16 15:00:00+00:00,Allegany,504.0,22225,486.0,15688,,2102,,,17790,24327,37913
314,314,314,314,314,314,314,314,315,2021-04-17 15:00:00+00:00,Allegany,16.0,22241,6.0,15694,,2102,,,17796,24343,37935
315,315,315,315,315,315,315,315,316,2021-04-18 15:00:00+00:00,Allegany,43.0,22284,8.0,15702,,2102,,,17804,24386,37986
316,316,316,316,316,316,316,316,317,2021-04-19 15:00:00+00:00,Allegany,109.0,22393,75.0,15777,,2102,,,17879,24495,38170
317,317,317,317,317,317,317,317,318,2021-04-20 15:00:00+00:00,Allegany,77.0,22470,239.0,16016,,2102,,,18118,24572,38486
318,318,318,318,318,318,318,318,319,2021-04-21 15:00:00+00:00,Allegany,205.0,22675,238.0,16254,,2102,,,18356,24777,38929
319,319,319,319,319,319,319,319,320,2021-04-22 15:00:00+00:00,Allegany,189.0,22864,380.0,16634,,2102,,,18736,24966,39498
320,320,320,320,320,320,320,320,321,2020-12-14 15:00:00+00:00,Anne Arundel,2.0,2,,0,,0,,,0,2,2
321,321,321,321,321,321,321,321,322,2020-12-15 15:00:00+00:00,Anne Arundel,4.0,6,,0,,0,,,0,6,6
322,322,322,322,322,322,322,322,323,2020-12-16 15:00:00+00:00,Anne Arundel,56.0,62,,0,,0,,,0,62,62
323,323,323,323,323,323,323,323,324,2020-12-17 15:00:00+00:00,Anne Arundel,105.0,167,,0,,0,,,0,167,167
324,324,324,324,324,324,324,324,325,2020-12-18 15:00:00+00:00,Anne Arundel,177.0,344,,0,,0,,,0,344,344
325,325,325,325,325,325,325,325,326,2020-12-19 15:00:00+00:00,Anne Arundel,43.0,387,,0,,0,,,0,387,387
326,326,326,326,326,326,326,326,327,2020-12-20 15:00:00+00:00,Anne Arundel,9.0,396,,0,,0,,,0,396,396
327,327,327,327,327,327,327,327,328,2020-12-21 15:00:00+00:00,Anne Arundel,290.0,686,,0,,0,,,0,686,686
328,328,328,328,328,328,328,328,329,2020-12-22 15:00:00+00:00,Anne Arundel,409.0,1095,2.0,2,,0,,,2,1095,1097
329,329,329,329,329,329,329,329,330,2020-12-23 15:00:00+00:00,Anne Arundel,382.0,1477,1.0,3,,0,,,3,1477,1480
330,330,330,330,330,330,330,330,331,2020-12-24 15:00:00+00:00,Anne Arundel,245.0,1722,3.0,6,,0,,,6,1722,1728
331,331,331,331,331,331,331,331,332,2020-12-25 15:00:00+00:00,Anne Arundel,31.0,1753,1.0,7,,0,,,7,1753,1760
332,332,332,332,332,332,332,332,333,2020-12-26 15:00:00+00:00,Anne Arundel,278.0,2031,1.0,8,,0,,,8,2031,2039
333,333,333,333,333,333,333,333,334,2020-12-27 15:00:00+00:00,Anne Arundel,101.0,2132,,8,,0,,,8,2132,2140
334,334,334,334,334,334,334,334,335,2020-12-28 15:00:00+00:00,Anne Arundel,757.0,2889,2.0,10,,0,,,10,2889,2899
335,335,335,335,335,335,335,335,336,2020-12-29 15:00:00+00:00,Anne Arundel,825.0,3714,3.0,13,,0,,,13,3714,3727
336,336,336,336,336,336,336,336,337,2020-12-30 15:00:00+00:00,Anne Arundel,864.0,4578,5.0,18,,0,,,18,4578,4596
337,337,337,337,337,337,337,337,338,2020-12-31 15:00:00+00:00,Anne Arundel,577.0,5155,3.0,21,,0,,,21,5155,5176
338,338,338,338,338,338,338,338,339,2021-01-01 15:00:00+00:00,Anne Arundel,232.0,5387,9.0,30,,0,,,30,5387,5417
339,339,339,339,339,339,339,339,340,2021-01-02 15:00:00+00:00,Anne Arundel,151.0,5538,2.0,32,,0,,,32,5538,5570
340,340,340,340,340,340,340,340,341,2021-01-03 15:00:00+00:00,Anne Arundel,213.0,5751,1.0,33,,0,,,33,5751,5784
341,341,341,341,341,341,341,341,342,2021-01-04 15:00:00+00:00,Anne Arundel,1210.0,6961,18.0,51,,0,,,51,6961,7012
342,342,342,342,342,342,342,342,343,2021-01-05 15:00:00+00:00,Anne Arundel,906.0,7867,21.0,72,,0,,,72,7867,7939
343,343,343,343,343,343,343,343,344,2021-01-06 15:00:00+00:00,Anne Arundel,1247.0,9114,72.0,144,,0,,,144,9114,9258
344,344,344,344,344,344,344,344,345,2021-01-07 15:00:00+00:00,Anne Arundel,1449.0,10563,116.0,260,,0,,,260,10563,10823
345,345,345,345,345,345,345,345,346,2021-01-08 15:00:00+00:00,Anne Arundel,1703.0,12266,188.0,448,,0,,,448,12266,12714
346,346,346,346,346,346,346,346,347,2021-01-09 15:00:00+00:00,Anne Arundel,321.0,12587,53.0,501,,0,,,501,12587,13088
347,347,347,347,347,347,347,347,348,2021-01-10 15:00:00+00:00,Anne Arundel,444.0,13031,17.0,518,,0,,,518,13031,13549
348,348,348,348,348,348,348,348,349,2021-01-11 15:00:00+00:00,Anne Arundel,1384.0,14415,290.0,808,,0,,,808,14415,15223
349,349,349,349,349,349,349,349,350,2021-01-12 15:00:00+00:00,Anne Arundel,1588.0,16003,402.0,1210,,0,,,1210,16003,17213
350,350,350,350,350,350,350,350,351,2021-01-13 15:00:00+00:00,Anne Arundel,1514.0,17517,302.0,1512,,0,,,1512,17517,19029
351,351,351,351,351,351,351,351,352,2021-01-14 15:00:00+00:00,Anne Arundel,1406.0,18923,113.0,1625,,0,,,1625,18923,20548
352,352,352,352,352,352,352,352,353,2021-01-15 15:00:00+00:00,Anne Arundel,1654.0,20577,108.0,1733,,0,,,1733,20577,22310
353,353,353,353,353,353,353,353,354,2021-01-16 15:00:00+00:00,Anne Arundel,510.0,21087,140.0,1873,,0,,,1873,21087,22960
354,354,354,354,354,354,354,354,355,2021-01-17 15:00:00+00:00,Anne Arundel,266.0,21353,145.0,2018,,0,,,2018,21353,23371
355,355,355,355,355,355,355,355,356,2021-01-18 15:00:00+00:00,Anne Arundel,1536.0,22889,403.0,2421,,0,,,2421,22889,25310
356,356,356,356,356,356,356,356,357,2021-01-19 15:00:00+00:00,Anne Arundel,2161.0,25050,588.0,3009,,0,,,3009,25050,28059
357,357,357,357,357,357,357,357,358,2021-01-20 15:00:00+00:00,Anne Arundel,2053.0,27103,488.0,3497,,0,,,3497,27103,30600
358,358,358,358,358,358,358,358,359,2021-01-21 15:00:00+00:00,Anne Arundel,2282.0,29385,437.0,3934,,0,,,3934,29385,33319
359,359,359,359,359,359,359,359,360,2021-01-22 15:00:00+00:00,Anne Arundel,2134.0,31519,347.0,4281,,0,,,4281,31519,35800
360,360,360,360,360,360,360,360,361,2021-01-23 15:00:00+00:00,Anne Arundel,658.0,32177,79.0,4360,,0,,,4360,32177,36537
361,361,361,361,361,361,361,361,362,2021-01-24 15:00:00+00:00,Anne Arundel,531.0,32708,52.0,4412,,0,,,4412,32708,37120
362,362,362,362,362,362,362,362,363,2021-01-25 15:00:00+00:00,Anne Arundel,1520.0,34228,928.0,5340,,0,,,5340,34228,39568
363,363,363,363,363,363,363,363,364,2021-01-26 15:00:00+00:00,Anne Arundel,1564.0,35792,886.0,6226,,0,,,6226,35792,42018
364,364,364,364,364,364,364,364,365,2021-01-27 15:00:00+00:00,Anne Arundel,1883.0,37675,958.0,7184,,0,,,7184,37675,44859
365,365,365,365,365,365,365,365,366,2021-01-28 15:00:00+00:00,Anne Arundel,1810.0,39485,785.0,7969,,0,,,7969,39485,47454
366,366,366,366,366,366,366,366,367,2021-01-29 15:00:00+00:00,Anne Arundel,1783.0,41268,926.0,8895,,0,,,8895,41268,50163
367,367,367,367,367,367,367,367,368,2021-01-30 15:00:00+00:00,Anne Arundel,1125.0,42393,150.0,9045,,0,,,9045,42393,51438
368,368,368,368,368,368,368,368,369,2021-01-31 15:00:00+00:00,Anne Arundel,408.0,42801,298.0,9343,,0,,,9343,42801,52144
369,369,369,369,369,369,369,369,370,2021-02-01 15:00:00+00:00,Anne Arundel,741.0,43542,343.0,9686,,0,,,9686,43542,53228
370,370,370,370,370,370,370,370,371,2021-02-02 15:00:00+00:00,Anne Arundel,1269.0,44811,1524.0,11210,,0,,,11210,44811,56021
371,371,371,371,371,371,371,371,372,2021-02-03 15:00:00+00:00,Anne Arundel,1487.0,46298,2094.0,13304,,0,,,13304,46298,59602
372,372,372,372,372,372,372,372,373,2021-02-04 15:00:00+00:00,Anne Arundel,1645.0,47943,1887.0,15191,,0,,,15191,47943,63134
373,373,373,373,373,373,373,373,374,2021-02-05 15:00:00+00:00,Anne Arundel,1488.0,49431,1519.0,16710,,0,,,16710,49431,66141
374,374,374,374,374,374,374,374,375,2021-02-06 15:00:00+00:00,Anne Arundel,823.0,50254,955.0,17665,,0,,,17665,50254,67919
375,375,375,375,375,375,375,375,376,2021-02-07 15:00:00+00:00,Anne Arundel,334.0,50588,102.0,17767,,0,,,17767,50588,68355
376,376,376,376,376,376,376,376,377,2021-02-08 15:00:00+00:00,Anne Arundel,1329.0,51917,1260.0,19027,,0,,,19027,51917,70944
377,377,377,377,377,377,377,377,378,2021-02-09 15:00:00+00:00,Anne Arundel,1159.0,53076,656.0,19683,,0,,,19683,53076,72759
378,378,378,378,378,378,378,378,379,2021-02-10 15:00:00+00:00,Anne Arundel,1619.0,54695,1793.0,21476,,0,,,21476,54695,76171
379,379,379,379,379,379,379,379,380,2021-02-11 15:00:00+00:00,Anne Arundel,3174.0,57869,1679.0,23155,,0,,,23155,57869,81024
380,380,380,380,380,380,380,380,381,2021-02-12 15:00:00+00:00,Anne Arundel,2243.0,60112,1787.0,24942,,0,,,24942,60112,85054
381,381,381,381,381,381,381,381,382,2021-02-13 15:00:00+00:00,Anne Arundel,736.0,60848,1263.0,26205,,0,,,26205,60848,87053
382,382,382,382,382,382,382,382,383,2021-02-14 15:00:00+00:00,Anne Arundel,859.0,61707,585.0,26790,,0,,,26790,61707,88497
383,383,383,383,383,383,383,383,384,2021-02-15 15:00:00+00:00,Anne Arundel,1995.0,63702,567.0,27357,,0,,,27357,63702,91059
384,384,384,384,384,384,384,384,385,2021-02-16 15:00:00+00:00,Anne Arundel,2206.0,65908,1311.0,28668,,0,,,28668,65908,94576
385,385,385,385,385,385,385,385,386,2021-02-17 15:00:00+00:00,Anne Arundel,3311.0,69219,2093.0,30761,,0,,,30761,69219,99980
386,386,386,386,386,386,386,386,387,2021-02-18 15:00:00+00:00,Anne Arundel,268.0,69487,281.0,31042,,0,,,31042,69487,100529
387,387,387,387,387,387,387,387,388,2021-02-19 15:00:00+00:00,Anne Arundel,1521.0,71008,1007.0,32049,,0,,,32049,71008,103057
388,388,388,388,388,388,388,388,389,2021-02-20 15:00:00+00:00,Anne Arundel,828.0,71836,1926.0,33975,,0,,,33975,71836,105811
389,389,389,389,389,389,389,389,390,2021-02-21 15:00:00+00:00,Anne Arundel,754.0,72590,1038.0,35013,,0,,,35013,72590,107603
390,390,390,390,390,390,390,390,391,2021-02-22 15:00:00+00:00,Anne Arundel,683.0,73273,1499.0,36512,,0,,,36512,73273,109785
391,391,391,391,391,391,391,391,392,2021-02-23 15:00:00+00:00,Anne Arundel,1474.0,74747,1743.0,38255,,0,,,38255,74747,113002
392,392,392,392,392,392,392,392,393,2021-02-24 15:00:00+00:00,Anne Arundel,1416.0,76163,1814.0,40069,,0,,,40069,76163,116232
393,393,393,393,393,393,393,393,394,2021-02-25 15:00:00+00:00,Anne Arundel,2413.0,78576,1665.0,41734,,0,,,41734,78576,120310
394,394,394,394,394,394,394,394,395,2021-02-26 15:00:00+00:00,Anne Arundel,2015.0,80591,1250.0,42984,,0,,,42984,80591,123575
395,395,395,395,395,395,395,395,396,2021-02-27 15:00:00+00:00,Anne Arundel,1334.0,81925,505.0,43489,,0,,,43489,81925,125414
396,396,396,396,396,396,396,396,397,2021-02-28 15:00:00+00:00,Anne Arundel,1445.0,83370,352.0,43841,,0,,,43841,83370,127211
397,397,397,397,397,397,397,397,398,2021-03-01 15:00:00+00:00,Anne Arundel,2161.0,85531,820.0,44661,,0,,,44661,85531,130192
398,398,398,398,398,398,398,398,399,2021-03-02 15:00:00+00:00,Anne Arundel,2126.0,87657,1245.0,45906,5.0,5,2131.0,1250.0,45911,87662,133563
399,399,399,399,399,399,399,399,400,2021-03-03 15:00:00+00:00,Anne Arundel,2488.0,90145,1583.0,47489,3.0,8,2491.0,1586.0,47497,90153,137634
400,400,400,400,400,400,400,400,401,2021-03-04 15:00:00+00:00,Anne Arundel,2828.0,92973,1579.0,49068,962.0,970,3790.0,2541.0,50038,93943,142041
401,401,401,401,401,401,401,401,402,2021-03-05 15:00:00+00:00,Anne Arundel,2311.0,95284,2051.0,51119,533.0,1503,2844.0,2584.0,52622,96787,146403
402,402,402,402,402,402,402,402,403,2021-03-06 15:00:00+00:00,Anne Arundel,1381.0,96665,745.0,51864,638.0,2141,2019.0,1383.0,54005,98806,148529
403,403,403,403,403,403,403,403,404,2021-03-07 15:00:00+00:00,Anne Arundel,1368.0,98033,519.0,52383,685.0,2826,2053.0,1204.0,55209,100859,150416
404,404,404,404,404,404,404,404,405,2021-03-08 15:00:00+00:00,Anne Arundel,2188.0,100221,1333.0,53716,863.0,3689,3051.0,2196.0,57405,103910,153937
405,405,405,405,405,405,405,405,406,2021-03-09 15:00:00+00:00,Anne Arundel,2341.0,102562,1809.0,55525,1810.0,5499,4151.0,3619.0,61024,108061,158087
406,406,406,406,406,406,406,406,407,2021-03-10 15:00:00+00:00,Anne Arundel,3161.0,105723,2368.0,57893,826.0,6325,3987.0,3194.0,64218,112048,163616
407,407,407,407,407,407,407,407,408,2021-03-11 15:00:00+00:00,Anne Arundel,3691.0,109414,2418.0,60311,329.0,6654,4020.0,2747.0,66965,116068,169725
408,408,408,408,408,408,408,408,409,2021-03-12 15:00:00+00:00,Anne Arundel,2746.0,112160,1989.0,62300,179.0,6833,2925.0,2168.0,69133,118993,174460
409,409,409,409,409,409,409,409,410,2021-03-13 15:00:00+00:00,Anne Arundel,2080.0,114240,845.0,63145,70.0,6903,2150.0,915.0,70048,121143,177385
410,410,410,410,410,410,410,410,411,2021-03-14 15:00:00+00:00,Anne Arundel,1909.0,116149,856.0,64001,32.0,6935,1941.0,888.0,70936,123084,180150
411,411,411,411,411,411,411,411,412,2021-03-15 15:00:00+00:00,Anne Arundel,2998.0,119147,1585.0,65586,69.0,7004,3067.0,1654.0,72590,126151,184733
412,412,412,412,412,412,412,412,413,2021-03-16 15:00:00+00:00,Anne Arundel,4042.0,123189,1531.0,67117,47.0,7051,4089.0,1578.0,74168,130240,190306
413,413,413,413,413,413,413,413,414,2021-03-17 15:00:00+00:00,Anne Arundel,3799.0,126988,1396.0,68513,43.0,7094,3842.0,1439.0,75607,134082,195501
414,414,414,414,414,414,414,414,415,2021-03-18 15:00:00+00:00,Anne Arundel,4000.0,130988,1674.0,70187,59.0,7153,4059.0,1733.0,77340,138141,201175
415,415,415,415,415,415,415,415,416,2021-03-19 15:00:00+00:00,Anne Arundel,2781.0,133769,1713.0,71900,91.0,7244,2872.0,1804.0,79144,141013,205669
416,416,416,416,416,416,416,416,417,2021-03-20 15:00:00+00:00,Anne Arundel,2100.0,135869,954.0,72854,45.0,7289,2145.0,999.0,80143,143158,208723
417,417,417,417,417,417,417,417,418,2021-03-21 15:00:00+00:00,Anne Arundel,1829.0,137698,818.0,73672,12.0,7301,1841.0,830.0,80973,144999,211370
418,418,418,418,418,418,418,418,419,2021-03-22 15:00:00+00:00,Anne Arundel,3610.0,141308,911.0,74583,72.0,7373,3682.0,983.0,81956,148681,215891
419,419,419,419,419,419,419,419,420,2021-03-23 15:00:00+00:00,Anne Arundel,3548.0,144856,1481.0,76064,109.0,7482,3657.0,1590.0,83546,152338,220920
420,420,420,420,420,420,420,420,421,2021-03-24 15:00:00+00:00,Anne Arundel,4068.0,148924,1724.0,77788,232.0,7714,4300.0,1956.0,85502,156638,226712
421,421,421,421,421,421,421,421,422,2021-03-25 15:00:00+00:00,Anne Arundel,4006.0,152930,2443.0,80231,110.0,7824,4116.0,2553.0,88055,160754,233161
422,422,422,422,422,422,422,422,423,2021-03-26 15:00:00+00:00,Anne Arundel,3594.0,156524,1957.0,82188,88.0,7912,3682.0,2045.0,90100,164436,238712
423,423,423,423,423,423,423,423,424,2021-03-27 15:00:00+00:00,Anne Arundel,1791.0,158315,1254.0,83442,143.0,8055,1934.0,1397.0,91497,166370,241757
424,424,424,424,424,424,424,424,425,2021-03-28 15:00:00+00:00,Anne Arundel,1495.0,159810,1282.0,84724,23.0,8078,1518.0,1305.0,92802,167888,244534
425,425,425,425,425,425,425,425,426,2021-03-29 15:00:00+00:00,Anne Arundel,2518.0,162328,2225.0,86949,139.0,8217,2657.0,2364.0,95166,170545,249277
426,426,426,426,426,426,426,426,427,2021-03-30 15:00:00+00:00,Anne Arundel,3226.0,165554,2164.0,89113,149.0,8366,3375.0,2313.0,97479,173920,254667
427,427,427,427,427,427,427,427,428,2021-03-31 15:00:00+00:00,Anne Arundel,3644.0,169198,3540.0,92653,247.0,8613,3891.0,3787.0,101266,177811,261851
428,428,428,428,428,428,428,428,429,2021-04-01 15:00:00+00:00,Anne Arundel,3453.0,172651,3450.0,96103,424.0,9037,3877.0,3874.0,105140,181688,268754
429,429,429,429,429,429,429,429,430,2021-04-02 15:00:00+00:00,Anne Arundel,3301.0,175952,2770.0,98873,304.0,9341,3605.0,3074.0,108214,185293,274825
430,430,430,430,430,430,430,430,431,2021-04-03 15:00:00+00:00,Anne Arundel,2238.0,178190,1741.0,100614,208.0,9549,2446.0,1949.0,110163,187739,278804
431,431,431,431,431,431,431,431,432,2021-04-04 15:00:00+00:00,Anne Arundel,811.0,179001,1269.0,101883,59.0,9608,870.0,1328.0,111491,188609,280884
432,432,432,432,432,432,432,432,433,2021-04-05 15:00:00+00:00,Anne Arundel,2870.0,181871,2610.0,104493,475.0,10083,3345.0,3085.0,114576,191954,286364
433,433,433,433,433,433,433,433,434,2021-04-06 15:00:00+00:00,Anne Arundel,3121.0,184992,2964.0,107457,616.0,10699,3737.0,3580.0,118156,195691,292449
434,434,434,434,434,434,434,434,435,2021-04-07 15:00:00+00:00,Anne Arundel,3140.0,188132,3455.0,110912,790.0,11489,3930.0,4245.0,122401,199621,299044
435,435,435,435,435,435,435,435,436,2021-04-08 15:00:00+00:00,Anne Arundel,4326.0,192458,4297.0,115209,772.0,12261,5098.0,5069.0,127470,204719,307667
436,436,436,436,436,436,436,436,437,2021-04-09 15:00:00+00:00,Anne Arundel,3198.0,195656,2735.0,117944,1101.0,13362,4299.0,3836.0,131306,209018,313600
437,437,437,437,437,437,437,437,438,2021-04-10 15:00:00+00:00,Anne Arundel,1813.0,197469,2273.0,120217,580.0,13942,2393.0,2853.0,134159,211411,317686
438,438,438,438,438,438,438,438,439,2021-04-11 15:00:00+00:00,Anne Arundel,1595.0,199064,1315.0,121532,383.0,14325,1978.0,1698.0,135857,213389,320596
439,439,439,439,439,439,439,439,440,2021-04-12 15:00:00+00:00,Anne Arundel,2477.0,201541,3263.0,124795,882.0,15207,3359.0,4145.0,140002,216748,326336
440,440,440,440,440,440,440,440,441,2021-04-13 15:00:00+00:00,Anne Arundel,3093.0,204634,4197.0,128992,21.0,15228,3114.0,4218.0,144220,219862,333626
441,441,441,441,441,441,441,441,442,2021-04-14 15:00:00+00:00,Anne Arundel,2992.0,207626,3495.0,132487,3.0,15231,2995.0,3498.0,147718,222857,340113
442,442,442,442,442,442,442,442,443,2021-04-15 15:00:00+00:00,Anne Arundel,3531.0,211157,3688.0,136175,1.0,15232,3532.0,3689.0,151407,226389,347332
443,443,443,443,443,443,443,443,444,2021-04-16 15:00:00+00:00,Anne Arundel,3696.0,214853,2712.0,138887,1.0,15233,3697.0,2713.0,154120,230086,353740
444,444,444,444,444,444,444,444,445,2021-04-17 15:00:00+00:00,Anne Arundel,2887.0,217740,1554.0,140441,,15233,,,155674,232973,358181
445,445,445,445,445,445,445,445,446,2021-04-18 15:00:00+00:00,Anne Arundel,2743.0,220483,1460.0,141901,,15233,,,157134,235716,362384
446,446,446,446,446,446,446,446,447,2021-04-19 15:00:00+00:00,Anne Arundel,3125.0,223608,2952.0,144853,1.0,15234,3126.0,2953.0,160087,238842,368461
447,447,447,447,447,447,447,447,448,2021-04-20 15:00:00+00:00,Anne Arundel,2867.0,226475,3675.0,148528,,15234,,,163762,241709,375003
448,448,448,448,448,448,448,448,449,2021-04-21 15:00:00+00:00,Anne Arundel,3965.0,230440,4984.0,153512,2.0,15236,3967.0,4986.0,168748,245676,383952
449,449,449,449,449,449,449,449,450,2021-04-22 15:00:00+00:00,Anne Arundel,3560.0,234000,4348.0,157860,2.0,15238,3562.0,4350.0,173098,249238,391860
450,450,450,450,450,450,450,450,451,2021-04-23 15:00:00+00:00,Anne Arundel,3081.0,237081,4087.0,161947,,15238,,,177185,252319,399028
451,451,451,451,451,451,451,451,452,2021-04-24 15:00:00+00:00,Anne Arundel,1747.0,238828,2479.0,164426,7.0,15245,1754.0,2486.0,179671,254073,403254
452,452,452,452,452,452,452,452,453,2021-04-25 15:00:00+00:00,Anne Arundel,1868.0,240696,836.0,165262,4.0,15249,1872.0,840.0,180511,255945,405958
453,453,453,453,453,453,453,453,454,2021-04-26 15:00:00+00:00,Anne Arundel,2594.0,243290,3186.0,168448,31.0,15280,2625.0,3217.0,183728,258570,411738
454,454,454,454,454,454,454,454,455,2021-04-27 15:00:00+00:00,Anne Arundel,2179.0,245469,2824.0,171272,132.0,15412,2311.0,2956.0,186684,260881,416741
455,455,455,455,455,455,455,455,456,2021-04-28 15:00:00+00:00,Anne Arundel,3119.0,248588,2273.0,173545,168.0,15580,3287.0,2441.0,189125,264168,422133
456,456,456,456,456,456,456,456,457,2021-04-29 15:00:00+00:00,Anne Arundel,2821.0,251409,2180.0,175725,147.0,15727,2968.0,2327.0,191452,267136,427134
457,457,457,457,457,457,457,457,458,2021-04-30 15:00:00+00:00,Anne Arundel,2706.0,254115,2287.0,178012,148.0,15875,2854.0,2435.0,193887,269990,432127
458,458,458,458,458,458,458,458,459,2021-05-01 15:00:00+00:00,Anne Arundel,2180.0,256295,2250.0,180262,98.0,15973,2278.0,2348.0,196235,272268,436557
459,459,459,459,459,459,459,459,460,2021-05-02 15:00:00+00:00,Anne Arundel,1089.0,257384,1530.0,181792,68.0,16041,1157.0,1598.0,197833,273425,439176
460,460,460,460,460,460,460,460,461,2021-05-03 15:00:00+00:00,Anne Arundel,1274.0,258658,2073.0,183865,196.0,16237,1470.0,2269.0,200102,274895,442523
461,461,461,461,461,461,461,461,462,2021-05-04 15:00:00+00:00,Anne Arundel,1244.0,259902,2384.0,186249,200.0,16437,1444.0,2584.0,202686,276339,446151
462,462,462,462,462,462,462,462,463,2021-05-05 15:00:00+00:00,Anne Arundel,2156.0,262058,3254.0,189503,167.0,16604,2323.0,3421.0,206107,278662,451561
463,463,463,463,463,463,463,463,464,2021-05-06 15:00:00+00:00,Anne Arundel,1734.0,263792,4133.0,193636,172.0,16776,1906.0,4305.0,210412,280568,457428
464,464,464,464,464,464,464,464,465,2021-05-07 15:00:00+00:00,Anne Arundel,1586.0,265378,3134.0,196770,140.0,16916,1726.0,3274.0,213686,282294,462148
465,465,465,465,465,465,465,465,466,2021-05-08 15:00:00+00:00,Anne Arundel,950.0,266328,2210.0,198980,137.0,17053,1087.0,2347.0,216033,283381,465308
466,466,466,466,466,466,466,466,467,2021-05-09 15:00:00+00:00,Anne Arundel,426.0,266754,1069.0,200049,60.0,17113,486.0,1129.0,217162,283867,466803
467,467,467,467,467,467,467,467,468,2021-05-10 15:00:00+00:00,Anne Arundel,826.0,267580,2804.0,202853,149.0,17262,975.0,2953.0,220115,284842,470433
468,468,468,468,468,468,468,468,469,2021-05-11 15:00:00+00:00,Anne Arundel,998.0,268578,2534.0,205387,143.0,17405,1141.0,2677.0,222792,285983,473965
469,469,469,469,469,469,469,469,470,2021-05-12 15:00:00+00:00,Anne Arundel,1666.0,270244,2963.0,208350,146.0,17551,1812.0,3109.0,225901,287795,478594
470,470,470,470,470,470,470,470,471,2021-05-13 15:00:00+00:00,Anne Arundel,2187.0,272431,2956.0,211306,123.0,17674,2310.0,3079.0,228980,290105,483737
471,471,471,471,471,471,471,471,472,2021-05-14 15:00:00+00:00,Anne Arundel,2423.0,274854,3111.0,214417,170.0,17844,2593.0,3281.0,232261,292698,489271
472,472,472,472,472,472,472,472,473,2021-05-15 15:00:00+00:00,Anne Arundel,1838.0,276692,2542.0,216959,95.0,17939,1933.0,2637.0,234898,294631,493651
473,473,473,473,473,473,473,473,474,2021-05-16 15:00:00+00:00,Anne Arundel,1262.0,277954,2188.0,219147,105.0,18044,1367.0,2293.0,237191,295998,497101
474,474,474,474,474,474,474,474,475,2021-05-17 15:00:00+00:00,Anne Arundel,1363.0,279317,2850.0,221997,238.0,18282,1601.0,3088.0,240279,297599,501314
475,475,475,475,475,475,475,475,476,2021-05-18 15:00:00+00:00,Anne Arundel,1456.0,280773,2878.0,224875,195.0,18477,1651.0,3073.0,243352,299250,505648
476,476,476,476,476,476,476,476,477,2021-05-19 15:00:00+00:00,Anne Arundel,3668.0,284441,4347.0,229222,209.0,18686,3877.0,4556.0,247908,303127,513663
477,477,477,477,477,477,477,477,478,2021-05-20 15:00:00+00:00,Anne Arundel,1753.0,286194,3558.0,232780,270.0,18956,2023.0,3828.0,251736,305150,518974
478,478,478,478,478,478,478,478,479,2021-05-21 15:00:00+00:00,Anne Arundel,1548.0,287742,3329.0,236109,126.0,19082,1674.0,3455.0,255191,306824,523851
479,479,479,479,479,479,479,479,480,2021-05-22 15:00:00+00:00,Anne Arundel,1299.0,289041,1644.0,237753,125.0,19207,1424.0,1769.0,256960,308248,526794
480,480,480,480,480,480,480,480,481,2021-05-23 15:00:00+00:00,Anne Arundel,906.0,289947,1385.0,239138,79.0,19286,985.0,1464.0,258424,309233,529085
481,481,481,481,481,481,481,481,482,2021-05-24 15:00:00+00:00,Anne Arundel,1138.0,291085,2128.0,241266,149.0,19435,1287.0,2277.0,260701,310520,532351
482,482,482,482,482,482,482,482,483,2021-05-25 15:00:00+00:00,Anne Arundel,949.0,292034,1537.0,242803,162.0,19597,1111.0,1699.0,262400,311631,534837
483,483,483,483,483,483,483,483,484,2021-05-26 15:00:00+00:00,Anne Arundel,2494.0,294528,1876.0,244679,113.0,19710,2607.0,1989.0,264389,314238,539207
484,484,484,484,484,484,484,484,485,2021-05-27 15:00:00+00:00,Anne Arundel,927.0,295455,1639.0,246318,98.0,19808,1025.0,1737.0,266126,315263,541773
485,485,485,485,485,485,485,485,486,2021-05-28 15:00:00+00:00,Anne Arundel,961.0,296416,1583.0,247901,104.0,19912,1065.0,1687.0,267813,316328,544317
486,486,486,486,486,486,486,486,487,2021-05-29 15:00:00+00:00,Anne Arundel,838.0,297254,1770.0,249671,86.0,19998,924.0,1856.0,269669,317252,546925
487,487,487,487,487,487,487,487,488,2021-05-30 15:00:00+00:00,Anne Arundel,486.0,297740,1225.0,250896,57.0,20055,543.0,1282.0,270951,317795,548636
488,488,488,488,488,488,488,488,489,2020-12-14 15:00:00+00:00,Baltimore,1.0,1,,0,,0,,,0,1,1
489,489,489,489,489,489,489,489,490,2020-12-15 15:00:00+00:00,Baltimore,6.0,7,2.0,2,,0,,,2,7,9
490,490,490,490,490,490,490,490,491,2020-12-16 15:00:00+00:00,Baltimore,116.0,123,,2,,0,,,2,123,125
491,491,491,491,491,491,491,491,492,2020-12-17 15:00:00+00:00,Baltimore,174.0,297,,2,,0,,,2,297,299
492,492,492,492,492,492,492,492,493,2020-12-18 15:00:00+00:00,Baltimore,408.0,705,3.0,5,,0,,,5,705,710
493,493,493,493,493,493,493,493,494,2020-12-19 15:00:00+00:00,Baltimore,131.0,836,,5,,0,,,5,836,841
494,494,494,494,494,494,494,494,495,2020-12-20 15:00:00+00:00,Baltimore,63.0,899,2.0,7,,0,,,7,899,906
495,495,495,495,495,495,495,495,496,2020-12-21 15:00:00+00:00,Baltimore,549.0,1448,1.0,8,,0,,,8,1448,1456
496,496,496,496,496,496,496,496,497,2020-12-22 15:00:00+00:00,Baltimore,994.0,2442,1.0,9,,0,,,9,2442,2451
497,497,497,497,497,497,497,497,498,2020-12-23 15:00:00+00:00,Baltimore,1124.0,3566,3.0,12,,0,,,12,3566,3578
498,498,498,498,498,498,498,498,499,2020-12-24 15:00:00+00:00,Baltimore,600.0,4166,2.0,14,,0,,,14,4166,4180
499,499,499,499,499,499,499,499,500,2020-12-25 15:00:00+00:00,Baltimore,35.0,4201,,14,,0,,,14,4201,4215
500,500,500,500,500,500,500,500,501,2020-12-26 15:00:00+00:00,Baltimore,305.0,4506,1.0,15,,0,,,15,4506,4521
501,501,501,501,501,501,501,501,502,2020-12-27 15:00:00+00:00,Baltimore,306.0,4812,3.0,18,,0,,,18,4812,4830
502,502,502,502,502,502,502,502,503,2020-12-28 15:00:00+00:00,Baltimore,1524.0,6336,6.0,24,,0,,,24,6336,6360
503,503,503,503,503,503,503,503,504,2020-12-29 15:00:00+00:00,Baltimore,1910.0,8246,5.0,29,,0,,,29,8246,8275
504,504,504,504,504,504,504,504,505,2020-12-30 15:00:00+00:00,Baltimore,1666.0,9912,8.0,37,,0,,,37,9912,9949
505,505,505,505,505,505,505,505,506,2020-12-31 15:00:00+00:00,Baltimore,1013.0,10925,,37,,0,,,37,10925,10962
506,506,506,506,506,506,506,506,507,2021-01-01 15:00:00+00:00,Baltimore,313.0,11238,5.0,42,,0,,,42,11238,11280
507,507,507,507,507,507,507,507,508,2021-01-02 15:00:00+00:00,Baltimore,563.0,11801,6.0,48,,0,,,48,11801,11849
508,508,508,508,508,508,508,508,509,2021-01-03 15:00:00+00:00,Baltimore,888.0,12689,16.0,64,,0,,,64,12689,12753
509,509,509,509,509,509,509,509,510,2021-01-04 15:00:00+00:00,Baltimore,1977.0,14666,55.0,119,,0,,,119,14666,14785
510,510,510,510,510,510,510,510,511,2021-01-05 15:00:00+00:00,Baltimore,2111.0,16777,95.0,214,,0,,,214,16777,16991
511,511,511,511,511,511,511,511,512,2021-01-06 15:00:00+00:00,Baltimore,2158.0,18935,174.0,388,,0,,,388,18935,19323
512,512,512,512,512,512,512,512,513,2021-01-07 15:00:00+00:00,Baltimore,2352.0,21287,274.0,662,,0,,,662,21287,21949
513,513,513,513,513,513,513,513,514,2021-01-08 15:00:00+00:00,Baltimore,2072.0,23359,335.0,997,,0,,,997,23359,24356
514,514,514,514,514,514,514,514,515,2021-01-09 15:00:00+00:00,Baltimore,371.0,23730,132.0,1129,,0,,,1129,23730,24859
515,515,515,515,515,515,515,515,516,2021-01-10 15:00:00+00:00,Baltimore,376.0,24106,40.0,1169,,0,,,1169,24106,25275
516,516,516,516,516,516,516,516,517,2021-01-11 15:00:00+00:00,Baltimore,3217.0,27323,520.0,1689,,0,,,1689,27323,29012
517,517,517,517,517,517,517,517,518,2021-01-12 15:00:00+00:00,Baltimore,3807.0,31130,892.0,2581,,0,,,2581,31130,33711
518,518,518,518,518,518,518,518,519,2021-01-13 15:00:00+00:00,Baltimore,2891.0,34021,842.0,3423,,0,,,3423,34021,37444
519,519,519,519,519,519,519,519,520,2021-01-14 15:00:00+00:00,Baltimore,2734.0,36755,378.0,3801,,0,,,3801,36755,40556
520,520,520,520,520,520,520,520,521,2021-01-15 15:00:00+00:00,Baltimore,2037.0,38792,253.0,4054,,0,,,4054,38792,42846
521,521,521,521,521,521,521,521,522,2021-01-16 15:00:00+00:00,Baltimore,665.0,39457,247.0,4301,,0,,,4301,39457,43758
522,522,522,522,522,522,522,522,523,2021-01-17 15:00:00+00:00,Baltimore,396.0,39853,259.0,4560,,0,,,4560,39853,44413
523,523,523,523,523,523,523,523,524,2021-01-18 15:00:00+00:00,Baltimore,867.0,40720,266.0,4826,,0,,,4826,40720,45546
524,524,524,524,524,524,524,524,525,2021-01-19 15:00:00+00:00,Baltimore,3159.0,43879,951.0,5777,,0,,,5777,43879,49656
525,525,525,525,525,525,525,525,526,2021-01-20 15:00:00+00:00,Baltimore,3632.0,47511,791.0,6568,,0,,,6568,47511,54079
526,526,526,526,526,526,526,526,527,2021-01-21 15:00:00+00:00,Baltimore,3559.0,51070,706.0,7274,,0,,,7274,51070,58344
527,527,527,527,527,527,527,527,528,2021-01-22 15:00:00+00:00,Baltimore,4485.0,55555,600.0,7874,,0,,,7874,55555,63429
528,528,528,528,528,528,528,528,529,2021-01-23 15:00:00+00:00,Baltimore,1274.0,56829,323.0,8197,,0,,,8197,56829,65026
529,529,529,529,529,529,529,529,530,2021-01-24 15:00:00+00:00,Baltimore,286.0,57115,505.0,8702,,0,,,8702,57115,65817
530,530,530,530,530,530,530,530,531,2021-01-25 15:00:00+00:00,Baltimore,3012.0,60127,1579.0,10281,,0,,,10281,60127,70408
531,531,531,531,531,531,531,531,532,2021-01-26 15:00:00+00:00,Baltimore,2385.0,62512,1695.0,11976,,0,,,11976,62512,74488
532,532,532,532,532,532,532,532,533,2021-01-27 15:00:00+00:00,Baltimore,3885.0,66397,1779.0,13755,,0,,,13755,66397,80152
533,533,533,533,533,533,533,533,534,2021-01-28 15:00:00+00:00,Baltimore,2590.0,68987,1340.0,15095,,0,,,15095,68987,84082
534,534,534,534,534,534,534,534,535,2021-01-29 15:00:00+00:00,Baltimore,2324.0,71311,1428.0,16523,,0,,,16523,71311,87834
535,535,535,535,535,535,535,535,536,2021-01-30 15:00:00+00:00,Baltimore,3278.0,74589,407.0,16930,,0,,,16930,74589,91519
536,536,536,536,536,536,536,536,537,2021-01-31 15:00:00+00:00,Baltimore,566.0,75155,217.0,17147,,0,,,17147,75155,92302
537,537,537,537,537,537,537,537,538,2021-02-01 15:00:00+00:00,Baltimore,1438.0,76593,974.0,18121,,0,,,18121,76593,94714
538,538,538,538,538,538,538,538,539,2021-02-02 15:00:00+00:00,Baltimore,1256.0,77849,2397.0,20518,,0,,,20518,77849,98367
539,539,539,539,539,539,539,539,540,2021-02-03 15:00:00+00:00,Baltimore,1754.0,79603,3665.0,24183,,0,,,24183,79603,103786
540,540,540,540,540,540,540,540,541,2021-02-04 15:00:00+00:00,Baltimore,2872.0,82475,2428.0,26611,,0,,,26611,82475,109086
541,541,541,541,541,541,541,541,542,2021-02-05 15:00:00+00:00,Baltimore,3305.0,85780,2343.0,28954,,0,,,28954,85780,114734
542,542,542,542,542,542,542,542,543,2021-02-06 15:00:00+00:00,Baltimore,3113.0,88893,622.0,29576,,0,,,29576,88893,118469
543,543,543,543,543,543,543,543,544,2021-02-07 15:00:00+00:00,Baltimore,1506.0,90399,246.0,29822,,0,,,29822,90399,120221
544,544,544,544,544,544,544,544,545,2021-02-08 15:00:00+00:00,Baltimore,2015.0,92414,2737.0,32559,,0,,,32559,92414,124973
545,545,545,545,545,545,545,545,546,2021-02-09 15:00:00+00:00,Baltimore,1852.0,94266,2570.0,35129,,0,,,35129,94266,129395
546,546,546,546,546,546,546,546,547,2021-02-10 15:00:00+00:00,Baltimore,2254.0,96520,2942.0,38071,,0,,,38071,96520,134591
547,547,547,547,547,547,547,547,548,2021-02-11 15:00:00+00:00,Baltimore,2966.0,99486,2988.0,41059,,0,,,41059,99486,140545
548,548,548,548,548,548,548,548,549,2021-02-12 15:00:00+00:00,Baltimore,2753.0,102239,2106.0,43165,,0,,,43165,102239,145404
549,549,549,549,549,549,549,549,550,2021-02-13 15:00:00+00:00,Baltimore,3048.0,105287,759.0,43924,,0,,,43924,105287,149211
550,550,550,550,550,550,550,550,551,2021-02-14 15:00:00+00:00,Baltimore,636.0,105923,188.0,44112,,0,,,44112,105923,150035
551,551,551,551,551,551,551,551,552,2021-02-15 15:00:00+00:00,Baltimore,1134.0,107057,3386.0,47498,,0,,,47498,107057,154555
552,552,552,552,552,552,552,552,553,2021-02-16 15:00:00+00:00,Baltimore,1581.0,108638,4141.0,51639,,0,,,51639,108638,160277
553,553,553,553,553,553,553,553,554,2021-02-17 15:00:00+00:00,Baltimore,1626.0,110264,4178.0,55817,,0,,,55817,110264,166081
554,554,554,554,554,554,554,554,555,2021-02-18 15:00:00+00:00,Baltimore,352.0,110616,545.0,56362,,0,,,56362,110616,166978
555,555,555,555,555,555,555,555,556,2021-02-19 15:00:00+00:00,Baltimore,935.0,111551,2513.0,58875,,0,,,58875,111551,170426
556,556,556,556,556,556,556,556,557,2021-02-20 15:00:00+00:00,Baltimore,1288.0,112839,3352.0,62227,,0,,,62227,112839,175066
557,557,557,557,557,557,557,557,558,2021-02-21 15:00:00+00:00,Baltimore,544.0,113383,683.0,62910,,0,,,62910,113383,176293
558,558,558,558,558,558,558,558,559,2021-02-22 15:00:00+00:00,Baltimore,829.0,114212,2805.0,65715,,0,,,65715,114212,179927
559,559,559,559,559,559,559,559,560,2021-02-23 15:00:00+00:00,Baltimore,3062.0,117274,1832.0,67547,,0,,,67547,117274,184821
560,560,560,560,560,560,560,560,561,2021-02-24 15:00:00+00:00,Baltimore,3026.0,120300,2121.0,69668,,0,,,69668,120300,189968
561,561,561,561,561,561,561,561,562,2021-02-25 15:00:00+00:00,Baltimore,1805.0,122105,4209.0,73877,,0,,,73877,122105,195982
562,562,562,562,562,562,562,562,563,2021-02-26 15:00:00+00:00,Baltimore,3437.0,125542,4359.0,78236,,0,,,78236,125542,203778
563,563,563,563,563,563,563,563,564,2021-02-27 15:00:00+00:00,Baltimore,2041.0,127583,2890.0,81126,,0,,,81126,127583,208709
564,564,564,564,564,564,564,564,565,2021-02-28 15:00:00+00:00,Baltimore,1887.0,129470,775.0,81901,,0,,,81901,129470,211371
565,565,565,565,565,565,565,565,566,2021-03-01 15:00:00+00:00,Baltimore,3863.0,133333,1700.0,83601,,0,,,83601,133333,216934
566,566,566,566,566,566,566,566,567,2021-03-02 15:00:00+00:00,Baltimore,2499.0,135832,1874.0,85475,1.0,1,2500.0,1875.0,85476,135833,221307
567,567,567,567,567,567,567,567,568,2021-03-03 15:00:00+00:00,Baltimore,4804.0,140636,1989.0,87464,4.0,5,4808.0,1993.0,87469,140641,228100
568,568,568,568,568,568,568,568,569,2021-03-04 15:00:00+00:00,Baltimore,4339.0,144975,2861.0,90325,728.0,733,5067.0,3589.0,91058,145708,235300
569,569,569,569,569,569,569,569,570,2021-03-05 15:00:00+00:00,Baltimore,3306.0,148281,3077.0,93402,578.0,1311,3884.0,3655.0,94713,149592,241683
570,570,570,570,570,570,570,570,571,2021-03-06 15:00:00+00:00,Baltimore,2074.0,150355,2519.0,95921,761.0,2072,2835.0,3280.0,97993,152427,246276
571,571,571,571,571,571,571,571,572,2021-03-07 15:00:00+00:00,Baltimore,1690.0,152045,574.0,96495,1530.0,3602,3220.0,2104.0,100097,155647,248540
572,572,572,572,572,572,572,572,573,2021-03-08 15:00:00+00:00,Baltimore,3818.0,155863,794.0,97289,1004.0,4606,4822.0,1798.0,101895,160469,253152
573,573,573,573,573,573,573,573,574,2021-03-09 15:00:00+00:00,Baltimore,2879.0,158742,1266.0,98555,949.0,5555,3828.0,2215.0,104110,164297,257297
574,574,574,574,574,574,574,574,575,2021-03-10 15:00:00+00:00,Baltimore,4383.0,163125,1488.0,100043,1101.0,6656,5484.0,2589.0,106699,169781,263168
575,575,575,575,575,575,575,575,576,2021-03-11 15:00:00+00:00,Baltimore,4272.0,167397,1441.0,101484,304.0,6960,4576.0,1745.0,108444,174357,268881
576,576,576,576,576,576,576,576,577,2021-03-12 15:00:00+00:00,Baltimore,4651.0,172048,1906.0,103390,168.0,7128,4819.0,2074.0,110518,179176,275438
577,577,577,577,577,577,577,577,578,2021-03-13 15:00:00+00:00,Baltimore,3742.0,175790,1295.0,104685,69.0,7197,3811.0,1364.0,111882,182987,280475
578,578,578,578,578,578,578,578,579,2021-03-14 15:00:00+00:00,Baltimore,2354.0,178144,811.0,105496,26.0,7223,2380.0,837.0,112719,185367,283640
579,579,579,579,579,579,579,579,580,2021-03-15 15:00:00+00:00,Baltimore,4658.0,182802,1218.0,106714,35.0,7258,4693.0,1253.0,113972,190060,289516
580,580,580,580,580,580,580,580,581,2021-03-16 15:00:00+00:00,Baltimore,3368.0,186170,1170.0,107884,104.0,7362,3472.0,1274.0,115246,193532,294054
581,581,581,581,581,581,581,581,582,2021-03-17 15:00:00+00:00,Baltimore,5474.0,191644,1343.0,109227,212.0,7574,5686.0,1555.0,116801,199218,300871
582,582,582,582,582,582,582,582,583,2021-03-18 15:00:00+00:00,Baltimore,6365.0,198009,1355.0,110582,145.0,7719,6510.0,1500.0,118301,205728,308591
583,583,583,583,583,583,583,583,584,2021-03-19 15:00:00+00:00,Baltimore,4898.0,202907,1647.0,112229,139.0,7858,5037.0,1786.0,120087,210765,315136
584,584,584,584,584,584,584,584,585,2021-03-20 15:00:00+00:00,Baltimore,2926.0,205833,1175.0,113404,103.0,7961,3029.0,1278.0,121365,213794,319237
585,585,585,585,585,585,585,585,586,2021-03-21 15:00:00+00:00,Baltimore,2723.0,208556,839.0,114243,81.0,8042,2804.0,920.0,122285,216598,322799
586,586,586,586,586,586,586,586,587,2021-03-22 15:00:00+00:00,Baltimore,4367.0,212923,1302.0,115545,97.0,8139,4464.0,1399.0,123684,221062,328468
587,587,587,587,587,587,587,587,588,2021-03-23 15:00:00+00:00,Baltimore,4080.0,217003,3333.0,118878,152.0,8291,4232.0,3485.0,127169,225294,335881
588,588,588,588,588,588,588,588,589,2021-03-24 15:00:00+00:00,Baltimore,3770.0,220773,3760.0,122638,175.0,8466,3945.0,3935.0,131104,229239,343411
589,589,589,589,589,589,589,589,590,2021-03-25 15:00:00+00:00,Baltimore,6474.0,227247,2293.0,124931,220.0,8686,6694.0,2513.0,133617,235933,352178
590,590,590,590,590,590,590,590,591,2021-03-26 15:00:00+00:00,Baltimore,3779.0,231026,3388.0,128319,146.0,8832,3925.0,3534.0,137151,239858,359345
591,591,591,591,591,591,591,591,592,2021-03-27 15:00:00+00:00,Baltimore,5121.0,236147,1699.0,130018,134.0,8966,5255.0,1833.0,138984,245113,366165
592,592,592,592,592,592,592,592,593,2021-03-28 15:00:00+00:00,Baltimore,1907.0,238054,1429.0,131447,46.0,9012,1953.0,1475.0,140459,247066,369501
593,593,593,593,593,593,593,593,594,2021-03-29 15:00:00+00:00,Baltimore,2531.0,240585,3850.0,135297,124.0,9136,2655.0,3974.0,144433,249721,375882
594,594,594,594,594,594,594,594,595,2021-03-30 15:00:00+00:00,Baltimore,6271.0,246856,3499.0,138796,224.0,9360,6495.0,3723.0,148156,256216,385652
595,595,595,595,595,595,595,595,596,2021-03-31 15:00:00+00:00,Baltimore,3927.0,250783,5126.0,143922,413.0,9773,4340.0,5539.0,153695,260556,394705
596,596,596,596,596,596,596,596,597,2021-04-01 15:00:00+00:00,Baltimore,5802.0,256585,5924.0,149846,517.0,10290,6319.0,6441.0,160136,266875,406431
597,597,597,597,597,597,597,597,598,2021-04-02 15:00:00+00:00,Baltimore,3408.0,259993,3717.0,153563,612.0,10902,4020.0,4329.0,164465,270895,413556
598,598,598,598,598,598,598,598,599,2021-04-03 15:00:00+00:00,Baltimore,2379.0,262372,2403.0,155966,307.0,11209,2686.0,2710.0,167175,273581,418338
599,599,599,599,599,599,599,599,600,2021-04-04 15:00:00+00:00,Baltimore,1078.0,263450,1207.0,157173,105.0,11314,1183.0,1312.0,168487,274764,420623
600,600,600,600,600,600,600,600,601,2021-04-05 15:00:00+00:00,Baltimore,2756.0,266206,4118.0,161291,858.0,12172,3614.0,4976.0,173463,278378,427497
601,601,601,601,601,601,601,601,602,2021-04-06 15:00:00+00:00,Baltimore,6993.0,273199,3248.0,164539,1215.0,13387,8208.0,4463.0,177926,286586,437738
602,602,602,602,602,602,602,602,603,2021-04-07 15:00:00+00:00,Baltimore,3239.0,276438,4969.0,169508,1532.0,14919,4771.0,6501.0,184427,291357,445946
603,603,603,603,603,603,603,603,604,2021-04-08 15:00:00+00:00,Baltimore,6366.0,282804,3945.0,173453,1597.0,16516,7963.0,5542.0,189969,299320,456257
604,604,604,604,604,604,604,604,605,2021-04-09 15:00:00+00:00,Baltimore,2984.0,285788,4796.0,178249,1369.0,17885,4353.0,6165.0,196134,303673,464037
605,605,605,605,605,605,605,605,606,2021-04-10 15:00:00+00:00,Baltimore,1933.0,287721,3198.0,181447,741.0,18626,2674.0,3939.0,200073,306347,469168
606,606,606,606,606,606,606,606,607,2021-04-11 15:00:00+00:00,Baltimore,1768.0,289489,1525.0,182972,3612.0,22238,5380.0,5137.0,205210,311727,472461
607,607,607,607,607,607,607,607,608,2021-04-12 15:00:00+00:00,Baltimore,2384.0,291873,4517.0,187489,1207.0,23445,3591.0,5724.0,210934,315318,479362
608,608,608,608,608,608,608,608,609,2021-04-13 15:00:00+00:00,Baltimore,6496.0,298369,3789.0,191278,43.0,23488,6539.0,3832.0,214766,321857,489647
609,609,609,609,609,609,609,609,610,2021-04-14 15:00:00+00:00,Baltimore,4512.0,302881,5231.0,196509,3.0,23491,4515.0,5234.0,220000,326372,499390
610,610,610,610,610,610,610,610,611,2021-04-15 15:00:00+00:00,Baltimore,3392.0,306273,5766.0,202275,1.0,23492,3393.0,5767.0,225767,329765,508548
611,611,611,611,611,611,611,611,612,2021-04-16 15:00:00+00:00,Baltimore,3471.0,309744,4425.0,206700,3.0,23495,3474.0,4428.0,230195,333239,516444
612,612,612,612,612,612,612,612,613,2021-04-17 15:00:00+00:00,Baltimore,5768.0,315512,2050.0,208750,,23495,,,232245,339007,524262
613,613,613,613,613,613,613,613,614,2021-04-18 15:00:00+00:00,Baltimore,1548.0,317060,1876.0,210626,,23495,,,234121,340555,527686
614,614,614,614,614,614,614,614,615,2021-04-19 15:00:00+00:00,Baltimore,2691.0,319751,4790.0,215416,,23495,,,238911,343246,535167
615,615,615,615,615,615,615,615,616,2021-04-20 15:00:00+00:00,Baltimore,2961.0,322712,6095.0,221511,3.0,23498,2964.0,6098.0,245009,346210,544223
616,616,616,616,616,616,616,616,617,2021-04-21 15:00:00+00:00,Baltimore,6817.0,329529,4610.0,226121,1.0,23499,6818.0,4611.0,249620,353028,555650
617,617,617,617,617,617,617,617,618,2021-04-22 15:00:00+00:00,Baltimore,3396.0,332925,6419.0,232540,,23499,,,256039,356424,565465
618,618,618,618,618,618,618,618,619,2021-04-23 15:00:00+00:00,Baltimore,3657.0,336582,3569.0,236109,,23499,,,259608,360081,572691
619,619,619,619,619,619,619,619,620,2021-04-24 15:00:00+00:00,Baltimore,2530.0,339112,4740.0,240849,3.0,23502,2533.0,4743.0,264351,362614,579961
620,620,620,620,620,620,620,620,621,2021-04-25 15:00:00+00:00,Baltimore,3133.0,342245,761.0,241610,3.0,23505,3136.0,764.0,265115,365750,583855
621,621,621,621,621,621,621,621,622,2021-04-26 15:00:00+00:00,Baltimore,2918.0,345163,4617.0,246227,13.0,23518,2931.0,4630.0,269745,368681,591390
622,622,622,622,622,622,622,622,623,2021-04-27 15:00:00+00:00,Baltimore,2752.0,347915,5346.0,251573,78.0,23596,2830.0,5424.0,275169,371511,599488
623,623,623,623,623,623,623,623,624,2021-04-28 15:00:00+00:00,Baltimore,4787.0,352702,3563.0,255136,114.0,23710,4901.0,3677.0,278846,376412,607838
624,624,624,624,624,624,624,624,625,2021-04-29 15:00:00+00:00,Baltimore,3315.0,356017,6091.0,261227,121.0,23831,3436.0,6212.0,285058,379848,617244
625,625,625,625,625,625,625,625,626,2021-04-30 15:00:00+00:00,Baltimore,3706.0,359723,3254.0,264481,169.0,24000,3875.0,3423.0,288481,383723,624204
626,626,626,626,626,626,626,626,627,2021-05-01 15:00:00+00:00,Baltimore,2823.0,362546,2436.0,266917,88.0,24088,2911.0,2524.0,291005,386634,629463
627,627,627,627,627,627,627,627,628,2021-05-02 15:00:00+00:00,Baltimore,908.0,363454,1741.0,268658,85.0,24173,993.0,1826.0,292831,387627,632112
628,628,628,628,628,628,628,628,629,2021-05-03 15:00:00+00:00,Baltimore,1493.0,364947,2728.0,271386,191.0,24364,1684.0,2919.0,295750,389311,636333
629,629,629,629,629,629,629,629,630,2021-05-04 15:00:00+00:00,Baltimore,1426.0,366373,6593.0,277979,257.0,24621,1683.0,6850.0,302600,390994,644352
630,630,630,630,630,630,630,630,631,2021-05-05 15:00:00+00:00,Baltimore,2247.0,368620,4531.0,282510,269.0,24890,2516.0,4800.0,307400,393510,651130
631,631,631,631,631,631,631,631,632,2021-05-06 15:00:00+00:00,Baltimore,1813.0,370433,3491.0,286001,221.0,25111,2034.0,3712.0,311112,395544,656434
632,632,632,632,632,632,632,632,633,2021-05-07 15:00:00+00:00,Baltimore,2059.0,372492,3284.0,289285,295.0,25406,2354.0,3579.0,314691,397898,661777
633,633,633,633,633,633,633,633,634,2021-05-08 15:00:00+00:00,Baltimore,1205.0,373697,4457.0,293742,193.0,25599,1398.0,4650.0,319341,399296,667439
634,634,634,634,634,634,634,634,635,2021-05-09 15:00:00+00:00,Baltimore,744.0,374441,1469.0,295211,103.0,25702,847.0,1572.0,320913,400143,669652
635,635,635,635,635,635,635,635,636,2021-05-10 15:00:00+00:00,Baltimore,1127.0,375568,3524.0,298735,211.0,25913,1338.0,3735.0,324648,401481,674303
636,636,636,636,636,636,636,636,637,2021-05-11 15:00:00+00:00,Baltimore,1644.0,377212,2957.0,301692,222.0,26135,1866.0,3179.0,327827,403347,678904
637,637,637,637,637,637,637,637,638,2021-05-12 15:00:00+00:00,Baltimore,1760.0,378972,6482.0,308174,225.0,26360,1985.0,6707.0,334534,405332,687146
638,638,638,638,638,638,638,638,639,2021-05-13 15:00:00+00:00,Baltimore,2454.0,381426,2823.0,310997,266.0,26626,2720.0,3089.0,337623,408052,692423
639,639,639,639,639,639,639,639,640,2021-05-14 15:00:00+00:00,Baltimore,2539.0,383965,3239.0,314236,290.0,26916,2829.0,3529.0,341152,410881,698201
640,640,640,640,640,640,640,640,641,2021-05-15 15:00:00+00:00,Baltimore,2717.0,386682,2374.0,316610,170.0,27086,2887.0,2544.0,343696,413768,703292
641,641,641,641,641,641,641,641,642,2021-05-16 15:00:00+00:00,Baltimore,1384.0,388066,2749.0,319359,107.0,27193,1491.0,2856.0,346552,415259,707425
642,642,642,642,642,642,642,642,643,2021-05-17 15:00:00+00:00,Baltimore,1982.0,390048,2838.0,322197,260.0,27453,2242.0,3098.0,349650,417501,712245
643,643,643,643,643,643,643,643,644,2021-05-18 15:00:00+00:00,Baltimore,2539.0,392587,3142.0,325339,297.0,27750,2836.0,3439.0,353089,420337,717926
644,644,644,644,644,644,644,644,645,2021-05-19 15:00:00+00:00,Baltimore,3702.0,396289,4796.0,330135,177.0,27927,3879.0,4973.0,358062,424216,726424
645,645,645,645,645,645,645,645,646,2021-05-20 15:00:00+00:00,Baltimore,2411.0,398700,3527.0,333662,226.0,28153,2637.0,3753.0,361815,426853,732362
646,646,646,646,646,646,646,646,647,2021-05-21 15:00:00+00:00,Baltimore,2262.0,400962,3871.0,337533,196.0,28349,2458.0,4067.0,365882,429311,738495
647,647,647,647,647,647,647,647,648,2021-05-22 15:00:00+00:00,Baltimore,1961.0,402923,3037.0,340570,121.0,28470,2082.0,3158.0,369040,431393,743493
648,648,648,648,648,648,648,648,649,2021-05-23 15:00:00+00:00,Baltimore,1338.0,404261,1133.0,341703,93.0,28563,1431.0,1226.0,370266,432824,745964
649,649,649,649,649,649,649,649,650,2021-05-24 15:00:00+00:00,Baltimore,1709.0,405970,1885.0,343588,261.0,28824,1970.0,2146.0,372412,434794,749558
650,650,650,650,650,650,650,650,651,2021-05-25 15:00:00+00:00,Baltimore,1953.0,407923,1904.0,345492,196.0,29020,2149.0,2100.0,374512,436943,753415
651,651,651,651,651,651,651,651,652,2021-05-26 15:00:00+00:00,Baltimore,3173.0,411096,2243.0,347735,280.0,29300,3453.0,2523.0,377035,440396,758831
652,652,652,652,652,652,652,652,653,2021-05-27 15:00:00+00:00,Baltimore,1522.0,412618,2102.0,349837,131.0,29431,1653.0,2233.0,379268,442049,762455
653,653,653,653,653,653,653,653,654,2021-05-28 15:00:00+00:00,Baltimore,1723.0,414341,2400.0,352237,172.0,29603,1895.0,2572.0,381840,443944,766578
654,654,654,654,654,654,654,654,655,2021-05-29 15:00:00+00:00,Baltimore,1106.0,415447,1148.0,353385,108.0,29711,1214.0,1256.0,383096,445158,768832
655,655,655,655,655,655,655,655,656,2021-05-30 15:00:00+00:00,Baltimore,714.0,416161,837.0,354222,66.0,29777,780.0,903.0,383999,445938,770383
656,656,656,656,656,656,656,656,657,2021-05-31 15:00:00+00:00,Baltimore,242.0,416403,377.0,354599,41.0,29818,283.0,418.0,384417,446221,771002
657,657,657,657,657,657,657,657,658,2021-06-01 15:00:00+00:00,Baltimore,1370.0,417773,2297.0,356896,163.0,29981,1533.0,2460.0,386877,447754,774669
658,658,658,658,658,658,658,658,659,2021-06-02 15:00:00+00:00,Baltimore,1147.0,418920,1862.0,358758,136.0,30117,1283.0,1998.0,388875,449037,777678
659,659,659,659,659,659,659,659,660,2021-06-03 15:00:00+00:00,Baltimore,1026.0,419946,2474.0,361232,161.0,30278,1187.0,2635.0,391510,450224,781178
660,660,660,660,660,660,660,660,661,2021-06-04 15:00:00+00:00,Baltimore,1159.0,421105,2423.0,363655,161.0,30439,1320.0,2584.0,394094,451544,784760
661,661,661,661,661,661,661,661,662,2021-06-05 15:00:00+00:00,Baltimore,1001.0,422106,2602.0,366257,122.0,30561,1123.0,2724.0,396818,452667,788363
662,662,662,662,662,662,662,662,663,2021-06-06 15:00:00+00:00,Baltimore,475.0,422581,923.0,367180,57.0,30618,532.0,980.0,397798,453199,789761
663,663,663,663,663,663,663,663,664,2021-06-07 15:00:00+00:00,Baltimore,935.0,423516,1991.0,369171,134.0,30752,1069.0,2125.0,399923,454268,792687
664,664,664,664,664,664,664,664,665,2021-06-08 15:00:00+00:00,Baltimore,869.0,424385,2600.0,371771,110.0,30862,979.0,2710.0,402633,455247,796156
665,665,665,665,665,665,665,665,666,2021-06-09 15:00:00+00:00,Baltimore,982.0,425367,3376.0,375147,111.0,30973,1093.0,3487.0,406120,456340,800514
666,666,666,666,666,666,666,666,667,2021-06-10 15:00:00+00:00,Baltimore,1002.0,426369,2275.0,377422,127.0,31100,1129.0,2402.0,408522,457469,803791
667,667,667,667,667,667,667,667,668,2021-06-11 15:00:00+00:00,Baltimore,931.0,427300,2247.0,379669,148.0,31248,1079.0,2395.0,410917,458548,806969
668,668,668,668,668,668,668,668,669,2021-06-12 15:00:00+00:00,Baltimore,664.0,427964,1708.0,381377,68.0,31316,732.0,1776.0,412693,459280,809341
669,669,669,669,669,669,669,669,670,2021-06-13 15:00:00+00:00,Baltimore,225.0,428189,1118.0,382495,74.0,31390,299.0,1192.0,413885,459579,810684
670,670,670,670,670,670,670,670,671,2021-06-14 15:00:00+00:00,Baltimore,764.0,428953,1767.0,384262,123.0,31513,887.0,1890.0,415775,460466,813215
671,671,671,671,671,671,671,671,672,2021-06-15 15:00:00+00:00,Baltimore,774.0,429727,2016.0,386278,87.0,31600,861.0,2103.0,417878,461327,816005
672,672,672,672,672,672,672,672,673,2021-06-16 15:00:00+00:00,Baltimore,875.0,430602,3052.0,389330,87.0,31687,962.0,3139.0,421017,462289,819932
673,673,673,673,673,673,673,673,674,2021-06-17 15:00:00+00:00,Baltimore,830.0,431432,1627.0,390957,93.0,31780,923.0,1720.0,422737,463212,822389
674,674,674,674,674,674,674,674,675,2021-06-18 15:00:00+00:00,Baltimore,884.0,432316,1687.0,392644,105.0,31885,989.0,1792.0,424529,464201,824960
675,675,675,675,675,675,675,675,676,2021-06-19 15:00:00+00:00,Baltimore,632.0,432948,1120.0,393764,89.0,31974,721.0,1209.0,425738,464922,826712
676,676,676,676,676,676,676,676,677,2021-06-20 15:00:00+00:00,Baltimore,282.0,433230,720.0,394484,45.0,32019,327.0,765.0,426503,465249,827714
677,677,677,677,677,677,677,677,678,2021-06-21 15:00:00+00:00,Baltimore,722.0,433952,731.0,395215,114.0,32133,836.0,845.0,427348,466085,829167
678,678,678,678,678,678,678,678,679,2021-06-22 15:00:00+00:00,Baltimore,707.0,434659,1346.0,396561,91.0,32224,798.0,1437.0,428785,466883,831220
679,679,679,679,679,679,679,679,680,2021-06-23 15:00:00+00:00,Baltimore,788.0,435447,1228.0,397789,109.0,32333,897.0,1337.0,430122,467780,833236
680,680,680,680,680,680,680,680,681,2021-06-24 15:00:00+00:00,Baltimore,758.0,436205,1100.0,398889,64.0,32397,822.0,1164.0,431286,468602,835094
681,681,681,681,681,681,681,681,682,2021-06-25 15:00:00+00:00,Baltimore,705.0,436910,1101.0,399990,103.0,32500,808.0,1204.0,432490,469410,836900
682,682,682,682,682,682,682,682,683,2021-06-26 15:00:00+00:00,Baltimore,417.0,437327,875.0,400865,31.0,32531,448.0,906.0,433396,469858,838192
683,683,683,683,683,683,683,683,684,2021-06-27 15:00:00+00:00,Baltimore,321.0,437648,488.0,401353,27.0,32558,348.0,515.0,433911,470206,839001
684,684,684,684,684,684,684,684,685,2021-06-28 15:00:00+00:00,Baltimore,627.0,438275,834.0,402187,77.0,32635,704.0,911.0,434822,470910,840462
685,685,685,685,685,685,685,685,686,2021-06-29 15:00:00+00:00,Baltimore,717.0,438992,856.0,403043,90.0,32725,807.0,946.0,435768,471717,842035
686,686,686,686,686,686,686,686,687,2021-06-30 15:00:00+00:00,Baltimore,739.0,439731,922.0,403965,98.0,32823,837.0,1020.0,436788,472554,843696
687,687,687,687,687,687,687,687,688,2021-07-01 15:00:00+00:00,Baltimore,662.0,440393,957.0,404922,59.0,32882,721.0,1016.0,437804,473275,845315
688,688,688,688,688,688,688,688,689,2021-07-02 15:00:00+00:00,Baltimore,608.0,441001,893.0,405815,65.0,32947,673.0,958.0,438762,473948,846816
689,689,689,689,689,689,689,689,690,2021-07-03 15:00:00+00:00,Baltimore,389.0,441390,538.0,406353,27.0,32974,416.0,565.0,439327,474364,847743
690,690,690,690,690,690,690,690,691,2021-07-04 15:00:00+00:00,Baltimore,64.0,441454,63.0,406416,8.0,32982,72.0,71.0,439398,474436,847870
691,691,691,691,691,691,691,691,692,2021-07-05 15:00:00+00:00,Baltimore,485.0,441939,623.0,407039,41.0,33023,526.0,664.0,440062,474962,848978
692,692,692,692,692,692,692,692,693,2021-07-06 15:00:00+00:00,Baltimore,638.0,442577,839.0,407878,61.0,33084,699.0,900.0,440962,475661,850455
693,693,693,693,693,693,693,693,694,2021-07-07 15:00:00+00:00,Baltimore,528.0,443105,846.0,408724,57.0,33141,585.0,903.0,441865,476246,851829
694,694,694,694,694,694,694,694,695,2021-07-08 15:00:00+00:00,Baltimore,568.0,443673,791.0,409515,73.0,33214,641.0,864.0,442729,476887,853188
695,695,695,695,695,695,695,695,696,2021-07-09 15:00:00+00:00,Baltimore,587.0,444260,804.0,410319,123.0,33337,710.0,927.0,443656,477597,854579
696,696,696,696,696,696,696,696,697,2021-07-10 15:00:00+00:00,Baltimore,496.0,444756,605.0,410924,32.0,33369,528.0,637.0,444293,478125,855680
697,697,697,697,697,697,697,697,698,2021-07-11 15:00:00+00:00,Baltimore,296.0,445052,310.0,411234,29.0,33398,325.0,339.0,444632,478450,856286
698,698,698,698,698,698,698,698,699,2021-07-12 15:00:00+00:00,Baltimore,600.0,445652,730.0,411964,60.0,33458,660.0,790.0,445422,479110,857616
699,699,699,699,699,699,699,699,700,2021-07-13 15:00:00+00:00,Baltimore,524.0,446176,627.0,412591,45.0,33503,569.0,672.0,446094,479679,858767
700,700,700,700,700,700,700,700,701,2021-07-14 15:00:00+00:00,Baltimore,548.0,446724,666.0,413257,49.0,33552,597.0,715.0,446809,480276,859981
701,701,701,701,701,701,701,701,702,2021-07-15 15:00:00+00:00,Baltimore,586.0,447310,687.0,413944,63.0,33615,649.0,750.0,447559,480925,861254
702,702,702,702,702,702,702,702,703,2021-07-16 15:00:00+00:00,Baltimore,752.0,448062,711.0,414655,76.0,33691,828.0,787.0,448346,481753,862717
703,703,703,703,703,703,703,703,704,2021-07-17 15:00:00+00:00,Baltimore,423.0,448485,449.0,415104,24.0,33715,447.0,473.0,448819,482200,863589
704,704,704,704,704,704,704,704,705,2021-07-18 15:00:00+00:00,Baltimore,262.0,448747,282.0,415386,12.0,33727,274.0,294.0,449113,482474,864133
705,705,705,705,705,705,705,705,706,2021-07-19 15:00:00+00:00,Baltimore,730.0,449477,654.0,416040,55.0,33782,785.0,709.0,449822,483259,865517
706,706,706,706,706,706,706,706,707,2021-07-20 15:00:00+00:00,Baltimore,699.0,450176,698.0,416738,43.0,33825,742.0,741.0,450563,484001,866914
707,707,707,707,707,707,707,707,708,2021-07-21 15:00:00+00:00,Baltimore,781.0,450957,734.0,417472,60.0,33885,841.0,794.0,451357,484842,868429
708,708,708,708,708,708,708,708,709,2021-07-22 15:00:00+00:00,Baltimore,804.0,451761,669.0,418141,58.0,33943,862.0,727.0,452084,485704,869902
709,709,709,709,709,709,709,709,710,2021-07-23 15:00:00+00:00,Baltimore,892.0,452653,590.0,418731,63.0,34006,955.0,653.0,452737,486659,871384
710,710,710,710,710,710,710,710,711,2021-07-24 15:00:00+00:00,Baltimore,530.0,453183,422.0,419153,25.0,34031,555.0,447.0,453184,487214,872336
711,711,711,711,711,711,711,711,712,2021-07-25 15:00:00+00:00,Baltimore,445.0,453628,142.0,419295,9.0,34040,454.0,151.0,453335,487668,872923
712,712,712,712,712,712,712,712,713,2021-07-26 15:00:00+00:00,Baltimore,817.0,454445,551.0,419846,56.0,34096,873.0,607.0,453942,488541,874291
713,713,713,713,713,713,713,713,714,2021-07-27 15:00:00+00:00,Baltimore,815.0,455260,582.0,420428,51.0,34147,866.0,633.0,454575,489407,875688
714,714,714,714,714,714,714,714,715,2021-07-28 15:00:00+00:00,Baltimore,899.0,456159,497.0,420925,99.0,34246,998.0,596.0,455171,490405,877084
715,715,715,715,715,715,715,715,716,2021-07-29 15:00:00+00:00,Baltimore,966.0,457125,579.0,421504,52.0,34298,1018.0,631.0,455802,491423,878629
716,716,716,716,716,716,716,716,717,2021-07-30 15:00:00+00:00,Baltimore,911.0,458036,569.0,422073,87.0,34385,998.0,656.0,456458,492421,880109
717,717,717,717,717,717,717,717,718,2021-07-31 15:00:00+00:00,Baltimore,585.0,458621,444.0,422517,38.0,34423,623.0,482.0,456940,493044,881138
718,718,718,718,718,718,718,718,719,2021-08-01 15:00:00+00:00,Baltimore,493.0,459114,266.0,422783,16.0,34439,509.0,282.0,457222,493553,881897
719,719,719,719,719,719,719,719,720,2021-08-02 15:00:00+00:00,Baltimore,932.0,460046,532.0,423315,66.0,34505,998.0,598.0,457820,494551,883361
720,720,720,720,720,720,720,720,721,2021-08-03 15:00:00+00:00,Baltimore,889.0,460935,496.0,423811,50.0,34555,939.0,546.0,458366,495490,884746
721,721,721,721,721,721,721,721,722,2021-08-04 15:00:00+00:00,Baltimore,902.0,461837,488.0,424299,63.0,34618,965.0,551.0,458917,496455,886136
722,722,722,722,722,722,722,722,723,2021-08-05 15:00:00+00:00,Baltimore,1026.0,462863,592.0,424891,49.0,34667,1075.0,641.0,459558,497530,887754
723,723,723,723,723,723,723,723,724,2021-08-06 15:00:00+00:00,Baltimore,1098.0,463961,643.0,425534,94.0,34761,1192.0,737.0,460295,498722,889495
724,724,724,724,724,724,724,724,725,2021-08-07 15:00:00+00:00,Baltimore,679.0,464640,346.0,425880,34.0,34795,713.0,380.0,460675,499435,890520
725,725,725,725,725,725,725,725,726,2021-08-08 15:00:00+00:00,Baltimore,510.0,465150,262.0,426142,24.0,34819,534.0,286.0,460961,499969,891292
726,726,726,726,726,726,726,726,727,2021-08-09 15:00:00+00:00,Baltimore,976.0,466126,603.0,426745,57.0,34876,1033.0,660.0,461621,501002,892871
727,727,727,727,727,727,727,727,728,2021-08-10 15:00:00+00:00,Baltimore,960.0,467086,604.0,427349,44.0,34920,1004.0,648.0,462269,502006,894435
728,728,728,728,728,728,728,728,729,2021-08-11 15:00:00+00:00,Baltimore,949.0,468035,620.0,427969,40.0,34960,989.0,660.0,462929,502995,896004
729,729,729,729,729,729,729,729,730,2021-08-12 15:00:00+00:00,Baltimore,839.0,468874,667.0,428636,42.0,35002,881.0,709.0,463638,503876,897510
730,730,730,730,730,730,730,730,731,2021-08-13 15:00:00+00:00,Baltimore,898.0,469772,729.0,429365,52.0,35054,950.0,781.0,464419,504826,899137
731,731,731,731,731,731,731,731,732,2021-08-14 15:00:00+00:00,Baltimore,616.0,470388,468.0,429833,59.0,35113,675.0,527.0,464946,505501,900221
732,732,732,732,732,732,732,732,733,2021-08-15 15:00:00+00:00,Baltimore,427.0,470815,384.0,430217,30.0,35143,457.0,414.0,465360,505958,901032
733,733,733,733,733,733,733,733,734,2021-08-16 15:00:00+00:00,Baltimore,687.0,471502,700.0,430917,58.0,35201,745.0,758.0,466118,506703,902419
734,734,734,734,734,734,734,734,735,2021-08-17 15:00:00+00:00,Baltimore,822.0,472324,755.0,431672,42.0,35243,864.0,797.0,466915,507567,903996
735,735,735,735,735,735,735,735,736,2021-08-18 15:00:00+00:00,Baltimore,805.0,473129,716.0,432388,48.0,35291,853.0,764.0,467679,508420,905517
736,736,736,736,736,736,736,736,737,2021-08-19 15:00:00+00:00,Baltimore,762.0,473891,805.0,433193,35.0,35326,797.0,840.0,468519,509217,907084
737,737,737,737,737,737,737,737,738,2021-08-20 15:00:00+00:00,Baltimore,818.0,474709,804.0,433997,71.0,35397,889.0,875.0,469394,510106,908706
738,738,738,738,738,738,738,738,739,2021-08-21 15:00:00+00:00,Baltimore,508.0,475217,557.0,434554,30.0,35427,538.0,587.0,469981,510644,909771
739,739,739,739,739,739,739,739,740,2021-08-22 15:00:00+00:00,Baltimore,407.0,475624,417.0,434971,13.0,35440,420.0,430.0,470411,511064,910595
740,740,740,740,740,740,740,740,741,2021-08-23 15:00:00+00:00,Baltimore,790.0,476414,803.0,435774,51.0,35491,841.0,854.0,471265,511905,912188
741,741,741,741,741,741,741,741,742,2021-08-24 15:00:00+00:00,Baltimore,858.0,477272,823.0,436597,38.0,35529,896.0,861.0,472126,512801,913869
742,742,742,742,742,742,742,742,743,2021-08-25 15:00:00+00:00,Baltimore,886.0,478158,789.0,437386,41.0,35570,927.0,830.0,472956,513728,915544
743,743,743,743,743,743,743,743,744,2021-08-26 15:00:00+00:00,Baltimore,855.0,479013,871.0,438257,51.0,35621,906.0,922.0,473878,514634,917270
744,744,744,744,744,744,744,744,745,2021-08-27 15:00:00+00:00,Baltimore,800.0,479813,937.0,439194,31.0,35652,831.0,968.0,474846,515465,919007
745,745,745,745,745,745,745,745,746,2021-08-28 15:00:00+00:00,Baltimore,548.0,480361,590.0,439784,31.0,35683,579.0,621.0,475467,516044,920145
746,746,746,746,746,746,746,746,747,2021-08-29 15:00:00+00:00,Baltimore,460.0,480821,455.0,440239,22.0,35705,482.0,477.0,475944,516526,921060
747,747,747,747,747,747,747,747,748,2021-08-30 15:00:00+00:00,Baltimore,725.0,481546,870.0,441109,26.0,35731,751.0,896.0,476840,517277,922655
748,748,748,748,748,748,748,748,749,2021-08-31 15:00:00+00:00,Baltimore,697.0,482243,827.0,441936,40.0,35771,737.0,867.0,477707,518014,924179
749,749,749,749,749,749,749,749,750,2021-09-01 15:00:00+00:00,Baltimore,647.0,482890,717.0,442653,33.0,35804,680.0,750.0,478457,518694,925543
750,750,750,750,750,750,750,750,751,2021-09-02 15:00:00+00:00,Baltimore,634.0,483524,750.0,443403,20.0,35824,654.0,770.0,479227,519348,926927
751,751,751,751,751,751,751,751,752,2021-09-03 15:00:00+00:00,Baltimore,687.0,484211,844.0,444247,25.0,35849,712.0,869.0,480096,520060,928458
752,752,752,752,752,752,752,752,753,2021-09-04 15:00:00+00:00,Baltimore,369.0,484580,551.0,444798,17.0,35866,386.0,568.0,480664,520446,929378
753,753,753,753,753,753,753,753,754,2021-09-05 15:00:00+00:00,Baltimore,374.0,484954,402.0,445200,14.0,35880,388.0,416.0,481080,520834,930154
754,754,754,754,754,754,754,754,755,2021-09-06 15:00:00+00:00,Baltimore,147.0,485101,168.0,445368,7.0,35887,154.0,175.0,481255,520988,930469
755,755,755,755,755,755,755,755,756,2021-09-07 15:00:00+00:00,Baltimore,580.0,485681,983.0,446351,29.0,35916,609.0,1012.0,482267,521597,932032
756,756,756,756,756,756,756,756,757,2021-09-08 15:00:00+00:00,Baltimore,516.0,486197,719.0,447070,34.0,35950,550.0,753.0,483020,522147,933267
757,757,757,757,757,757,757,757,758,2021-09-09 15:00:00+00:00,Baltimore,680.0,486877,716.0,447786,42.0,35992,722.0,758.0,483778,522869,934663
758,758,758,758,758,758,758,758,759,2021-09-10 15:00:00+00:00,Baltimore,668.0,487545,775.0,448561,41.0,36033,709.0,816.0,484594,523578,936106
759,759,759,759,759,759,759,759,760,2021-09-11 15:00:00+00:00,Baltimore,423.0,487968,528.0,449089,56.0,36089,479.0,584.0,485178,524057,937057
760,760,760,760,760,760,760,760,761,2021-09-12 15:00:00+00:00,Baltimore,337.0,488305,426.0,449515,10.0,36099,347.0,436.0,485614,524404,937820
761,761,761,761,761,761,761,761,762,2021-09-13 15:00:00+00:00,Baltimore,593.0,488898,702.0,450217,29.0,36128,622.0,731.0,486345,525026,939115
762,762,762,762,762,762,762,762,763,2021-09-14 15:00:00+00:00,Baltimore,587.0,489485,700.0,450917,52.0,36180,639.0,752.0,487097,525665,940402
763,763,763,763,763,763,763,763,764,2021-09-15 15:00:00+00:00,Baltimore,474.0,489959,737.0,451654,39.0,36219,513.0,776.0,487873,526178,941613
764,764,764,764,764,764,764,764,765,2021-09-16 15:00:00+00:00,Baltimore,466.0,490425,738.0,452392,35.0,36254,501.0,773.0,488646,526679,942817
765,765,765,765,765,765,765,765,766,2021-09-17 15:00:00+00:00,Baltimore,562.0,490987,785.0,453177,21.0,36275,583.0,806.0,489452,527262,944164
766,766,766,766,766,766,766,766,767,2021-09-18 15:00:00+00:00,Baltimore,379.0,491366,472.0,453649,20.0,36295,399.0,492.0,489944,527661,945015
767,767,767,767,767,767,767,767,768,2021-09-19 15:00:00+00:00,Baltimore,274.0,491640,411.0,454060,4.0,36299,278.0,415.0,490359,527939,945700
768,768,768,768,768,768,768,768,769,2021-09-20 15:00:00+00:00,Baltimore,368.0,492008,499.0,454559,24.0,36323,392.0,523.0,490882,528331,946567
769,769,769,769,769,769,769,769,770,2021-09-21 15:00:00+00:00,Baltimore,410.0,492418,617.0,455176,24.0,36347,434.0,641.0,491523,528765,947594
770,770,770,770,770,770,770,770,771,2021-09-22 15:00:00+00:00,Baltimore,425.0,492843,619.0,455795,13.0,36360,438.0,632.0,492155,529203,948638
771,771,771,771,771,771,771,771,772,2021-09-23 15:00:00+00:00,Baltimore,426.0,493269,598.0,456393,24.0,36384,450.0,622.0,492777,529653,949662
772,772,772,772,772,772,772,772,773,2021-09-24 15:00:00+00:00,Baltimore,478.0,493747,621.0,457014,25.0,36409,503.0,646.0,493423,530156,950761
773,773,773,773,773,773,773,773,774,2021-09-25 15:00:00+00:00,Baltimore,321.0,494068,367.0,457381,13.0,36422,334.0,380.0,493803,530490,951449
774,774,774,774,774,774,774,774,775,2021-09-26 15:00:00+00:00,Baltimore,195.0,494263,334.0,457715,5.0,36427,200.0,339.0,494142,530690,951978
775,775,775,775,775,775,775,775,776,2021-09-27 15:00:00+00:00,Baltimore,455.0,494718,342.0,458057,27.0,36454,482.0,369.0,494511,531172,952775
776,776,776,776,776,776,776,776,777,2021-09-28 15:00:00+00:00,Baltimore,478.0,495196,544.0,458601,20.0,36474,498.0,564.0,495075,531670,953797
777,777,777,777,777,777,777,777,778,2021-09-29 15:00:00+00:00,Baltimore,495.0,495691,494.0,459095,26.0,36500,521.0,520.0,495595,532191,954786
778,778,778,778,778,778,778,778,779,2021-09-30 15:00:00+00:00,Baltimore,507.0,496198,592.0,459687,33.0,36533,540.0,625.0,496220,532731,955885
779,779,779,779,779,779,779,779,780,2021-10-01 15:00:00+00:00,Baltimore,525.0,496723,666.0,460353,29.0,36562,554.0,695.0,496915,533285,957076
780,780,780,780,780,780,780,780,781,2021-10-02 15:00:00+00:00,Baltimore,323.0,497046,366.0,460719,9.0,36571,332.0,375.0,497290,533617,957765
781,781,781,781,781,781,781,781,782,2021-10-03 15:00:00+00:00,Baltimore,232.0,497278,279.0,460998,7.0,36578,239.0,286.0,497576,533856,958276
782,782,782,782,782,782,782,782,783,2021-10-04 15:00:00+00:00,Baltimore,424.0,497702,457.0,461455,31.0,36609,455.0,488.0,498064,534311,959157
783,783,783,783,783,783,783,783,784,2021-10-05 15:00:00+00:00,Baltimore,418.0,498120,516.0,461971,20.0,36629,438.0,536.0,498600,534749,960091
784,784,784,784,784,784,784,784,785,2021-10-06 15:00:00+00:00,Baltimore,396.0,498516,437.0,462408,25.0,36654,421.0,462.0,499062,535170,960924
785,785,785,785,785,785,785,785,786,2021-10-07 15:00:00+00:00,Baltimore,448.0,498964,433.0,462841,34.0,36688,482.0,467.0,499529,535652,961805
786,786,786,786,786,786,786,786,787,2021-10-08 15:00:00+00:00,Baltimore,511.0,499475,495.0,463336,20.0,36708,531.0,515.0,500044,536183,962811
787,787,787,787,787,787,787,787,788,2021-10-09 15:00:00+00:00,Baltimore,276.0,499751,326.0,463662,14.0,36722,290.0,340.0,500384,536473,963413
788,788,788,788,788,788,788,788,789,2021-10-10 15:00:00+00:00,Baltimore,187.0,499938,221.0,463883,16.0,36738,203.0,237.0,500621,536676,963821
789,789,789,789,789,789,789,789,790,2021-10-11 15:00:00+00:00,Baltimore,408.0,500346,435.0,464318,35.0,36773,443.0,470.0,501091,537119,964664
790,790,790,790,790,790,790,790,791,2021-10-12 15:00:00+00:00,Baltimore,396.0,500742,431.0,464749,33.0,36806,429.0,464.0,501555,537548,965491
791,791,791,791,791,791,791,791,792,2021-10-13 15:00:00+00:00,Baltimore,437.0,501179,399.0,465148,29.0,36835,466.0,428.0,501983,538014,966327
792,792,792,792,792,792,792,792,793,2021-10-14 15:00:00+00:00,Baltimore,446.0,501625,415.0,465563,24.0,36859,470.0,439.0,502422,538484,967188
793,793,793,793,793,793,793,793,794,2021-10-15 15:00:00+00:00,Baltimore,439.0,502064,502.0,466065,29.0,36888,468.0,531.0,502953,538952,968129
794,794,794,794,794,794,794,794,795,2021-10-16 15:00:00+00:00,Baltimore,237.0,502301,256.0,466321,8.0,36896,245.0,264.0,503217,539197,968622
795,795,795,795,795,795,795,795,796,2021-10-17 15:00:00+00:00,Baltimore,134.0,502435,137.0,466458,2.0,36898,136.0,139.0,503356,539333,968893
796,796,796,796,796,796,796,796,797,2021-10-18 15:00:00+00:00,Baltimore,402.0,502837,381.0,466839,29.0,36927,431.0,410.0,503766,539764,969676
797,797,797,797,797,797,797,797,798,2021-10-19 15:00:00+00:00,Baltimore,373.0,503210,383.0,467222,23.0,36950,396.0,406.0,504172,540160,970432
798,798,798,798,798,798,798,798,799,2021-10-20 15:00:00+00:00,Baltimore,321.0,503531,397.0,467619,25.0,36975,346.0,422.0,504594,540506,971150
799,799,799,799,799,799,799,799,800,2021-10-21 15:00:00+00:00,Baltimore,366.0,503897,455.0,468074,32.0,37007,398.0,487.0,505081,540904,971971
800,800,800,800,800,800,800,800,801,2021-10-22 15:00:00+00:00,Baltimore,393.0,504290,596.0,468670,23.0,37030,416.0,619.0,505700,541320,972960
801,801,801,801,801,801,801,801,802,2021-10-23 15:00:00+00:00,Baltimore,242.0,504532,397.0,469067,15.0,37045,257.0,412.0,506112,541577,973599
802,802,802,802,802,802,802,802,803,2021-10-24 15:00:00+00:00,Baltimore,159.0,504691,256.0,469323,1.0,37046,160.0,257.0,506369,541737,974014
803,803,803,803,803,803,803,803,804,2021-10-25 15:00:00+00:00,Baltimore,410.0,505101,688.0,470011,43.0,37089,453.0,731.0,507100,542190,975112
804,804,804,804,804,804,804,804,805,2021-10-26 15:00:00+00:00,Baltimore,373.0,505474,700.0,470711,25.0,37114,398.0,725.0,507825,542588,976185
805,805,805,805,805,805,805,805,806,2021-10-27 15:00:00+00:00,Baltimore,392.0,505866,691.0,471402,31.0,37145,423.0,722.0,508547,543011,977268
806,806,806,806,806,806,806,806,807,2021-10-28 15:00:00+00:00,Baltimore,386.0,506252,696.0,472098,35.0,37180,421.0,731.0,509278,543432,978350
807,807,807,807,807,807,807,807,808,2021-10-29 15:00:00+00:00,Baltimore,374.0,506626,724.0,472822,47.0,37227,421.0,771.0,510049,543853,979448
808,808,808,808,808,808,808,808,809,2021-10-30 15:00:00+00:00,Baltimore,215.0,506841,389.0,473211,16.0,37243,231.0,405.0,510454,544084,980052
809,809,809,809,809,809,809,809,810,2021-10-31 15:00:00+00:00,Baltimore,133.0,506974,220.0,473431,,37243,,,510674,544217,980405
810,810,810,810,810,810,810,810,811,2021-11-01 15:00:00+00:00,Baltimore,398.0,507372,668.0,474099,38.0,37281,436.0,706.0,511380,544653,981471
811,811,811,811,811,811,811,811,812,2021-11-02 15:00:00+00:00,Baltimore,376.0,507748,577.0,474676,34.0,37315,410.0,611.0,511991,545063,982424
812,812,812,812,812,812,812,812,813,2021-11-03 15:00:00+00:00,Baltimore,393.0,508141,668.0,475344,31.0,37346,424.0,699.0,512690,545487,983485
813,813,813,813,813,813,813,813,814,2021-11-04 15:00:00+00:00,Baltimore,311.0,508452,711.0,476055,36.0,37382,347.0,747.0,513437,545834,984507
814,814,814,814,814,814,814,814,815,2021-11-05 15:00:00+00:00,Baltimore,388.0,508840,669.0,476724,24.0,37406,412.0,693.0,514130,546246,985564
815,815,815,815,815,815,815,815,816,2021-11-06 15:00:00+00:00,Baltimore,60.0,508900,125.0,476849,8.0,37414,68.0,133.0,514263,546314,985749
816,816,816,816,816,816,816,816,817,2020-12-15 15:00:00+00:00,Baltimore City,4.0,4,,0,,0,,,0,4,4
817,817,817,817,817,817,817,817,818,2020-12-16 15:00:00+00:00,Baltimore City,162.0,166,,0,,0,,,0,166,166
818,818,818,818,818,818,818,818,819,2020-12-17 15:00:00+00:00,Baltimore City,246.0,412,1.0,1,,0,,,1,412,413
819,819,819,819,819,819,819,819,820,2020-12-18 15:00:00+00:00,Baltimore City,394.0,806,,1,,0,,,1,806,807
820,820,820,820,820,820,820,820,821,2020-12-19 15:00:00+00:00,Baltimore City,94.0,900,,1,,0,,,1,900,901
821,821,821,821,821,821,821,821,822,2020-12-20 15:00:00+00:00,Baltimore City,53.0,953,,1,,0,,,1,953,954
822,822,822,822,822,822,822,822,823,2020-12-21 15:00:00+00:00,Baltimore City,530.0,1483,,1,,0,,,1,1483,1484
823,823,823,823,823,823,823,823,824,2020-12-22 15:00:00+00:00,Baltimore City,584.0,2067,1.0,2,,0,,,2,2067,2069
824,824,824,824,824,824,824,824,825,2020-12-23 15:00:00+00:00,Baltimore City,638.0,2705,,2,,0,,,2,2705,2707
825,825,825,825,825,825,825,825,826,2020-12-24 15:00:00+00:00,Baltimore City,451.0,3156,1.0,3,,0,,,3,3156,3159
826,826,826,826,826,826,826,826,827,2020-12-25 15:00:00+00:00,Baltimore City,12.0,3168,1.0,4,,0,,,4,3168,3172
827,827,827,827,827,827,827,827,828,2020-12-26 15:00:00+00:00,Baltimore City,196.0,3364,,4,,0,,,4,3364,3368
828,828,828,828,828,828,828,828,829,2020-12-27 15:00:00+00:00,Baltimore City,149.0,3513,,4,,0,,,4,3513,3517
829,829,829,829,829,829,829,829,830,2020-12-28 15:00:00+00:00,Baltimore City,1347.0,4860,2.0,6,,0,,,6,4860,4866
830,830,830,830,830,830,830,830,831,2020-12-29 15:00:00+00:00,Baltimore City,1236.0,6096,2.0,8,,0,,,8,6096,6104
831,831,831,831,831,831,831,831,832,2020-12-30 15:00:00+00:00,Baltimore City,1139.0,7235,3.0,11,,0,,,11,7235,7246
832,832,832,832,832,832,832,832,833,2020-12-31 15:00:00+00:00,Baltimore City,730.0,7965,1.0,12,,0,,,12,7965,7977
833,833,833,833,833,833,833,833,834,2021-01-01 15:00:00+00:00,Baltimore City,143.0,8108,6.0,18,,0,,,18,8108,8126
834,834,834,834,834,834,834,834,835,2021-01-02 15:00:00+00:00,Baltimore City,553.0,8661,8.0,26,,0,,,26,8661,8687
835,835,835,835,835,835,835,835,836,2021-01-03 15:00:00+00:00,Baltimore City,446.0,9107,30.0,56,,0,,,56,9107,9163
836,836,836,836,836,836,836,836,837,2021-01-04 15:00:00+00:00,Baltimore City,1247.0,10354,95.0,151,,0,,,151,10354,10505
837,837,837,837,837,837,837,837,838,2021-01-05 15:00:00+00:00,Baltimore City,1360.0,11714,88.0,239,,0,,,239,11714,11953
838,838,838,838,838,838,838,838,839,2021-01-06 15:00:00+00:00,Baltimore City,1287.0,13001,199.0,438,,0,,,438,13001,13439
839,839,839,839,839,839,839,839,840,2021-01-07 15:00:00+00:00,Baltimore City,1348.0,14349,298.0,736,,0,,,736,14349,15085
840,840,840,840,840,840,840,840,841,2021-01-08 15:00:00+00:00,Baltimore City,1361.0,15710,328.0,1064,,0,,,1064,15710,16774
841,841,841,841,841,841,841,841,842,2021-01-09 15:00:00+00:00,Baltimore City,399.0,16109,143.0,1207,,0,,,1207,16109,17316
842,842,842,842,842,842,842,842,843,2021-01-10 15:00:00+00:00,Baltimore City,282.0,16391,62.0,1269,,0,,,1269,16391,17660
843,843,843,843,843,843,843,843,844,2021-01-11 15:00:00+00:00,Baltimore City,1654.0,18045,491.0,1760,,0,,,1760,18045,19805
844,844,844,844,844,844,844,844,845,2021-01-12 15:00:00+00:00,Baltimore City,1727.0,19772,547.0,2307,,0,,,2307,19772,22079
845,845,845,845,845,845,845,845,846,2021-01-13 15:00:00+00:00,Baltimore City,1694.0,21466,409.0,2716,,0,,,2716,21466,24182
846,846,846,846,846,846,846,846,847,2021-01-14 15:00:00+00:00,Baltimore City,1813.0,23279,368.0,3084,,0,,,3084,23279,26363
847,847,847,847,847,847,847,847,848,2021-01-15 15:00:00+00:00,Baltimore City,1429.0,24708,168.0,3252,,0,,,3252,24708,27960
848,848,848,848,848,848,848,848,849,2021-01-16 15:00:00+00:00,Baltimore City,481.0,25189,291.0,3543,,0,,,3543,25189,28732
849,849,849,849,849,849,849,849,850,2021-01-17 15:00:00+00:00,Baltimore City,258.0,25447,235.0,3778,,0,,,3778,25447,29225
850,850,850,850,850,850,850,850,851,2021-01-18 15:00:00+00:00,Baltimore City,697.0,26144,220.0,3998,,0,,,3998,26144,30142
851,851,851,851,851,851,851,851,852,2021-01-19 15:00:00+00:00,Baltimore City,1507.0,27651,717.0,4715,,0,,,4715,27651,32366
852,852,852,852,852,852,852,852,853,2021-01-20 15:00:00+00:00,Baltimore City,1838.0,29489,623.0,5338,,0,,,5338,29489,34827
853,853,853,853,853,853,853,853,854,2021-01-21 15:00:00+00:00,Baltimore City,1981.0,31470,641.0,5979,,0,,,5979,31470,37449
854,854,854,854,854,854,854,854,855,2021-01-22 15:00:00+00:00,Baltimore City,2409.0,33879,409.0,6388,,0,,,6388,33879,40267
855,855,855,855,855,855,855,855,856,2021-01-23 15:00:00+00:00,Baltimore City,1063.0,34942,287.0,6675,,0,,,6675,34942,41617
856,856,856,856,856,856,856,856,857,2021-01-24 15:00:00+00:00,Baltimore City,271.0,35213,170.0,6845,,0,,,6845,35213,42058
857,857,857,857,857,857,857,857,858,2021-01-25 15:00:00+00:00,Baltimore City,1552.0,36765,860.0,7705,,0,,,7705,36765,44470
858,858,858,858,858,858,858,858,859,2021-01-26 15:00:00+00:00,Baltimore City,1687.0,38452,949.0,8654,,0,,,8654,38452,47106
859,859,859,859,859,859,859,859,860,2021-01-27 15:00:00+00:00,Baltimore City,1998.0,40450,1096.0,9750,,0,,,9750,40450,50200
860,860,860,860,860,860,860,860,861,2021-01-28 15:00:00+00:00,Baltimore City,1763.0,42213,812.0,10562,,0,,,10562,42213,52775
861,861,861,861,861,861,861,861,862,2021-01-29 15:00:00+00:00,Baltimore City,2015.0,44228,1012.0,11574,,0,,,11574,44228,55802
862,862,862,862,862,862,862,862,863,2021-01-30 15:00:00+00:00,Baltimore City,1143.0,45371,385.0,11959,,0,,,11959,45371,57330
863,863,863,863,863,863,863,863,864,2021-01-31 15:00:00+00:00,Baltimore City,362.0,45733,217.0,12176,,0,,,12176,45733,57909
864,864,864,864,864,864,864,864,865,2021-02-01 15:00:00+00:00,Baltimore City,388.0,46121,572.0,12748,,0,,,12748,46121,58869
865,865,865,865,865,865,865,865,866,2021-02-02 15:00:00+00:00,Baltimore City,759.0,46880,1457.0,14205,,0,,,14205,46880,61085
866,866,866,866,866,866,866,866,867,2021-02-03 15:00:00+00:00,Baltimore City,1587.0,48467,1856.0,16061,,0,,,16061,48467,64528
867,867,867,867,867,867,867,867,868,2021-02-04 15:00:00+00:00,Baltimore City,1420.0,49887,1797.0,17858,,0,,,17858,49887,67745
868,868,868,868,868,868,868,868,869,2021-02-05 15:00:00+00:00,Baltimore City,1517.0,51404,1288.0,19146,,0,,,19146,51404,70550
869,869,869,869,869,869,869,869,870,2021-02-06 15:00:00+00:00,Baltimore City,1152.0,52556,441.0,19587,,0,,,19587,52556,72143
870,870,870,870,870,870,870,870,871,2021-02-07 15:00:00+00:00,Baltimore City,742.0,53298,202.0,19789,,0,,,19789,53298,73087
871,871,871,871,871,871,871,871,872,2021-02-08 15:00:00+00:00,Baltimore City,1137.0,54435,1233.0,21022,,0,,,21022,54435,75457
872,872,872,872,872,872,872,872,873,2021-02-09 15:00:00+00:00,Baltimore City,1092.0,55527,1312.0,22334,,0,,,22334,55527,77861
873,873,873,873,873,873,873,873,874,2021-02-10 15:00:00+00:00,Baltimore City,1430.0,56957,1504.0,23838,,0,,,23838,56957,80795
874,874,874,874,874,874,874,874,875,2021-02-11 15:00:00+00:00,Baltimore City,1413.0,58370,1490.0,25328,,0,,,25328,58370,83698
875,875,875,875,875,875,875,875,876,2021-02-12 15:00:00+00:00,Baltimore City,1555.0,59925,1545.0,26873,,0,,,26873,59925,86798
876,876,876,876,876,876,876,876,877,2021-02-13 15:00:00+00:00,Baltimore City,1410.0,61335,744.0,27617,,0,,,27617,61335,88952
877,877,877,877,877,877,877,877,878,2021-02-14 15:00:00+00:00,Baltimore City,224.0,61559,149.0,27766,,0,,,27766,61559,89325
878,878,878,878,878,878,878,878,879,2021-02-15 15:00:00+00:00,Baltimore City,942.0,62501,1292.0,29058,,0,,,29058,62501,91559
879,879,879,879,879,879,879,879,880,2021-02-16 15:00:00+00:00,Baltimore City,1318.0,63819,2136.0,31194,,0,,,31194,63819,95013
880,880,880,880,880,880,880,880,881,2021-02-17 15:00:00+00:00,Baltimore City,1171.0,64990,2043.0,33237,,0,,,33237,64990,98227
881,881,881,881,881,881,881,881,882,2021-02-18 15:00:00+00:00,Baltimore City,166.0,65156,278.0,33515,,0,,,33515,65156,98671
882,882,882,882,882,882,882,882,883,2021-02-19 15:00:00+00:00,Baltimore City,857.0,66013,1503.0,35018,,0,,,35018,66013,101031
883,883,883,883,883,883,883,883,884,2021-02-20 15:00:00+00:00,Baltimore City,917.0,66930,1269.0,36287,,0,,,36287,66930,103217
884,884,884,884,884,884,884,884,885,2021-02-21 15:00:00+00:00,Baltimore City,232.0,67162,287.0,36574,,0,,,36574,67162,103736
885,885,885,885,885,885,885,885,886,2021-02-22 15:00:00+00:00,Baltimore City,423.0,67585,1369.0,37943,,0,,,37943,67585,105528
886,886,886,886,886,886,886,886,887,2021-02-23 15:00:00+00:00,Baltimore City,1467.0,69052,1187.0,39130,,0,,,39130,69052,108182
887,887,887,887,887,887,887,887,888,2021-02-24 15:00:00+00:00,Baltimore City,1576.0,70628,1750.0,40880,,0,,,40880,70628,111508
888,888,888,888,888,888,888,888,889,2021-02-25 15:00:00+00:00,Baltimore City,1404.0,72032,2225.0,43105,,0,,,43105,72032,115137
889,889,889,889,889,889,889,889,890,2021-02-26 15:00:00+00:00,Baltimore City,2327.0,74359,2230.0,45335,,0,,,45335,74359,119694
890,890,890,890,890,890,890,890,891,2021-02-27 15:00:00+00:00,Baltimore City,1489.0,75848,1154.0,46489,,0,,,46489,75848,122337
891,891,891,891,891,891,891,891,892,2021-02-28 15:00:00+00:00,Baltimore City,1048.0,76896,431.0,46920,,0,,,46920,76896,123816
892,892,892,892,892,892,892,892,893,2021-03-01 15:00:00+00:00,Baltimore City,1894.0,78790,996.0,47916,,0,,,47916,78790,126706
893,893,893,893,893,893,893,893,894,2021-03-02 15:00:00+00:00,Baltimore City,1650.0,80440,833.0,48749,,0,,,48749,80440,129189
894,894,894,894,894,894,894,894,895,2021-03-03 15:00:00+00:00,Baltimore City,2921.0,83361,1518.0,50267,3.0,3,2924.0,1521.0,50270,83364,133628
895,895,895,895,895,895,895,895,896,2021-03-04 15:00:00+00:00,Baltimore City,2905.0,86266,1551.0,51818,371.0,374,3276.0,1922.0,52192,86640,138084
896,896,896,896,896,896,896,896,897,2021-03-05 15:00:00+00:00,Baltimore City,2431.0,88697,1497.0,53315,283.0,657,2714.0,1780.0,53972,89354,142012
897,897,897,897,897,897,897,897,898,2021-03-06 15:00:00+00:00,Baltimore City,1641.0,90338,1308.0,54623,385.0,1042,2026.0,1693.0,55665,91380,144961
898,898,898,898,898,898,898,898,899,2021-03-07 15:00:00+00:00,Baltimore City,629.0,90967,428.0,55051,643.0,1685,1272.0,1071.0,56736,92652,146018
899,899,899,899,899,899,899,899,900,2021-03-08 15:00:00+00:00,Baltimore City,2095.0,93062,677.0,55728,703.0,2388,2798.0,1380.0,58116,95450,148790
900,900,900,900,900,900,900,900,901,2021-03-09 15:00:00+00:00,Baltimore City,2882.0,95944,863.0,56591,567.0,2955,3449.0,1430.0,59546,98899,152535
901,901,901,901,901,901,901,901,902,2021-03-10 15:00:00+00:00,Baltimore City,2390.0,98334,1329.0,57920,584.0,3539,2974.0,1913.0,61459,101873,156254
902,902,902,902,902,902,902,902,903,2021-03-11 15:00:00+00:00,Baltimore City,3562.0,101896,1045.0,58965,208.0,3747,3770.0,1253.0,62712,105643,160861
903,903,903,903,903,903,903,903,904,2021-03-12 15:00:00+00:00,Baltimore City,2856.0,104752,1279.0,60244,148.0,3895,3004.0,1427.0,64139,108647,164996
904,904,904,904,904,904,904,904,905,2021-03-13 15:00:00+00:00,Baltimore City,2061.0,106813,872.0,61116,83.0,3978,2144.0,955.0,65094,110791,167929
905,905,905,905,905,905,905,905,906,2021-03-14 15:00:00+00:00,Baltimore City,1201.0,108014,366.0,61482,21.0,3999,1222.0,387.0,65481,112013,169496
906,906,906,906,906,906,906,906,907,2021-03-15 15:00:00+00:00,Baltimore City,2310.0,110324,819.0,62301,14.0,4013,2324.0,833.0,66314,114337,172625
907,907,907,907,907,907,907,907,908,2021-03-16 15:00:00+00:00,Baltimore City,2713.0,113037,991.0,63292,238.0,4251,2951.0,1229.0,67543,117288,176329
908,908,908,908,908,908,908,908,909,2021-03-17 15:00:00+00:00,Baltimore City,2900.0,115937,920.0,64212,470.0,4721,3370.0,1390.0,68933,120658,180149
909,909,909,909,909,909,909,909,910,2021-03-18 15:00:00+00:00,Baltimore City,3937.0,119874,1013.0,65225,206.0,4927,4143.0,1219.0,70152,124801,185099
910,910,910,910,910,910,910,910,911,2021-03-19 15:00:00+00:00,Baltimore City,2844.0,122718,1240.0,66465,63.0,4990,2907.0,1303.0,71455,127708,189183
911,911,911,911,911,911,911,911,912,2021-03-20 15:00:00+00:00,Baltimore City,1848.0,124566,1056.0,67521,60.0,5050,1908.0,1116.0,72571,129616,192087
912,912,912,912,912,912,912,912,913,2021-03-21 15:00:00+00:00,Baltimore City,1346.0,125912,664.0,68185,57.0,5107,1403.0,721.0,73292,131019,194097
913,913,913,913,913,913,913,913,914,2021-03-22 15:00:00+00:00,Baltimore City,2588.0,128500,822.0,69007,36.0,5143,2624.0,858.0,74150,133643,197507
914,914,914,914,914,914,914,914,915,2021-03-23 15:00:00+00:00,Baltimore City,3453.0,131953,1654.0,70661,231.0,5374,3684.0,1885.0,76035,137327,202614
915,915,915,915,915,915,915,915,916,2021-03-24 15:00:00+00:00,Baltimore City,2719.0,134672,2369.0,73030,122.0,5496,2841.0,2491.0,78526,140168,207702
916,916,916,916,916,916,916,916,917,2021-03-25 15:00:00+00:00,Baltimore City,4222.0,138894,2191.0,75221,132.0,5628,4354.0,2323.0,80849,144522,214115
917,917,917,917,917,917,917,917,918,2021-03-26 15:00:00+00:00,Baltimore City,3226.0,142120,2324.0,77545,64.0,5692,3290.0,2388.0,83237,147812,219665
918,918,918,918,918,918,918,918,919,2021-03-27 15:00:00+00:00,Baltimore City,2690.0,144810,1282.0,78827,187.0,5879,2877.0,1469.0,84706,150689,223637
919,919,919,919,919,919,919,919,920,2021-03-28 15:00:00+00:00,Baltimore City,1108.0,145918,606.0,79433,13.0,5892,1121.0,619.0,85325,151810,225351
920,920,920,920,920,920,920,920,921,2021-03-29 15:00:00+00:00,Baltimore City,1924.0,147842,2231.0,81664,47.0,5939,1971.0,2278.0,87603,153781,229506
921,921,921,921,921,921,921,921,922,2021-03-30 15:00:00+00:00,Baltimore City,3434.0,151276,2687.0,84351,128.0,6067,3562.0,2815.0,90418,157343,235627
922,922,922,922,922,922,922,922,923,2021-03-31 15:00:00+00:00,Baltimore City,3487.0,154763,3250.0,87601,177.0,6244,3664.0,3427.0,93845,161007,242364
923,923,923,923,923,923,923,923,924,2021-04-01 15:00:00+00:00,Baltimore City,3312.0,158075,3852.0,91453,193.0,6437,3505.0,4045.0,97890,164512,249528
924,924,924,924,924,924,924,924,925,2021-04-02 15:00:00+00:00,Baltimore City,2598.0,160673,2307.0,93760,258.0,6695,2856.0,2565.0,100455,167368,254433
925,925,925,925,925,925,925,925,926,2021-04-03 15:00:00+00:00,Baltimore City,2381.0,163054,1870.0,95630,107.0,6802,2488.0,1977.0,102432,169856,258684
926,926,926,926,926,926,926,926,927,2021-04-04 15:00:00+00:00,Baltimore City,479.0,163533,433.0,96063,39.0,6841,518.0,472.0,102904,170374,259596
927,927,927,927,927,927,927,927,928,2021-04-05 15:00:00+00:00,Baltimore City,2219.0,165752,1762.0,97825,375.0,7216,2594.0,2137.0,105041,172968,263577
928,928,928,928,928,928,928,928,929,2021-04-06 15:00:00+00:00,Baltimore City,3842.0,169594,2398.0,100223,671.0,7887,4513.0,3069.0,108110,177481,269817
929,929,929,929,929,929,929,929,930,2021-04-07 15:00:00+00:00,Baltimore City,2655.0,172249,2455.0,102678,764.0,8651,3419.0,3219.0,111329,180900,274927
930,930,930,930,930,930,930,930,931,2021-04-08 15:00:00+00:00,Baltimore City,2801.0,175050,3295.0,105973,821.0,9472,3622.0,4116.0,115445,184522,281023
931,931,931,931,931,931,931,931,932,2021-04-09 15:00:00+00:00,Baltimore City,3279.0,178329,3090.0,109063,751.0,10223,4030.0,3841.0,119286,188552,287392
932,932,932,932,932,932,932,932,933,2021-04-10 15:00:00+00:00,Baltimore City,2398.0,180727,2161.0,111224,506.0,10729,2904.0,2667.0,121953,191456,291951
933,933,933,933,933,933,933,933,934,2021-04-11 15:00:00+00:00,Baltimore City,1185.0,181912,724.0,111948,734.0,11463,1919.0,1458.0,123411,193375,293860
934,934,934,934,934,934,934,934,935,2021-04-12 15:00:00+00:00,Baltimore City,2072.0,183984,2862.0,114810,550.0,12013,2622.0,3412.0,126823,195997,298794
935,935,935,935,935,935,935,935,936,2021-04-13 15:00:00+00:00,Baltimore City,3450.0,187434,2985.0,117795,10.0,12023,3460.0,2995.0,129818,199457,305229
936,936,936,936,936,936,936,936,937,2021-04-14 15:00:00+00:00,Baltimore City,3693.0,191127,2618.0,120413,6.0,12029,3699.0,2624.0,132442,203156,311540
937,937,937,937,937,937,937,937,938,2021-04-15 15:00:00+00:00,Baltimore City,2863.0,193990,3860.0,124273,,12029,,,136302,206019,318263
938,938,938,938,938,938,938,938,939,2021-04-16 15:00:00+00:00,Baltimore City,3071.0,197061,3013.0,127286,2.0,12031,3073.0,3015.0,139317,209092,324347
939,939,939,939,939,939,939,939,940,2021-04-17 15:00:00+00:00,Baltimore City,2793.0,199854,1947.0,129233,,12031,,,141264,211885,329087
940,940,940,940,940,940,940,940,941,2021-04-18 15:00:00+00:00,Baltimore City,1146.0,201000,1361.0,130594,,12031,,,142625,213031,331594
941,941,941,941,941,941,941,941,942,2021-04-19 15:00:00+00:00,Baltimore City,1718.0,202718,2333.0,132927,24.0,12055,1742.0,2357.0,144982,214773,335645
942,942,942,942,942,942,942,942,943,2021-04-20 15:00:00+00:00,Baltimore City,2311.0,205029,3596.0,136523,28.0,12083,2339.0,3624.0,148606,217112,341552
943,943,943,943,943,943,943,943,944,2021-04-21 15:00:00+00:00,Baltimore City,2973.0,208002,3678.0,140201,7.0,12090,2980.0,3685.0,152291,220092,348203
944,944,944,944,944,944,944,944,945,2021-04-22 15:00:00+00:00,Baltimore City,2786.0,210788,3541.0,143742,10.0,12100,2796.0,3551.0,155842,222888,354530
945,945,945,945,945,945,945,945,946,2021-04-23 15:00:00+00:00,Baltimore City,2214.0,213002,2586.0,146328,5.0,12105,2219.0,2591.0,158433,225107,359330
946,946,946,946,946,946,946,946,947,2021-04-24 15:00:00+00:00,Baltimore City,1648.0,214650,2560.0,148888,32.0,12137,1680.0,2592.0,161025,226787,363538
947,947,947,947,947,947,947,947,948,2021-04-25 15:00:00+00:00,Baltimore City,1102.0,215752,271.0,149159,3.0,12140,1105.0,274.0,161299,227892,364911
948,948,948,948,948,948,948,948,949,2021-04-26 15:00:00+00:00,Baltimore City,1713.0,217465,2314.0,151473,9.0,12149,1722.0,2323.0,163622,229614,368938
949,949,949,949,949,949,949,949,950,2021-04-27 15:00:00+00:00,Baltimore City,1752.0,219217,3197.0,154670,71.0,12220,1823.0,3268.0,166890,231437,373887
950,950,950,950,950,950,950,950,951,2021-04-28 15:00:00+00:00,Baltimore City,2383.0,221600,2745.0,157415,67.0,12287,2450.0,2812.0,169702,233887,379015
951,951,951,951,951,951,951,951,952,2021-04-29 15:00:00+00:00,Baltimore City,2469.0,224069,3016.0,160431,115.0,12402,2584.0,3131.0,172833,236471,384500
952,952,952,952,952,952,952,952,953,2021-04-30 15:00:00+00:00,Baltimore City,2655.0,226724,2211.0,162642,102.0,12504,2757.0,2313.0,175146,239228,389366
953,953,953,953,953,953,953,953,954,2021-05-01 15:00:00+00:00,Baltimore City,1484.0,228208,2395.0,165037,74.0,12578,1558.0,2469.0,177615,240786,393245
954,954,954,954,954,954,954,954,955,2021-05-02 15:00:00+00:00,Baltimore City,590.0,228798,1191.0,166228,44.0,12622,634.0,1235.0,178850,241420,395026
955,955,955,955,955,955,955,955,956,2021-05-03 15:00:00+00:00,Baltimore City,972.0,229770,2047.0,168275,99.0,12721,1071.0,2146.0,180996,242491,398045
956,956,956,956,956,956,956,956,957,2021-05-04 15:00:00+00:00,Baltimore City,1120.0,230890,3444.0,171719,91.0,12812,1211.0,3535.0,184531,243702,402609
957,957,957,957,957,957,957,957,958,2021-05-05 15:00:00+00:00,Baltimore City,1592.0,232482,3289.0,175008,97.0,12909,1689.0,3386.0,187917,245391,407490
958,958,958,958,958,958,958,958,959,2021-05-06 15:00:00+00:00,Baltimore City,1586.0,234068,2593.0,177601,134.0,13043,1720.0,2727.0,190644,247111,411669
959,959,959,959,959,959,959,959,960,2021-05-07 15:00:00+00:00,Baltimore City,1639.0,235707,2906.0,180507,128.0,13171,1767.0,3034.0,193678,248878,416214
960,960,960,960,960,960,960,960,961,2021-05-08 15:00:00+00:00,Baltimore City,965.0,236672,2448.0,182955,99.0,13270,1064.0,2547.0,196225,249942,419627
961,961,961,961,961,961,961,961,962,2021-05-09 15:00:00+00:00,Baltimore City,430.0,237102,928.0,183883,52.0,13322,482.0,980.0,197205,250424,420985
962,962,962,962,962,962,962,962,963,2021-05-10 15:00:00+00:00,Baltimore City,825.0,237927,2088.0,185971,138.0,13460,963.0,2226.0,199431,251387,423898
963,963,963,963,963,963,963,963,964,2021-05-11 15:00:00+00:00,Baltimore City,1178.0,239105,2412.0,188383,166.0,13626,1344.0,2578.0,202009,252731,427488
964,964,964,964,964,964,964,964,965,2021-05-12 15:00:00+00:00,Baltimore City,1249.0,240354,3030.0,191413,126.0,13752,1375.0,3156.0,205165,254106,431767
965,965,965,965,965,965,965,965,966,2021-05-13 15:00:00+00:00,Baltimore City,1709.0,242063,2231.0,193644,128.0,13880,1837.0,2359.0,207524,255943,435707
966,966,966,966,966,966,966,966,967,2021-05-14 15:00:00+00:00,Baltimore City,1990.0,244053,2144.0,195788,148.0,14028,2138.0,2292.0,209816,258081,439841
967,967,967,967,967,967,967,967,968,2021-05-15 15:00:00+00:00,Baltimore City,1604.0,245657,1671.0,197459,119.0,14147,1723.0,1790.0,211606,259804,443116
968,968,968,968,968,968,968,968,969,2021-05-16 15:00:00+00:00,Baltimore City,803.0,246460,954.0,198413,64.0,14211,867.0,1018.0,212624,260671,444873
969,969,969,969,969,969,969,969,970,2021-05-17 15:00:00+00:00,Baltimore City,1279.0,247739,1531.0,199944,192.0,14403,1471.0,1723.0,214347,262142,447683
970,970,970,970,970,970,970,970,971,2021-05-18 15:00:00+00:00,Baltimore City,1369.0,249108,2103.0,202047,162.0,14565,1531.0,2265.0,216612,263673,451155
971,971,971,971,971,971,971,971,972,2021-05-19 15:00:00+00:00,Baltimore City,1495.0,250603,2439.0,204486,101.0,14666,1596.0,2540.0,219152,265269,455089
972,972,972,972,972,972,972,972,973,2021-05-20 15:00:00+00:00,Baltimore City,1711.0,252314,2381.0,206867,139.0,14805,1850.0,2520.0,221672,267119,459181
973,973,973,973,973,973,973,973,974,2021-05-21 15:00:00+00:00,Baltimore City,1605.0,253919,2559.0,209426,139.0,14944,1744.0,2698.0,224370,268863,463345
974,974,974,974,974,974,974,974,975,2021-05-22 15:00:00+00:00,Baltimore City,1242.0,255161,1663.0,211089,68.0,15012,1310.0,1731.0,226101,270173,466250
975,975,975,975,975,975,975,975,976,2021-05-23 15:00:00+00:00,Baltimore City,765.0,255926,638.0,211727,35.0,15047,800.0,673.0,226774,270973,467653
976,976,976,976,976,976,976,976,977,2021-05-24 15:00:00+00:00,Baltimore City,1167.0,257093,1134.0,212861,82.0,15129,1249.0,1216.0,227990,272222,469954
977,977,977,977,977,977,977,977,978,2021-05-25 15:00:00+00:00,Baltimore City,1286.0,258379,1383.0,214244,82.0,15211,1368.0,1465.0,229455,273590,472623
978,978,978,978,978,978,978,978,979,2021-05-26 15:00:00+00:00,Baltimore City,1288.0,259667,1447.0,215691,120.0,15331,1408.0,1567.0,231022,274998,475358
979,979,979,979,979,979,979,979,980,2021-05-27 15:00:00+00:00,Baltimore City,1237.0,260904,1906.0,217597,92.0,15423,1329.0,1998.0,233020,276327,478501
980,980,980,980,980,980,980,980,981,2021-05-28 15:00:00+00:00,Baltimore City,1117.0,262021,2034.0,219631,114.0,15537,1231.0,2148.0,235168,277558,481652
981,981,981,981,981,981,981,981,982,2021-05-29 15:00:00+00:00,Baltimore City,678.0,262699,813.0,220444,41.0,15578,719.0,854.0,236022,278277,483143
982,982,982,982,982,982,982,982,983,2021-05-30 15:00:00+00:00,Baltimore City,354.0,263053,472.0,220916,46.0,15624,400.0,518.0,236540,278677,483969
983,983,983,983,983,983,983,983,984,2021-05-31 15:00:00+00:00,Baltimore City,153.0,263206,225.0,221141,38.0,15662,191.0,263.0,236803,278868,484347
984,984,984,984,984,984,984,984,985,2021-06-01 15:00:00+00:00,Baltimore City,1017.0,264223,1589.0,222730,73.0,15735,1090.0,1662.0,238465,279958,486953
985,985,985,985,985,985,985,985,986,2021-06-02 15:00:00+00:00,Baltimore City,1011.0,265234,1241.0,223971,91.0,15826,1102.0,1332.0,239797,281060,489205
986,986,986,986,986,986,986,986,987,2021-06-03 15:00:00+00:00,Baltimore City,952.0,266186,1728.0,225699,92.0,15918,1044.0,1820.0,241617,282104,491885
987,987,987,987,987,987,987,987,988,2021-06-04 15:00:00+00:00,Baltimore City,918.0,267104,1793.0,227492,144.0,16062,1062.0,1937.0,243554,283166,494596
988,988,988,988,988,988,988,988,989,2021-06-05 15:00:00+00:00,Baltimore City,784.0,267888,1559.0,229051,53.0,16115,837.0,1612.0,245166,284003,496939
989,989,989,989,989,989,989,989,990,2021-06-06 15:00:00+00:00,Baltimore City,272.0,268160,472.0,229523,21.0,16136,293.0,493.0,245659,284296,497683
990,990,990,990,990,990,990,990,991,2021-06-07 15:00:00+00:00,Baltimore City,582.0,268742,1189.0,230712,57.0,16193,639.0,1246.0,246905,284935,499454
991,991,991,991,991,991,991,991,992,2021-06-08 15:00:00+00:00,Baltimore City,692.0,269434,1461.0,232173,94.0,16287,786.0,1555.0,248460,285721,501607
992,992,992,992,992,992,992,992,993,2021-06-09 15:00:00+00:00,Baltimore City,806.0,270240,1375.0,233548,158.0,16445,964.0,1533.0,249993,286685,503788
993,993,993,993,993,993,993,993,994,2021-06-10 15:00:00+00:00,Baltimore City,810.0,271050,1628.0,235176,82.0,16527,892.0,1710.0,251703,287577,506226
994,994,994,994,994,994,994,994,995,2021-06-11 15:00:00+00:00,Baltimore City,741.0,271791,1659.0,236835,90.0,16617,831.0,1749.0,253452,288408,508626
995,995,995,995,995,995,995,995,996,2021-06-12 15:00:00+00:00,Baltimore City,456.0,272247,1155.0,237990,70.0,16687,526.0,1225.0,254677,288934,510237
996,996,996,996,996,996,996,996,997,2021-06-13 15:00:00+00:00,Baltimore City,180.0,272427,561.0,238551,54.0,16741,234.0,615.0,255292,289168,510978
997,997,997,997,997,997,997,997,998,2021-06-14 15:00:00+00:00,Baltimore City,498.0,272925,1123.0,239674,78.0,16819,576.0,1201.0,256493,289744,512599
998,998,998,998,998,998,998,998,999,2021-06-15 15:00:00+00:00,Baltimore City,603.0,273528,1404.0,241078,129.0,16948,732.0,1533.0,258026,290476,514606
999,999,999,999,999,999,999,999,1000,2021-06-16 15:00:00+00:00,Baltimore City,730.0,274258,1306.0,242384,84.0,17032,814.0,1390.0,259416,291290,516642
1000,1000,1000,1000,1000,1000,1000,1000,1001,2021-06-17 15:00:00+00:00,Baltimore City,741.0,274999,1241.0,243625,113.0,17145,854.0,1354.0,260770,292144,518624
1001,1001,1001,1001,1001,1001,1001,1001,1002,2021-06-18 15:00:00+00:00,Baltimore City,868.0,275867,1122.0,244747,73.0,17218,941.0,1195.0,261965,293085,520614
1002,1002,1002,1002,1002,1002,1002,1002,1003,2021-06-19 15:00:00+00:00,Baltimore City,458.0,276325,617.0,245364,41.0,17259,499.0,658.0,262623,293584,521689
1003,1003,1003,1003,1003,1003,1003,1003,1004,2021-06-20 15:00:00+00:00,Baltimore City,159.0,276484,390.0,245754,41.0,17300,200.0,431.0,263054,293784,522238
1004,1004,1004,1004,1004,1004,1004,1004,1005,2021-06-21 15:00:00+00:00,Baltimore City,504.0,276988,455.0,246209,70.0,17370,574.0,525.0,263579,294358,523197
1005,1005,1005,1005,1005,1005,1005,1005,1006,2021-06-22 15:00:00+00:00,Baltimore City,608.0,277596,988.0,247197,117.0,17487,725.0,1105.0,264684,295083,524793
1006,1006,1006,1006,1006,1006,1006,1006,1007,2021-06-23 15:00:00+00:00,Baltimore City,711.0,278307,1047.0,248244,111.0,17598,822.0,1158.0,265842,295905,526551
1007,1007,1007,1007,1007,1007,1007,1007,1008,2021-06-24 15:00:00+00:00,Baltimore City,613.0,278920,891.0,249135,52.0,17650,665.0,943.0,266785,296570,528055
1008,1008,1008,1008,1008,1008,1008,1008,1009,2021-06-25 15:00:00+00:00,Baltimore City,716.0,279636,873.0,250008,57.0,17707,773.0,930.0,267715,297343,529644
1009,1009,1009,1009,1009,1009,1009,1009,1010,2021-06-26 15:00:00+00:00,Baltimore City,351.0,279987,615.0,250623,34.0,17741,385.0,649.0,268364,297728,530610
1010,1010,1010,1010,1010,1010,1010,1010,1011,2021-06-27 15:00:00+00:00,Baltimore City,164.0,280151,242.0,250865,16.0,17757,180.0,258.0,268622,297908,531016
1011,1011,1011,1011,1011,1011,1011,1011,1012,2021-06-28 15:00:00+00:00,Baltimore City,453.0,280604,509.0,251374,102.0,17859,555.0,611.0,269233,298463,531978
1012,1012,1012,1012,1012,1012,1012,1012,1013,2021-06-29 15:00:00+00:00,Baltimore City,597.0,281201,578.0,251952,39.0,17898,636.0,617.0,269850,299099,533153
1013,1013,1013,1013,1013,1013,1013,1013,1014,2021-06-30 15:00:00+00:00,Baltimore City,602.0,281803,806.0,252758,81.0,17979,683.0,887.0,270737,299782,534561
1014,1014,1014,1014,1014,1014,1014,1014,1015,2021-07-01 15:00:00+00:00,Baltimore City,519.0,282322,682.0,253440,58.0,18037,577.0,740.0,271477,300359,535762
1015,1015,1015,1015,1015,1015,1015,1015,1016,2021-07-02 15:00:00+00:00,Baltimore City,525.0,282847,686.0,254126,46.0,18083,571.0,732.0,272209,300930,536973
1016,1016,1016,1016,1016,1016,1016,1016,1017,2021-07-03 15:00:00+00:00,Baltimore City,298.0,283145,338.0,254464,10.0,18093,308.0,348.0,272557,301238,537609
1017,1017,1017,1017,1017,1017,1017,1017,1018,2021-07-04 15:00:00+00:00,Baltimore City,31.0,283176,35.0,254499,12.0,18105,43.0,47.0,272604,301281,537675
1018,1018,1018,1018,1018,1018,1018,1018,1019,2021-07-05 15:00:00+00:00,Baltimore City,300.0,283476,284.0,254783,32.0,18137,332.0,316.0,272920,301613,538259
1019,1019,1019,1019,1019,1019,1019,1019,1020,2021-07-06 15:00:00+00:00,Baltimore City,471.0,283947,622.0,255405,44.0,18181,515.0,666.0,273586,302128,539352
1020,1020,1020,1020,1020,1020,1020,1020,1021,2021-07-07 15:00:00+00:00,Baltimore City,469.0,284416,642.0,256047,90.0,18271,559.0,732.0,274318,302687,540463
1021,1021,1021,1021,1021,1021,1021,1021,1022,2021-07-08 15:00:00+00:00,Baltimore City,547.0,284963,631.0,256678,65.0,18336,612.0,696.0,275014,303299,541641
1022,1022,1022,1022,1022,1022,1022,1022,1023,2021-07-09 15:00:00+00:00,Baltimore City,567.0,285530,859.0,257537,42.0,18378,609.0,901.0,275915,303908,543067
1023,1023,1023,1023,1023,1023,1023,1023,1024,2021-07-10 15:00:00+00:00,Baltimore City,330.0,285860,463.0,258000,25.0,18403,355.0,488.0,276403,304263,543860
1024,1024,1024,1024,1024,1024,1024,1024,1025,2021-07-11 15:00:00+00:00,Baltimore City,255.0,286115,182.0,258182,18.0,18421,273.0,200.0,276603,304536,544297
1025,1025,1025,1025,1025,1025,1025,1025,1026,2021-07-12 15:00:00+00:00,Baltimore City,486.0,286601,484.0,258666,68.0,18489,554.0,552.0,277155,305090,545267
1026,1026,1026,1026,1026,1026,1026,1026,1027,2021-07-13 15:00:00+00:00,Baltimore City,483.0,287084,546.0,259212,20.0,18509,503.0,566.0,277721,305593,546296
1027,1027,1027,1027,1027,1027,1027,1027,1028,2021-07-14 15:00:00+00:00,Baltimore City,466.0,287550,588.0,259800,101.0,18610,567.0,689.0,278410,306160,547350
1028,1028,1028,1028,1028,1028,1028,1028,1029,2021-07-15 15:00:00+00:00,Baltimore City,478.0,288028,518.0,260318,45.0,18655,523.0,563.0,278973,306683,548346
1029,1029,1029,1029,1029,1029,1029,1029,1030,2021-07-16 15:00:00+00:00,Baltimore City,687.0,288715,653.0,260971,57.0,18712,744.0,710.0,279683,307427,549686
1030,1030,1030,1030,1030,1030,1030,1030,1031,2021-07-17 15:00:00+00:00,Baltimore City,272.0,288987,345.0,261316,41.0,18753,313.0,386.0,280069,307740,550303
1031,1031,1031,1031,1031,1031,1031,1031,1032,2021-07-18 15:00:00+00:00,Baltimore City,139.0,289126,127.0,261443,13.0,18766,152.0,140.0,280209,307892,550569
1032,1032,1032,1032,1032,1032,1032,1032,1033,2021-07-19 15:00:00+00:00,Baltimore City,561.0,289687,435.0,261878,44.0,18810,605.0,479.0,280688,308497,551565
1033,1033,1033,1033,1033,1033,1033,1033,1034,2021-07-20 15:00:00+00:00,Baltimore City,643.0,290330,597.0,262475,69.0,18879,712.0,666.0,281354,309209,552805
1034,1034,1034,1034,1034,1034,1034,1034,1035,2021-07-21 15:00:00+00:00,Baltimore City,612.0,290942,573.0,263048,64.0,18943,676.0,637.0,281991,309885,553990
1035,1035,1035,1035,1035,1035,1035,1035,1036,2021-07-22 15:00:00+00:00,Baltimore City,667.0,291609,500.0,263548,43.0,18986,710.0,543.0,282534,310595,555157
1036,1036,1036,1036,1036,1036,1036,1036,1037,2021-07-23 15:00:00+00:00,Baltimore City,855.0,292464,560.0,264108,95.0,19081,950.0,655.0,283189,311545,556572
1037,1037,1037,1037,1037,1037,1037,1037,1038,2021-07-24 15:00:00+00:00,Baltimore City,475.0,292939,303.0,264411,37.0,19118,512.0,340.0,283529,312057,557350
1038,1038,1038,1038,1038,1038,1038,1038,1039,2021-07-25 15:00:00+00:00,Baltimore City,288.0,293227,92.0,264503,20.0,19138,308.0,112.0,283641,312365,557730
1039,1039,1039,1039,1039,1039,1039,1039,1040,2021-07-26 15:00:00+00:00,Baltimore City,627.0,293854,416.0,264919,57.0,19195,684.0,473.0,284114,313049,558773
1040,1040,1040,1040,1040,1040,1040,1040,1041,2021-07-27 15:00:00+00:00,Baltimore City,689.0,294543,498.0,265417,60.0,19255,749.0,558.0,284672,313798,559960
1041,1041,1041,1041,1041,1041,1041,1041,1042,2021-07-28 15:00:00+00:00,Baltimore City,696.0,295239,420.0,265837,40.0,19295,736.0,460.0,285132,314534,561076
1042,1042,1042,1042,1042,1042,1042,1042,1043,2021-07-29 15:00:00+00:00,Baltimore City,670.0,295909,462.0,266299,48.0,19343,718.0,510.0,285642,315252,562208
1043,1043,1043,1043,1043,1043,1043,1043,1044,2021-07-30 15:00:00+00:00,Baltimore City,800.0,296709,586.0,266885,82.0,19425,882.0,668.0,286310,316134,563594
1044,1044,1044,1044,1044,1044,1044,1044,1045,2021-07-31 15:00:00+00:00,Baltimore City,412.0,297121,277.0,267162,24.0,19449,436.0,301.0,286611,316570,564283
1045,1045,1045,1045,1045,1045,1045,1045,1046,2021-08-01 15:00:00+00:00,Baltimore City,371.0,297492,228.0,267390,17.0,19466,388.0,245.0,286856,316958,564882
1046,1046,1046,1046,1046,1046,1046,1046,1047,2021-08-02 15:00:00+00:00,Baltimore City,705.0,298197,361.0,267751,19.0,19485,724.0,380.0,287236,317682,565948
1047,1047,1047,1047,1047,1047,1047,1047,1048,2021-08-03 15:00:00+00:00,Baltimore City,830.0,299027,418.0,268169,55.0,19540,885.0,473.0,287709,318567,567196
1048,1048,1048,1048,1048,1048,1048,1048,1049,2021-08-04 15:00:00+00:00,Baltimore City,782.0,299809,401.0,268570,97.0,19637,879.0,498.0,288207,319446,568379
1049,1049,1049,1049,1049,1049,1049,1049,1050,2021-08-05 15:00:00+00:00,Baltimore City,835.0,300644,484.0,269054,76.0,19713,911.0,560.0,288767,320357,569698
1050,1050,1050,1050,1050,1050,1050,1050,1051,2021-08-06 15:00:00+00:00,Baltimore City,946.0,301590,541.0,269595,47.0,19760,993.0,588.0,289355,321350,571185
1051,1051,1051,1051,1051,1051,1051,1051,1052,2021-08-07 15:00:00+00:00,Baltimore City,456.0,302046,237.0,269832,52.0,19812,508.0,289.0,289644,321858,571878
1052,1052,1052,1052,1052,1052,1052,1052,1053,2021-08-08 15:00:00+00:00,Baltimore City,303.0,302349,142.0,269974,15.0,19827,318.0,157.0,289801,322176,572323
1053,1053,1053,1053,1053,1053,1053,1053,1054,2021-08-09 15:00:00+00:00,Baltimore City,709.0,303058,480.0,270454,32.0,19859,741.0,512.0,290313,322917,573512
1054,1054,1054,1054,1054,1054,1054,1054,1055,2021-08-10 15:00:00+00:00,Baltimore City,722.0,303780,531.0,270985,36.0,19895,758.0,567.0,290880,323675,574765
1055,1055,1055,1055,1055,1055,1055,1055,1056,2021-08-11 15:00:00+00:00,Baltimore City,837.0,304617,498.0,271483,39.0,19934,876.0,537.0,291417,324551,576100
1056,1056,1056,1056,1056,1056,1056,1056,1057,2021-08-12 15:00:00+00:00,Baltimore City,761.0,305378,522.0,272005,63.0,19997,824.0,585.0,292002,325375,577383
1057,1057,1057,1057,1057,1057,1057,1057,1058,2021-08-13 15:00:00+00:00,Baltimore City,816.0,306194,664.0,272669,65.0,20062,881.0,729.0,292731,326256,578863
1058,1058,1058,1058,1058,1058,1058,1058,1059,2021-08-14 15:00:00+00:00,Baltimore City,465.0,306659,355.0,273024,30.0,20092,495.0,385.0,293116,326751,579683
1059,1059,1059,1059,1059,1059,1059,1059,1060,2021-08-15 15:00:00+00:00,Baltimore City,318.0,306977,242.0,273266,28.0,20120,346.0,270.0,293386,327097,580243
1060,1060,1060,1060,1060,1060,1060,1060,1061,2021-08-16 15:00:00+00:00,Baltimore City,478.0,307455,508.0,273774,66.0,20186,544.0,574.0,293960,327641,581229
1061,1061,1061,1061,1061,1061,1061,1061,1062,2021-08-17 15:00:00+00:00,Baltimore City,725.0,308180,563.0,274337,29.0,20215,754.0,592.0,294552,328395,582517
1062,1062,1062,1062,1062,1062,1062,1062,1063,2021-08-18 15:00:00+00:00,Baltimore City,719.0,308899,532.0,274869,84.0,20299,803.0,616.0,295168,329198,583768
1063,1063,1063,1063,1063,1063,1063,1063,1064,2021-08-19 15:00:00+00:00,Baltimore City,680.0,309579,563.0,275432,52.0,20351,732.0,615.0,295783,329930,585011
1064,1064,1064,1064,1064,1064,1064,1064,1065,2021-08-20 15:00:00+00:00,Baltimore City,951.0,310530,739.0,276171,46.0,20397,997.0,785.0,296568,330927,586701
1065,1065,1065,1065,1065,1065,1065,1065,1066,2021-08-21 15:00:00+00:00,Baltimore City,491.0,311021,355.0,276526,43.0,20440,534.0,398.0,296966,331461,587547
1066,1066,1066,1066,1066,1066,1066,1066,1067,2021-08-22 15:00:00+00:00,Baltimore City,299.0,311320,294.0,276820,6.0,20446,305.0,300.0,297266,331766,588140
1067,1067,1067,1067,1067,1067,1067,1067,1068,2021-08-23 15:00:00+00:00,Baltimore City,591.0,311911,613.0,277433,23.0,20469,614.0,636.0,297902,332380,589344
1068,1068,1068,1068,1068,1068,1068,1068,1069,2021-08-24 15:00:00+00:00,Baltimore City,831.0,312742,684.0,278117,32.0,20501,863.0,716.0,298618,333243,590859
1069,1069,1069,1069,1069,1069,1069,1069,1070,2021-08-25 15:00:00+00:00,Baltimore City,812.0,313554,684.0,278801,46.0,20547,858.0,730.0,299348,334101,592355
1070,1070,1070,1070,1070,1070,1070,1070,1071,2021-08-26 15:00:00+00:00,Baltimore City,946.0,314500,649.0,279450,40.0,20587,986.0,689.0,300037,335087,593950
1071,1071,1071,1071,1071,1071,1071,1071,1072,2021-08-27 15:00:00+00:00,Baltimore City,936.0,315436,835.0,280285,39.0,20626,975.0,874.0,300911,336062,595721
1072,1072,1072,1072,1072,1072,1072,1072,1073,2021-08-28 15:00:00+00:00,Baltimore City,458.0,315894,381.0,280666,35.0,20661,493.0,416.0,301327,336555,596560
1073,1073,1073,1073,1073,1073,1073,1073,1074,2021-08-29 15:00:00+00:00,Baltimore City,356.0,316250,268.0,280934,19.0,20680,375.0,287.0,301614,336930,597184
1074,1074,1074,1074,1074,1074,1074,1074,1075,2021-08-30 15:00:00+00:00,Baltimore City,864.0,317114,638.0,281572,48.0,20728,912.0,686.0,302300,337842,598686
1075,1075,1075,1075,1075,1075,1075,1075,1076,2021-08-31 15:00:00+00:00,Baltimore City,801.0,317915,611.0,282183,29.0,20757,830.0,640.0,302940,338672,600098
1076,1076,1076,1076,1076,1076,1076,1076,1077,2021-05-31 15:00:00+00:00,Anne Arundel,158.0,297898,568.0,251464,30.0,20085,188.0,598.0,271549,317983,549362
1077,1077,1077,1077,1077,1077,1077,1077,1078,2021-06-01 15:00:00+00:00,Anne Arundel,725.0,298623,1356.0,252820,101.0,20186,826.0,1457.0,273006,318809,551443
1078,1078,1078,1078,1078,1078,1078,1078,1079,2021-06-02 15:00:00+00:00,Anne Arundel,1268.0,299891,2512.0,255332,76.0,20262,1344.0,2588.0,275594,320153,555223
1079,1079,1079,1079,1079,1079,1079,1079,1080,2021-06-03 15:00:00+00:00,Anne Arundel,686.0,300577,2237.0,257569,108.0,20370,794.0,2345.0,277939,320947,558146
1080,1080,1080,1080,1080,1080,1080,1080,1081,2021-06-04 15:00:00+00:00,Anne Arundel,651.0,301228,2463.0,260032,116.0,20486,767.0,2579.0,280518,321714,561260
1081,1081,1081,1081,1081,1081,1081,1081,1082,2021-06-05 15:00:00+00:00,Anne Arundel,548.0,301776,2077.0,262109,59.0,20545,607.0,2136.0,282654,322321,563885
1082,1082,1082,1082,1082,1082,1082,1082,1083,2021-06-06 15:00:00+00:00,Anne Arundel,291.0,302067,1038.0,263147,30.0,20575,321.0,1068.0,283722,322642,565214
1083,1083,1083,1083,1083,1083,1083,1083,1084,2021-06-07 15:00:00+00:00,Anne Arundel,491.0,302558,1356.0,264503,68.0,20643,559.0,1424.0,285146,323201,567061
1084,1084,1084,1084,1084,1084,1084,1084,1085,2021-06-08 15:00:00+00:00,Anne Arundel,420.0,302978,1238.0,265741,59.0,20702,479.0,1297.0,286443,323680,568719
1085,1085,1085,1085,1085,1085,1085,1085,1086,2021-06-09 15:00:00+00:00,Anne Arundel,618.0,303596,3335.0,269076,98.0,20800,716.0,3433.0,289876,324396,572672
1086,1086,1086,1086,1086,1086,1086,1086,1087,2021-06-10 15:00:00+00:00,Anne Arundel,647.0,304243,1806.0,270882,109.0,20909,756.0,1915.0,291791,325152,575125
1087,1087,1087,1087,1087,1087,1087,1087,1088,2021-06-11 15:00:00+00:00,Anne Arundel,554.0,304797,1659.0,272541,101.0,21010,655.0,1760.0,293551,325807,577338
1088,1088,1088,1088,1088,1088,1088,1088,1089,2021-06-12 15:00:00+00:00,Anne Arundel,416.0,305213,1277.0,273818,66.0,21076,482.0,1343.0,294894,326289,579031
1089,1089,1089,1089,1089,1089,1089,1089,1090,2021-06-13 15:00:00+00:00,Anne Arundel,110.0,305323,540.0,274358,35.0,21111,145.0,575.0,295469,326434,579681
1090,1090,1090,1090,1090,1090,1090,1090,1091,2021-06-14 15:00:00+00:00,Anne Arundel,458.0,305781,1176.0,275534,86.0,21197,544.0,1262.0,296731,326978,581315
1091,1091,1091,1091,1091,1091,1091,1091,1092,2021-06-15 15:00:00+00:00,Anne Arundel,442.0,306223,1147.0,276681,69.0,21266,511.0,1216.0,297947,327489,582904
1092,1092,1092,1092,1092,1092,1092,1092,1093,2021-06-16 15:00:00+00:00,Anne Arundel,453.0,306676,2441.0,279122,73.0,21339,526.0,2514.0,300461,328015,585798
1093,1093,1093,1093,1093,1093,1093,1093,1094,2021-06-17 15:00:00+00:00,Anne Arundel,497.0,307173,1089.0,280211,61.0,21400,558.0,1150.0,301611,328573,587384
1094,1094,1094,1094,1094,1094,1094,1094,1095,2021-06-18 15:00:00+00:00,Anne Arundel,457.0,307630,1002.0,281213,55.0,21455,512.0,1057.0,302668,329085,588843
1095,1095,1095,1095,1095,1095,1095,1095,1096,2021-06-19 15:00:00+00:00,Anne Arundel,412.0,308042,938.0,282151,96.0,21551,508.0,1034.0,303702,329593,590193
1096,1096,1096,1096,1096,1096,1096,1096,1097,2021-06-20 15:00:00+00:00,Anne Arundel,188.0,308230,354.0,282505,22.0,21573,210.0,376.0,304078,329803,590735
1097,1097,1097,1097,1097,1097,1097,1097,1098,2021-06-21 15:00:00+00:00,Anne Arundel,439.0,308669,532.0,283037,64.0,21637,503.0,596.0,304674,330306,591706
1098,1098,1098,1098,1098,1098,1098,1098,1099,2021-06-22 15:00:00+00:00,Anne Arundel,430.0,309099,762.0,283799,80.0,21717,510.0,842.0,305516,330816,592898
1099,1099,1099,1099,1099,1099,1099,1099,1100,2021-06-23 15:00:00+00:00,Anne Arundel,466.0,309565,1155.0,284954,59.0,21776,525.0,1214.0,306730,331341,594519
1100,1100,1100,1100,1100,1100,1100,1100,1101,2021-06-24 15:00:00+00:00,Anne Arundel,470.0,310035,726.0,285680,61.0,21837,531.0,787.0,307517,331872,595715
1101,1101,1101,1101,1101,1101,1101,1101,1102,2021-06-25 15:00:00+00:00,Anne Arundel,426.0,310461,698.0,286378,65.0,21902,491.0,763.0,308280,332363,596839
1102,1102,1102,1102,1102,1102,1102,1102,1103,2021-06-26 15:00:00+00:00,Anne Arundel,289.0,310750,549.0,286927,41.0,21943,330.0,590.0,308870,332693,597677
1103,1103,1103,1103,1103,1103,1103,1103,1104,2021-06-27 15:00:00+00:00,Anne Arundel,174.0,310924,273.0,287200,11.0,21954,185.0,284.0,309154,332878,598124
1104,1104,1104,1104,1104,1104,1104,1104,1105,2021-06-28 15:00:00+00:00,Anne Arundel,378.0,311302,492.0,287692,58.0,22012,436.0,550.0,309704,333314,598994
1105,1105,1105,1105,1105,1105,1105,1105,1106,2021-06-29 15:00:00+00:00,Anne Arundel,446.0,311748,479.0,288171,60.0,22072,506.0,539.0,310243,333820,599919
1106,1106,1106,1106,1106,1106,1106,1106,1107,2021-06-30 15:00:00+00:00,Anne Arundel,435.0,312183,629.0,288800,53.0,22125,488.0,682.0,310925,334308,600983
1107,1107,1107,1107,1107,1107,1107,1107,1108,2021-07-01 15:00:00+00:00,Anne Arundel,419.0,312602,619.0,289419,50.0,22175,469.0,669.0,311594,334777,602021
1108,1108,1108,1108,1108,1108,1108,1108,1109,2021-07-02 15:00:00+00:00,Anne Arundel,382.0,312984,500.0,289919,58.0,22233,440.0,558.0,312152,335217,602903
1109,1109,1109,1109,1109,1109,1109,1109,1110,2021-07-03 15:00:00+00:00,Anne Arundel,239.0,313223,359.0,290278,19.0,22252,258.0,378.0,312530,335475,603501
1110,1110,1110,1110,1110,1110,1110,1110,1111,2021-07-04 15:00:00+00:00,Anne Arundel,38.0,313261,36.0,290314,5.0,22257,43.0,41.0,312571,335518,603575
1111,1111,1111,1111,1111,1111,1111,1111,1112,2021-07-05 15:00:00+00:00,Anne Arundel,340.0,313601,350.0,290664,42.0,22299,382.0,392.0,312963,335900,604265
1112,1112,1112,1112,1112,1112,1112,1112,1113,2021-07-06 15:00:00+00:00,Anne Arundel,355.0,313956,407.0,291071,42.0,22341,397.0,449.0,313412,336297,605027
1113,1113,1113,1113,1113,1113,1113,1113,1114,2021-07-07 15:00:00+00:00,Anne Arundel,364.0,314320,481.0,291552,40.0,22381,404.0,521.0,313933,336701,605872
1114,1114,1114,1114,1114,1114,1114,1114,1115,2021-07-08 15:00:00+00:00,Anne Arundel,387.0,314707,448.0,292000,55.0,22436,442.0,503.0,314436,337143,606707
1115,1115,1115,1115,1115,1115,1115,1115,1116,2021-07-09 15:00:00+00:00,Anne Arundel,445.0,315152,488.0,292488,52.0,22488,497.0,540.0,314976,337640,607640
1116,1116,1116,1116,1116,1116,1116,1116,1117,2021-07-10 15:00:00+00:00,Anne Arundel,276.0,315428,352.0,292840,27.0,22515,303.0,379.0,315355,337943,608268
1117,1117,1117,1117,1117,1117,1117,1117,1118,2021-07-11 15:00:00+00:00,Anne Arundel,172.0,315600,199.0,293039,9.0,22524,181.0,208.0,315563,338124,608639
1118,1118,1118,1118,1118,1118,1118,1118,1119,2021-07-12 15:00:00+00:00,Anne Arundel,415.0,316015,445.0,293484,40.0,22564,455.0,485.0,316048,338579,609499
1119,1119,1119,1119,1119,1119,1119,1119,1120,2021-07-13 15:00:00+00:00,Anne Arundel,339.0,316354,380.0,293864,47.0,22611,386.0,427.0,316475,338965,610218
1120,1120,1120,1120,1120,1120,1120,1120,1121,2021-07-14 15:00:00+00:00,Anne Arundel,379.0,316733,412.0,294276,41.0,22652,420.0,453.0,316928,339385,611009
1121,1121,1121,1121,1121,1121,1121,1121,1122,2021-07-15 15:00:00+00:00,Anne Arundel,382.0,317115,413.0,294689,25.0,22677,407.0,438.0,317366,339792,611804
1122,1122,1122,1122,1122,1122,1122,1122,1123,2021-07-16 15:00:00+00:00,Anne Arundel,447.0,317562,432.0,295121,45.0,22722,492.0,477.0,317843,340284,612683
1123,1123,1123,1123,1123,1123,1123,1123,1124,2021-07-17 15:00:00+00:00,Anne Arundel,303.0,317865,281.0,295402,24.0,22746,327.0,305.0,318148,340611,613267
1124,1124,1124,1124,1124,1124,1124,1124,1125,2021-07-18 15:00:00+00:00,Anne Arundel,160.0,318025,169.0,295571,7.0,22753,167.0,176.0,318324,340778,613596
1125,1125,1125,1125,1125,1125,1125,1125,1126,2021-07-19 15:00:00+00:00,Anne Arundel,421.0,318446,383.0,295954,36.0,22789,457.0,419.0,318743,341235,614400
1126,1126,1126,1126,1126,1126,1126,1126,1127,2021-07-20 15:00:00+00:00,Anne Arundel,453.0,318899,377.0,296331,22.0,22811,475.0,399.0,319142,341710,615230
1127,1127,1127,1127,1127,1127,1127,1127,1128,2021-07-21 15:00:00+00:00,Anne Arundel,576.0,319475,426.0,296757,43.0,22854,619.0,469.0,319611,342329,616232
1128,1128,1128,1128,1128,1128,1128,1128,1129,2021-07-22 15:00:00+00:00,Anne Arundel,540.0,320015,380.0,297137,52.0,22906,592.0,432.0,320043,342921,617152
1129,1129,1129,1129,1129,1129,1129,1129,1130,2021-07-23 15:00:00+00:00,Anne Arundel,580.0,320595,373.0,297510,36.0,22942,616.0,409.0,320452,343537,618105
1130,1130,1130,1130,1130,1130,1130,1130,1131,2021-07-24 15:00:00+00:00,Anne Arundel,351.0,320946,295.0,297805,21.0,22963,372.0,316.0,320768,343909,618751
1131,1131,1131,1131,1131,1131,1131,1131,1132,2021-07-25 15:00:00+00:00,Anne Arundel,295.0,321241,90.0,297895,17.0,22980,312.0,107.0,320875,344221,619136
1132,1132,1132,1132,1132,1132,1132,1132,1133,2021-09-01 15:00:00+00:00,Baltimore City,545.0,318460,506.0,282689,46.0,20803,591.0,552.0,303492,339263,601149
1133,1133,1133,1133,1133,1133,1133,1133,1134,2021-09-02 15:00:00+00:00,Baltimore City,613.0,319073,656.0,283345,27.0,20830,640.0,683.0,304175,339903,602418
1134,1134,1134,1134,1134,1134,1134,1134,1135,2021-09-03 15:00:00+00:00,Baltimore City,709.0,319782,842.0,284187,46.0,20876,755.0,888.0,305063,340658,603969
1135,1135,1135,1135,1135,1135,1135,1135,1136,2021-09-04 15:00:00+00:00,Baltimore City,290.0,320072,348.0,284535,18.0,20894,308.0,366.0,305429,340966,604607
1136,1136,1136,1136,1136,1136,1136,1136,1137,2021-09-05 15:00:00+00:00,Baltimore City,253.0,320325,232.0,284767,19.0,20913,272.0,251.0,305680,341238,605092
1137,1137,1137,1137,1137,1137,1137,1137,1138,2021-09-06 15:00:00+00:00,Baltimore City,114.0,320439,96.0,284863,7.0,20920,121.0,103.0,305783,341359,605302
1138,1138,1138,1138,1138,1138,1138,1138,1139,2021-09-07 15:00:00+00:00,Baltimore City,503.0,320942,657.0,285520,11.0,20931,514.0,668.0,306451,341873,606462
1139,1139,1139,1139,1139,1139,1139,1139,1140,2021-09-08 15:00:00+00:00,Baltimore City,560.0,321502,670.0,286190,41.0,20972,601.0,711.0,307162,342474,607692
1140,1140,1140,1140,1140,1140,1140,1140,1141,2021-09-09 15:00:00+00:00,Baltimore City,605.0,322107,603.0,286793,16.0,20988,621.0,619.0,307781,343095,608900
1141,1141,1141,1141,1141,1141,1141,1141,1142,2021-09-10 15:00:00+00:00,Baltimore City,698.0,322805,711.0,287504,51.0,21039,749.0,762.0,308543,343844,610309
1142,1142,1142,1142,1142,1142,1142,1142,1143,2021-09-11 15:00:00+00:00,Baltimore City,400.0,323205,492.0,287996,23.0,21062,423.0,515.0,309058,344267,611201
1143,1143,1143,1143,1143,1143,1143,1143,1144,2021-09-12 15:00:00+00:00,Baltimore City,314.0,323519,378.0,288374,5.0,21067,319.0,383.0,309441,344586,611893
1144,1144,1144,1144,1144,1144,1144,1144,1145,2021-09-13 15:00:00+00:00,Baltimore City,468.0,323987,503.0,288877,22.0,21089,490.0,525.0,309966,345076,612864
1145,1145,1145,1145,1145,1145,1145,1145,1146,2021-09-14 15:00:00+00:00,Baltimore City,506.0,324493,707.0,289584,35.0,21124,541.0,742.0,310708,345617,614077
1146,1146,1146,1146,1146,1146,1146,1146,1147,2021-09-15 15:00:00+00:00,Baltimore City,471.0,324964,652.0,290236,21.0,21145,492.0,673.0,311381,346109,615200
1147,1147,1147,1147,1147,1147,1147,1147,1148,2021-09-16 15:00:00+00:00,Baltimore City,477.0,325441,575.0,290811,36.0,21181,513.0,611.0,311992,346622,616252
1148,1148,1148,1148,1148,1148,1148,1148,1149,2021-09-17 15:00:00+00:00,Baltimore City,546.0,325987,758.0,291569,31.0,21212,577.0,789.0,312781,347199,617556
1149,1149,1149,1149,1149,1149,1149,1149,1150,2021-09-18 15:00:00+00:00,Baltimore City,371.0,326358,664.0,292233,14.0,21226,385.0,678.0,313459,347584,618591
1150,1150,1150,1150,1150,1150,1150,1150,1151,2021-09-19 15:00:00+00:00,Baltimore City,216.0,326574,322.0,292555,2.0,21228,218.0,324.0,313783,347802,619129
1151,1151,1151,1151,1151,1151,1151,1151,1152,2021-09-20 15:00:00+00:00,Baltimore City,333.0,326907,590.0,293145,24.0,21252,357.0,614.0,314397,348159,620052
1152,1152,1152,1152,1152,1152,1152,1152,1153,2021-09-21 15:00:00+00:00,Baltimore City,418.0,327325,643.0,293788,21.0,21273,439.0,664.0,315061,348598,621113
1153,1153,1153,1153,1153,1153,1153,1153,1154,2021-09-22 15:00:00+00:00,Baltimore City,419.0,327744,491.0,294279,39.0,21312,458.0,530.0,315591,349056,622023
1154,1154,1154,1154,1154,1154,1154,1154,1155,2021-09-23 15:00:00+00:00,Baltimore City,477.0,328221,519.0,294798,31.0,21343,508.0,550.0,316141,349564,623019
1155,1155,1155,1155,1155,1155,1155,1155,1156,2021-09-24 15:00:00+00:00,Baltimore City,541.0,328762,679.0,295477,72.0,21415,613.0,751.0,316892,350177,624239
1156,1156,1156,1156,1156,1156,1156,1156,1157,2021-09-25 15:00:00+00:00,Baltimore City,297.0,329059,301.0,295778,4.0,21419,301.0,305.0,317197,350478,624837
1157,1157,1157,1157,1157,1157,1157,1157,1158,2021-09-26 15:00:00+00:00,Baltimore City,193.0,329252,188.0,295966,4.0,21423,197.0,192.0,317389,350675,625218
1158,1158,1158,1158,1158,1158,1158,1158,1159,2021-09-27 15:00:00+00:00,Baltimore City,432.0,329684,346.0,296312,26.0,21449,458.0,372.0,317761,351133,625996
1159,1159,1159,1159,1159,1159,1159,1159,1160,2021-09-28 15:00:00+00:00,Baltimore City,426.0,330110,552.0,296864,18.0,21467,444.0,570.0,318331,351577,626974
1160,1160,1160,1160,1160,1160,1160,1160,1161,2021-09-29 15:00:00+00:00,Baltimore City,479.0,330589,509.0,297373,14.0,21481,493.0,523.0,318854,352070,627962
1161,1161,1161,1161,1161,1161,1161,1161,1162,2021-09-30 15:00:00+00:00,Baltimore City,480.0,331069,543.0,297916,35.0,21516,515.0,578.0,319432,352585,628985
1162,1162,1162,1162,1162,1162,1162,1162,1163,2021-10-01 15:00:00+00:00,Baltimore City,607.0,331676,628.0,298544,32.0,21548,639.0,660.0,320092,353224,630220
1163,1163,1163,1163,1163,1163,1163,1163,1164,2021-10-02 15:00:00+00:00,Baltimore City,273.0,331949,302.0,298846,11.0,21559,284.0,313.0,320405,353508,630795
1164,1164,1164,1164,1164,1164,1164,1164,1165,2021-10-03 15:00:00+00:00,Baltimore City,234.0,332183,220.0,299066,25.0,21584,259.0,245.0,320650,353767,631249
1165,1165,1165,1165,1165,1165,1165,1165,1166,2021-10-04 15:00:00+00:00,Baltimore City,394.0,332577,323.0,299389,20.0,21604,414.0,343.0,320993,354181,631966
1166,1166,1166,1166,1166,1166,1166,1166,1167,2021-10-05 15:00:00+00:00,Baltimore City,420.0,332997,426.0,299815,10.0,21614,430.0,436.0,321429,354611,632812
1167,1167,1167,1167,1167,1167,1167,1167,1168,2021-10-06 15:00:00+00:00,Baltimore City,448.0,333445,430.0,300245,22.0,21636,470.0,452.0,321881,355081,633690
1168,1168,1168,1168,1168,1168,1168,1168,1169,2021-10-07 15:00:00+00:00,Baltimore City,460.0,333905,421.0,300666,32.0,21668,492.0,453.0,322334,355573,634571
1169,1169,1169,1169,1169,1169,1169,1169,1170,2021-10-08 15:00:00+00:00,Baltimore City,502.0,334407,437.0,301103,19.0,21687,521.0,456.0,322790,356094,635510
1170,1170,1170,1170,1170,1170,1170,1170,1171,2021-10-09 15:00:00+00:00,Baltimore City,208.0,334615,259.0,301362,28.0,21715,236.0,287.0,323077,356330,635977
1171,1171,1171,1171,1171,1171,1171,1171,1172,2021-10-10 15:00:00+00:00,Baltimore City,161.0,334776,149.0,301511,5.0,21720,166.0,154.0,323231,356496,636287
1172,1172,1172,1172,1172,1172,1172,1172,1173,2021-10-11 15:00:00+00:00,Baltimore City,392.0,335168,364.0,301875,12.0,21732,404.0,376.0,323607,356900,637043
1173,1173,1173,1173,1173,1173,1173,1173,1174,2021-10-12 15:00:00+00:00,Baltimore City,369.0,335537,409.0,302284,13.0,21745,382.0,422.0,324029,357282,637821
1174,1174,1174,1174,1174,1174,1174,1174,1175,2021-10-13 15:00:00+00:00,Baltimore City,389.0,335926,381.0,302665,51.0,21796,440.0,432.0,324461,357722,638591
1175,1175,1175,1175,1175,1175,1175,1175,1176,2021-10-14 15:00:00+00:00,Baltimore City,346.0,336272,388.0,303053,28.0,21824,374.0,416.0,324877,358096,639325
1176,1176,1176,1176,1176,1176,1176,1176,1177,2021-10-15 15:00:00+00:00,Baltimore City,438.0,336710,533.0,303586,29.0,21853,467.0,562.0,325439,358563,640296
1177,1177,1177,1177,1177,1177,1177,1177,1178,2021-10-16 15:00:00+00:00,Baltimore City,194.0,336904,235.0,303821,15.0,21868,209.0,250.0,325689,358772,640725
1178,1178,1178,1178,1178,1178,1178,1178,1179,2021-10-17 15:00:00+00:00,Baltimore City,134.0,337038,132.0,303953,3.0,21871,137.0,135.0,325824,358909,640991
1179,1179,1179,1179,1179,1179,1179,1179,1180,2021-10-18 15:00:00+00:00,Baltimore City,336.0,337374,383.0,304336,28.0,21899,364.0,411.0,326235,359273,641710
1180,1180,1180,1180,1180,1180,1180,1180,1181,2021-10-19 15:00:00+00:00,Baltimore City,308.0,337682,363.0,304699,13.0,21912,321.0,376.0,326611,359594,642381
1181,1181,1181,1181,1181,1181,1181,1181,1182,2021-10-20 15:00:00+00:00,Baltimore City,312.0,337994,376.0,305075,11.0,21923,323.0,387.0,326998,359917,643069
1182,1182,1182,1182,1182,1182,1182,1182,1183,2021-10-21 15:00:00+00:00,Baltimore City,375.0,338369,433.0,305508,29.0,21952,404.0,462.0,327460,360321,643877
1183,1183,1183,1183,1183,1183,1183,1183,1184,2021-10-22 15:00:00+00:00,Baltimore City,364.0,338733,573.0,306081,36.0,21988,400.0,609.0,328069,360721,644814
1184,1184,1184,1184,1184,1184,1184,1184,1185,2021-10-23 15:00:00+00:00,Baltimore City,188.0,338921,258.0,306339,9.0,21997,197.0,267.0,328336,360918,645260
1185,1185,1185,1185,1185,1185,1185,1185,1186,2021-10-24 15:00:00+00:00,Baltimore City,133.0,339054,180.0,306519,2.0,21999,135.0,182.0,328518,361053,645573
1186,1186,1186,1186,1186,1186,1186,1186,1187,2021-10-25 15:00:00+00:00,Baltimore City,310.0,339364,483.0,307002,30.0,22029,340.0,513.0,329031,361393,646366
1187,1187,1187,1187,1187,1187,1187,1187,1188,2021-10-26 15:00:00+00:00,Baltimore City,346.0,339710,523.0,307525,18.0,22047,364.0,541.0,329572,361757,647235
1188,1188,1188,1188,1188,1188,1188,1188,1189,2021-07-26 15:00:00+00:00,Anne Arundel,559.0,321800,382.0,298277,49.0,23029,608.0,431.0,321306,344829,620077
1189,1189,1189,1189,1189,1189,1189,1189,1190,2021-07-27 15:00:00+00:00,Anne Arundel,549.0,322349,352.0,298629,46.0,23075,595.0,398.0,321704,345424,620978
1190,1190,1190,1190,1190,1190,1190,1190,1191,2021-07-28 15:00:00+00:00,Anne Arundel,567.0,322916,328.0,298957,38.0,23113,605.0,366.0,322070,346029,621873
1191,1191,1191,1191,1191,1191,1191,1191,1192,2021-07-29 15:00:00+00:00,Anne Arundel,605.0,323521,366.0,299323,27.0,23140,632.0,393.0,322463,346661,622844
1192,1192,1192,1192,1192,1192,1192,1192,1193,2021-07-30 15:00:00+00:00,Anne Arundel,673.0,324194,360.0,299683,43.0,23183,716.0,403.0,322866,347377,623877
1193,1193,1193,1193,1193,1193,1193,1193,1194,2021-07-31 15:00:00+00:00,Anne Arundel,445.0,324639,243.0,299926,19.0,23202,464.0,262.0,323128,347841,624565
1194,1194,1194,1194,1194,1194,1194,1194,1195,2021-08-01 15:00:00+00:00,Anne Arundel,361.0,325000,154.0,300080,30.0,23232,391.0,184.0,323312,348232,625080
1195,1195,1195,1195,1195,1195,1195,1195,1196,2021-08-02 15:00:00+00:00,Anne Arundel,750.0,325750,336.0,300416,32.0,23264,782.0,368.0,323680,349014,626166
1196,1196,1196,1196,1196,1196,1196,1196,1197,2021-08-03 15:00:00+00:00,Anne Arundel,658.0,326408,313.0,300729,49.0,23313,707.0,362.0,324042,349721,627137
1197,1197,1197,1197,1197,1197,1197,1197,1198,2021-08-04 15:00:00+00:00,Anne Arundel,668.0,327076,330.0,301059,59.0,23372,727.0,389.0,324431,350448,628135
1198,1198,1198,1198,1198,1198,1198,1198,1199,2021-08-05 15:00:00+00:00,Anne Arundel,690.0,327766,322.0,301381,44.0,23416,734.0,366.0,324797,351182,629147
1199,1199,1199,1199,1199,1199,1199,1199,1200,2021-08-06 15:00:00+00:00,Anne Arundel,782.0,328548,378.0,301759,50.0,23466,832.0,428.0,325225,352014,630307
1200,1200,1200,1200,1200,1200,1200,1200,1201,2021-08-07 15:00:00+00:00,Anne Arundel,467.0,329015,247.0,302006,32.0,23498,499.0,279.0,325504,352513,631021
1201,1201,1201,1201,1201,1201,1201,1201,1202,2021-08-08 15:00:00+00:00,Anne Arundel,349.0,329364,165.0,302171,15.0,23513,364.0,180.0,325684,352877,631535
1202,1202,1202,1202,1202,1202,1202,1202,1203,2021-08-09 15:00:00+00:00,Anne Arundel,592.0,329956,414.0,302585,33.0,23546,625.0,447.0,326131,353502,632541
1203,1203,1203,1203,1203,1203,1203,1203,1204,2021-08-10 15:00:00+00:00,Anne Arundel,708.0,330664,356.0,302941,46.0,23592,754.0,402.0,326533,354256,633605
1204,1204,1204,1204,1204,1204,1204,1204,1205,2021-08-11 15:00:00+00:00,Anne Arundel,602.0,331266,432.0,303373,59.0,23651,661.0,491.0,327024,354917,634639
1205,1205,1205,1205,1205,1205,1205,1205,1206,2021-08-12 15:00:00+00:00,Anne Arundel,635.0,331901,429.0,303802,41.0,23692,676.0,470.0,327494,355593,635703
1206,1206,1206,1206,1206,1206,1206,1206,1207,2021-08-13 15:00:00+00:00,Anne Arundel,619.0,332520,454.0,304256,41.0,23733,660.0,495.0,327989,356253,636776
1207,1207,1207,1207,1207,1207,1207,1207,1208,2021-08-14 15:00:00+00:00,Anne Arundel,409.0,332929,322.0,304578,29.0,23762,438.0,351.0,328340,356691,637507
1208,1208,1208,1208,1208,1208,1208,1208,1209,2021-08-15 15:00:00+00:00,Anne Arundel,268.0,333197,215.0,304793,22.0,23784,290.0,237.0,328577,356981,637990
1209,1209,1209,1209,1209,1209,1209,1209,1210,2021-08-16 15:00:00+00:00,Anne Arundel,459.0,333656,470.0,305263,33.0,23817,492.0,503.0,329080,357473,638919
1210,1210,1210,1210,1210,1210,1210,1210,1211,2021-08-17 15:00:00+00:00,Anne Arundel,547.0,334203,444.0,305707,27.0,23844,574.0,471.0,329551,358047,639910
1211,1211,1211,1211,1211,1211,1211,1211,1212,2021-08-18 15:00:00+00:00,Anne Arundel,545.0,334748,488.0,306195,39.0,23883,584.0,527.0,330078,358631,640943
1212,1212,1212,1212,1212,1212,1212,1212,1213,2021-08-19 15:00:00+00:00,Anne Arundel,502.0,335250,477.0,306672,25.0,23908,527.0,502.0,330580,359158,641922
1213,1213,1213,1213,1213,1213,1213,1213,1214,2021-08-20 15:00:00+00:00,Anne Arundel,493.0,335743,555.0,307227,25.0,23933,518.0,580.0,331160,359676,642970
1214,1214,1214,1214,1214,1214,1214,1214,1215,2021-08-21 15:00:00+00:00,Anne Arundel,324.0,336067,391.0,307618,22.0,23955,346.0,413.0,331573,360022,643685
1215,1215,1215,1215,1215,1215,1215,1215,1216,2021-08-22 15:00:00+00:00,Anne Arundel,259.0,336326,345.0,307963,8.0,23963,267.0,353.0,331926,360289,644289
1216,1216,1216,1216,1216,1216,1216,1216,1217,2021-08-23 15:00:00+00:00,Anne Arundel,519.0,336845,600.0,308563,22.0,23985,541.0,622.0,332548,360830,645408
1217,1217,1217,1217,1217,1217,1217,1217,1218,2021-08-24 15:00:00+00:00,Anne Arundel,540.0,337385,587.0,309150,21.0,24006,561.0,608.0,333156,361391,646535
1218,1218,1218,1218,1218,1218,1218,1218,1219,2021-08-25 15:00:00+00:00,Anne Arundel,543.0,337928,569.0,309719,63.0,24069,606.0,632.0,333788,361997,647647
1219,1219,1219,1219,1219,1219,1219,1219,1220,2021-08-26 15:00:00+00:00,Anne Arundel,552.0,338480,569.0,310288,33.0,24102,585.0,602.0,334390,362582,648768
1220,1220,1220,1220,1220,1220,1220,1220,1221,2021-08-27 15:00:00+00:00,Anne Arundel,562.0,339042,677.0,310965,18.0,24120,580.0,695.0,335085,363162,650007
1221,1221,1221,1221,1221,1221,1221,1221,1222,2021-08-28 15:00:00+00:00,Anne Arundel,397.0,339439,458.0,311423,18.0,24138,415.0,476.0,335561,363577,650862
1222,1222,1222,1222,1222,1222,1222,1222,1223,2021-08-29 15:00:00+00:00,Anne Arundel,289.0,339728,337.0,311760,2.0,24140,291.0,339.0,335900,363868,651488
1223,1223,1223,1223,1223,1223,1223,1223,1224,2021-08-30 15:00:00+00:00,Anne Arundel,559.0,340287,594.0,312354,29.0,24169,588.0,623.0,336523,364456,652641
1224,1224,1224,1224,1224,1224,1224,1224,1225,2021-08-31 15:00:00+00:00,Anne Arundel,479.0,340766,606.0,312960,17.0,24186,496.0,623.0,337146,364952,653726
1225,1225,1225,1225,1225,1225,1225,1225,1226,2021-09-01 15:00:00+00:00,Anne Arundel,450.0,341216,472.0,313432,28.0,24214,478.0,500.0,337646,365430,654648
1226,1226,1226,1226,1226,1226,1226,1226,1227,2021-09-02 15:00:00+00:00,Anne Arundel,487.0,341703,583.0,314015,34.0,24248,521.0,617.0,338263,365951,655718
1227,1227,1227,1227,1227,1227,1227,1227,1228,2021-09-03 15:00:00+00:00,Anne Arundel,518.0,342221,614.0,314629,21.0,24269,539.0,635.0,338898,366490,656850
1228,1228,1228,1228,1228,1228,1228,1228,1229,2021-09-04 15:00:00+00:00,Anne Arundel,305.0,342526,389.0,315018,9.0,24278,314.0,398.0,339296,366804,657544
1229,1229,1229,1229,1229,1229,1229,1229,1230,2021-09-05 15:00:00+00:00,Anne Arundel,239.0,342765,248.0,315266,9.0,24287,248.0,257.0,339553,367052,658031
1230,1230,1230,1230,1230,1230,1230,1230,1231,2021-09-06 15:00:00+00:00,Anne Arundel,105.0,342870,98.0,315364,6.0,24293,111.0,104.0,339657,367163,658234
1231,1231,1231,1231,1231,1231,1231,1231,1232,2021-09-07 15:00:00+00:00,Anne Arundel,396.0,343266,663.0,316027,28.0,24321,424.0,691.0,340348,367587,659293
1232,1232,1232,1232,1232,1232,1232,1232,1233,2021-09-08 15:00:00+00:00,Anne Arundel,422.0,343688,439.0,316466,38.0,24359,460.0,477.0,340825,368047,660154
1233,1233,1233,1233,1233,1233,1233,1233,1234,2021-09-09 15:00:00+00:00,Anne Arundel,445.0,344133,447.0,316913,18.0,24377,463.0,465.0,341290,368510,661046
1234,1234,1234,1234,1234,1234,1234,1234,1235,2021-09-10 15:00:00+00:00,Anne Arundel,450.0,344583,519.0,317432,44.0,24421,494.0,563.0,341853,369004,662015
1235,1235,1235,1235,1235,1235,1235,1235,1236,2021-09-11 15:00:00+00:00,Anne Arundel,323.0,344906,302.0,317734,13.0,24434,336.0,315.0,342168,369340,662640
1236,1236,1236,1236,1236,1236,1236,1236,1237,2021-09-12 15:00:00+00:00,Anne Arundel,227.0,345133,230.0,317964,6.0,24440,233.0,236.0,342404,369573,663097
1237,1237,1237,1237,1237,1237,1237,1237,1238,2021-09-13 15:00:00+00:00,Anne Arundel,379.0,345512,413.0,318377,24.0,24464,403.0,437.0,342841,369976,663889
1238,1238,1238,1238,1238,1238,1238,1238,1239,2021-09-14 15:00:00+00:00,Anne Arundel,358.0,345870,415.0,318792,30.0,24494,388.0,445.0,343286,370364,664662
1239,1239,1239,1239,1239,1239,1239,1239,1240,2021-09-15 15:00:00+00:00,Anne Arundel,358.0,346228,425.0,319217,40.0,24534,398.0,465.0,343751,370762,665445
1240,1240,1240,1240,1240,1240,1240,1240,1241,2021-09-16 15:00:00+00:00,Anne Arundel,384.0,346612,493.0,319710,28.0,24562,412.0,521.0,344272,371174,666322
1241,1241,1241,1241,1241,1241,1241,1241,1242,2021-09-17 15:00:00+00:00,Anne Arundel,396.0,347008,513.0,320223,25.0,24587,421.0,538.0,344810,371595,667231
1242,1242,1242,1242,1242,1242,1242,1242,1243,2021-09-18 15:00:00+00:00,Anne Arundel,269.0,347277,386.0,320609,7.0,24594,276.0,393.0,345203,371871,667886
1243,1243,1243,1243,1243,1243,1243,1243,1244,2021-09-19 15:00:00+00:00,Anne Arundel,181.0,347458,236.0,320845,4.0,24598,185.0,240.0,345443,372056,668303
1244,1244,1244,1244,1244,1244,1244,1244,1245,2021-09-20 15:00:00+00:00,Anne Arundel,272.0,347730,404.0,321249,8.0,24606,280.0,412.0,345855,372336,668979
1245,1245,1245,1245,1245,1245,1245,1245,1246,2021-09-21 15:00:00+00:00,Anne Arundel,354.0,348084,473.0,321722,23.0,24629,377.0,496.0,346351,372713,669806
1246,1246,1246,1246,1246,1246,1246,1246,1247,2021-09-22 15:00:00+00:00,Anne Arundel,309.0,348393,367.0,322089,33.0,24662,342.0,400.0,346751,373055,670482
1247,1247,1247,1247,1247,1247,1247,1247,1248,2021-09-23 15:00:00+00:00,Anne Arundel,316.0,348709,442.0,322531,27.0,24689,343.0,469.0,347220,373398,671240
1248,1248,1248,1248,1248,1248,1248,1248,1249,2021-09-24 15:00:00+00:00,Anne Arundel,360.0,349069,508.0,323039,13.0,24702,373.0,521.0,347741,373771,672108
1249,1249,1249,1249,1249,1249,1249,1249,1250,2021-09-25 15:00:00+00:00,Anne Arundel,239.0,349308,302.0,323341,8.0,24710,247.0,310.0,348051,374018,672649
1250,1250,1250,1250,1250,1250,1250,1250,1251,2021-09-26 15:00:00+00:00,Anne Arundel,167.0,349475,195.0,323536,,24710,,,348246,374185,673011
1251,1251,1251,1251,1251,1251,1251,1251,1252,2021-09-27 15:00:00+00:00,Anne Arundel,370.0,349845,245.0,323781,27.0,24737,397.0,272.0,348518,374582,673626
1252,1252,1252,1252,1252,1252,1252,1252,1253,2021-09-28 15:00:00+00:00,Anne Arundel,353.0,350198,368.0,324149,17.0,24754,370.0,385.0,348903,374952,674347
1253,1253,1253,1253,1253,1253,1253,1253,1254,2021-09-29 15:00:00+00:00,Anne Arundel,356.0,350554,334.0,324483,25.0,24779,381.0,359.0,349262,375333,675037
1254,1254,1254,1254,1254,1254,1254,1254,1255,2021-09-30 15:00:00+00:00,Anne Arundel,353.0,350907,417.0,324900,20.0,24799,373.0,437.0,349699,375706,675807
1255,1255,1255,1255,1255,1255,1255,1255,1256,2021-10-01 15:00:00+00:00,Anne Arundel,432.0,351339,419.0,325319,25.0,24824,457.0,444.0,350143,376163,676658
1256,1256,1256,1256,1256,1256,1256,1256,1257,2021-10-02 15:00:00+00:00,Anne Arundel,225.0,351564,266.0,325585,7.0,24831,232.0,273.0,350416,376395,677149
1257,1257,1257,1257,1257,1257,1257,1257,1258,2021-10-03 15:00:00+00:00,Anne Arundel,134.0,351698,176.0,325761,4.0,24835,138.0,180.0,350596,376533,677459
1258,1258,1258,1258,1258,1258,1258,1258,1259,2021-10-04 15:00:00+00:00,Anne Arundel,326.0,352024,327.0,326088,16.0,24851,342.0,343.0,350939,376875,678112
1259,1259,1259,1259,1259,1259,1259,1259,1260,2021-10-05 15:00:00+00:00,Anne Arundel,308.0,352332,313.0,326401,17.0,24868,325.0,330.0,351269,377200,678733
1260,1260,1260,1260,1260,1260,1260,1260,1261,2021-10-06 15:00:00+00:00,Anne Arundel,328.0,352660,287.0,326688,42.0,24910,370.0,329.0,351598,377570,679348
1261,1261,1261,1261,1261,1261,1261,1261,1262,2021-10-07 15:00:00+00:00,Anne Arundel,366.0,353026,302.0,326990,17.0,24927,383.0,319.0,351917,377953,680016
1262,1262,1262,1262,1262,1262,1262,1262,1263,2021-10-08 15:00:00+00:00,Anne Arundel,389.0,353415,373.0,327363,26.0,24953,415.0,399.0,352316,378368,680778
1263,1263,1263,1263,1263,1263,1263,1263,1264,2021-10-09 15:00:00+00:00,Anne Arundel,169.0,353584,246.0,327609,6.0,24959,175.0,252.0,352568,378543,681193
1264,1264,1264,1264,1264,1264,1264,1264,1265,2021-10-10 15:00:00+00:00,Anne Arundel,123.0,353707,147.0,327756,,24959,,,352715,378666,681463
1265,1265,1265,1265,1265,1265,1265,1265,1266,2021-10-11 15:00:00+00:00,Anne Arundel,398.0,354105,279.0,328035,49.0,25008,447.0,328.0,353043,379113,682140
1266,1266,1266,1266,1266,1266,1266,1266,1267,2021-10-12 15:00:00+00:00,Anne Arundel,285.0,354390,285.0,328320,13.0,25021,298.0,298.0,353341,379411,682710
1267,1267,1267,1267,1267,1267,1267,1267,1268,2021-10-13 15:00:00+00:00,Anne Arundel,326.0,354716,282.0,328602,50.0,25071,376.0,332.0,353673,379787,683318
1268,1268,1268,1268,1268,1268,1268,1268,1269,2021-10-14 15:00:00+00:00,Anne Arundel,303.0,355019,248.0,328850,22.0,25093,325.0,270.0,353943,380112,683869
1269,1269,1269,1269,1269,1269,1269,1269,1270,2021-10-15 15:00:00+00:00,Anne Arundel,350.0,355369,325.0,329175,21.0,25114,371.0,346.0,354289,380483,684544
1270,1270,1270,1270,1270,1270,1270,1270,1271,2021-10-16 15:00:00+00:00,Anne Arundel,169.0,355538,182.0,329357,11.0,25125,180.0,193.0,354482,380663,684895
1271,1271,1271,1271,1271,1271,1271,1271,1272,2021-10-17 15:00:00+00:00,Anne Arundel,107.0,355645,134.0,329491,1.0,25126,108.0,135.0,354617,380771,685136
1272,1272,1272,1272,1272,1272,1272,1272,1273,2021-10-27 15:00:00+00:00,Baltimore City,334.0,340044,499.0,308024,32.0,22079,366.0,531.0,330103,362123,648068
1273,1273,1273,1273,1273,1273,1273,1273,1274,2021-10-28 15:00:00+00:00,Baltimore City,390.0,340434,534.0,308558,19.0,22098,409.0,553.0,330656,362532,648992
1274,1274,1274,1274,1274,1274,1274,1274,1275,2021-10-29 15:00:00+00:00,Baltimore City,361.0,340795,585.0,309143,37.0,22135,398.0,622.0,331278,362930,649938
1275,1275,1275,1275,1275,1275,1275,1275,1276,2021-10-30 15:00:00+00:00,Baltimore City,204.0,340999,245.0,309388,11.0,22146,215.0,256.0,331534,363145,650387
1276,1276,1276,1276,1276,1276,1276,1276,1277,2021-10-31 15:00:00+00:00,Baltimore City,130.0,341129,180.0,309568,5.0,22151,135.0,185.0,331719,363280,650697
1277,1277,1277,1277,1277,1277,1277,1277,1278,2021-11-01 15:00:00+00:00,Baltimore City,272.0,341401,442.0,310010,20.0,22171,292.0,462.0,332181,363572,651411
1278,1278,1278,1278,1278,1278,1278,1278,1279,2021-11-02 15:00:00+00:00,Baltimore City,291.0,341692,480.0,310490,23.0,22194,314.0,503.0,332684,363886,652182
1279,1279,1279,1279,1279,1279,1279,1279,1280,2021-11-03 15:00:00+00:00,Baltimore City,337.0,342029,433.0,310923,33.0,22227,370.0,466.0,333150,364256,652952
1280,1280,1280,1280,1280,1280,1280,1280,1281,2021-11-04 15:00:00+00:00,Baltimore City,286.0,342315,389.0,311312,20.0,22247,306.0,409.0,333559,364562,653627
1281,1281,1281,1281,1281,1281,1281,1281,1282,2021-11-05 15:00:00+00:00,Baltimore City,300.0,342615,498.0,311810,22.0,22269,322.0,520.0,334079,364884,654425
1282,1282,1282,1282,1282,1282,1282,1282,1283,2021-11-06 15:00:00+00:00,Baltimore City,74.0,342689,140.0,311950,5.0,22274,79.0,145.0,334224,364963,654639
1283,1283,1283,1283,1283,1283,1283,1283,1284,2020-12-16 15:00:00+00:00,Caroline,2.0,2,,0,,0,,,0,2,2
1284,1284,1284,1284,1284,1284,1284,1284,1285,2020-12-17 15:00:00+00:00,Caroline,10.0,12,,0,,0,,,0,12,12
1285,1285,1285,1285,1285,1285,1285,1285,1286,2020-12-18 15:00:00+00:00,Caroline,6.0,18,,0,,0,,,0,18,18
1286,1286,1286,1286,1286,1286,1286,1286,1287,2020-12-21 15:00:00+00:00,Caroline,9.0,27,1.0,1,,0,,,1,27,28
1287,1287,1287,1287,1287,1287,1287,1287,1288,2020-12-22 15:00:00+00:00,Caroline,19.0,46,,1,,0,,,1,46,47
1288,1288,1288,1288,1288,1288,1288,1288,1289,2020-12-23 15:00:00+00:00,Caroline,69.0,115,1.0,2,,0,,,2,115,117
1289,1289,1289,1289,1289,1289,1289,1289,1290,2020-12-24 15:00:00+00:00,Caroline,4.0,119,,2,,0,,,2,119,121
1290,1290,1290,1290,1290,1290,1290,1290,1291,2020-12-25 15:00:00+00:00,Caroline,2.0,121,,2,,0,,,2,121,123
1291,1291,1291,1291,1291,1291,1291,1291,1292,2020-12-26 15:00:00+00:00,Caroline,7.0,128,,2,,0,,,2,128,130
1292,1292,1292,1292,1292,1292,1292,1292,1293,2020-12-27 15:00:00+00:00,Caroline,44.0,172,1.0,3,,0,,,3,172,175
1293,1293,1293,1293,1293,1293,1293,1293,1294,2020-12-28 15:00:00+00:00,Caroline,16.0,188,,3,,0,,,3,188,191
1294,1294,1294,1294,1294,1294,1294,1294,1295,2020-12-29 15:00:00+00:00,Caroline,73.0,261,,3,,0,,,3,261,264
1295,1295,1295,1295,1295,1295,1295,1295,1296,2020-12-30 15:00:00+00:00,Caroline,409.0,670,2.0,5,,0,,,5,670,675
1296,1296,1296,1296,1296,1296,1296,1296,1297,2020-12-31 15:00:00+00:00,Caroline,58.0,728,,5,,0,,,5,728,733
1297,1297,1297,1297,1297,1297,1297,1297,1298,2021-01-01 15:00:00+00:00,Caroline,2.0,730,1.0,6,,0,,,6,730,736
1298,1298,1298,1298,1298,1298,1298,1298,1299,2021-01-02 15:00:00+00:00,Caroline,21.0,751,,6,,0,,,6,751,757
1299,1299,1299,1299,1299,1299,1299,1299,1300,2021-01-03 15:00:00+00:00,Caroline,3.0,754,,6,,0,,,6,754,760
1300,1300,1300,1300,1300,1300,1300,1300,1301,2021-01-04 15:00:00+00:00,Caroline,106.0,860,,6,,0,,,6,860,866
1301,1301,1301,1301,1301,1301,1301,1301,1302,2021-01-05 15:00:00+00:00,Caroline,68.0,928,,6,,0,,,6,928,934
1302,1302,1302,1302,1302,1302,1302,1302,1303,2021-01-06 15:00:00+00:00,Caroline,305.0,1233,3.0,9,,0,,,9,1233,1242
1303,1303,1303,1303,1303,1303,1303,1303,1304,2021-01-07 15:00:00+00:00,Caroline,74.0,1307,10.0,19,,0,,,19,1307,1326
1304,1304,1304,1304,1304,1304,1304,1304,1305,2021-01-08 15:00:00+00:00,Caroline,116.0,1423,5.0,24,,0,,,24,1423,1447
1305,1305,1305,1305,1305,1305,1305,1305,1306,2021-01-09 15:00:00+00:00,Caroline,8.0,1431,,24,,0,,,24,1431,1455
1306,1306,1306,1306,1306,1306,1306,1306,1307,2021-01-10 15:00:00+00:00,Caroline,1.0,1432,1.0,25,,0,,,25,1432,1457
1307,1307,1307,1307,1307,1307,1307,1307,1308,2021-01-11 15:00:00+00:00,Caroline,35.0,1467,7.0,32,,0,,,32,1467,1499
1308,1308,1308,1308,1308,1308,1308,1308,1309,2021-01-12 15:00:00+00:00,Caroline,39.0,1506,23.0,55,,0,,,55,1506,1561
1309,1309,1309,1309,1309,1309,1309,1309,1310,2021-01-13 15:00:00+00:00,Caroline,168.0,1674,20.0,75,,0,,,75,1674,1749
1310,1310,1310,1310,1310,1310,1310,1310,1311,2021-01-14 15:00:00+00:00,Caroline,87.0,1761,4.0,79,,0,,,79,1761,1840
1311,1311,1311,1311,1311,1311,1311,1311,1312,2021-01-15 15:00:00+00:00,Caroline,111.0,1872,11.0,90,,0,,,90,1872,1962
1312,1312,1312,1312,1312,1312,1312,1312,1313,2021-01-16 15:00:00+00:00,Caroline,8.0,1880,3.0,93,,0,,,93,1880,1973
1313,1313,1313,1313,1313,1313,1313,1313,1314,2021-01-17 15:00:00+00:00,Caroline,46.0,1926,39.0,132,,0,,,132,1926,2058
1314,1314,1314,1314,1314,1314,1314,1314,1315,2021-01-18 15:00:00+00:00,Caroline,20.0,1946,8.0,140,,0,,,140,1946,2086
1315,1315,1315,1315,1315,1315,1315,1315,1316,2021-01-19 15:00:00+00:00,Caroline,40.0,1986,5.0,145,,0,,,145,1986,2131
1316,1316,1316,1316,1316,1316,1316,1316,1317,2021-01-20 15:00:00+00:00,Caroline,374.0,2360,38.0,183,,0,,,183,2360,2543
1317,1317,1317,1317,1317,1317,1317,1317,1318,2021-01-21 15:00:00+00:00,Caroline,105.0,2465,15.0,198,,0,,,198,2465,2663
1318,1318,1318,1318,1318,1318,1318,1318,1319,2021-01-22 15:00:00+00:00,Caroline,198.0,2663,32.0,230,,0,,,230,2663,2893
1319,1319,1319,1319,1319,1319,1319,1319,1320,2021-01-23 15:00:00+00:00,Caroline,11.0,2674,16.0,246,,0,,,246,2674,2920
1320,1320,1320,1320,1320,1320,1320,1320,1321,2021-01-24 15:00:00+00:00,Caroline,7.0,2681,2.0,248,,0,,,248,2681,2929
1321,1321,1321,1321,1321,1321,1321,1321,1322,2021-01-25 15:00:00+00:00,Caroline,51.0,2732,28.0,276,,0,,,276,2732,3008
1322,1322,1322,1322,1322,1322,1322,1322,1323,2021-01-26 15:00:00+00:00,Caroline,120.0,2852,104.0,380,,0,,,380,2852,3232
1323,1323,1323,1323,1323,1323,1323,1323,1324,2021-01-27 15:00:00+00:00,Caroline,111.0,2963,192.0,572,,0,,,572,2963,3535
1324,1324,1324,1324,1324,1324,1324,1324,1325,2021-01-28 15:00:00+00:00,Caroline,267.0,3230,99.0,671,,0,,,671,3230,3901
1325,1325,1325,1325,1325,1325,1325,1325,1326,2021-01-29 15:00:00+00:00,Caroline,189.0,3419,133.0,804,,0,,,804,3419,4223
1326,1326,1326,1326,1326,1326,1326,1326,1327,2021-01-30 15:00:00+00:00,Caroline,6.0,3425,8.0,812,,0,,,812,3425,4237
1327,1327,1327,1327,1327,1327,1327,1327,1328,2021-01-31 15:00:00+00:00,Caroline,2.0,3427,1.0,813,,0,,,813,3427,4240
1328,1328,1328,1328,1328,1328,1328,1328,1329,2021-04-23 15:00:00+00:00,Allegany,245.0,23109,1095.0,17729,,2102,,,19831,25211,40838
1329,1329,1329,1329,1329,1329,1329,1329,1330,2021-04-24 15:00:00+00:00,Allegany,40.0,23149,9.0,17738,,2102,,,19840,25251,40887
1330,1330,1330,1330,1330,1330,1330,1330,1331,2021-04-25 15:00:00+00:00,Allegany,21.0,23170,4.0,17742,,2102,,,19844,25272,40912
1331,1331,1331,1331,1331,1331,1331,1331,1332,2021-04-26 15:00:00+00:00,Allegany,83.0,23253,48.0,17790,,2102,,,19892,25355,41043
1332,1332,1332,1332,1332,1332,1332,1332,1333,2021-04-27 15:00:00+00:00,Allegany,104.0,23357,46.0,17836,3.0,2105,107.0,49.0,19941,25462,41193
1333,1333,1333,1333,1333,1333,1333,1333,1334,2021-04-28 15:00:00+00:00,Allegany,68.0,23425,681.0,18517,6.0,2111,74.0,687.0,20628,25536,41942
1334,1334,1334,1334,1334,1334,1334,1334,1335,2021-04-29 15:00:00+00:00,Allegany,228.0,23653,134.0,18651,10.0,2121,238.0,144.0,20772,25774,42304
1335,1335,1335,1335,1335,1335,1335,1335,1336,2021-04-30 15:00:00+00:00,Allegany,106.0,23759,754.0,19405,13.0,2134,119.0,767.0,21539,25893,43164
1336,1336,1336,1336,1336,1336,1336,1336,1337,2021-05-01 15:00:00+00:00,Allegany,25.0,23784,11.0,19416,14.0,2148,39.0,25.0,21564,25932,43200
1337,1337,1337,1337,1337,1337,1337,1337,1338,2021-05-02 15:00:00+00:00,Allegany,7.0,23791,33.0,19449,5.0,2153,12.0,38.0,21602,25944,43240
1338,1338,1338,1338,1338,1338,1338,1338,1339,2021-05-03 15:00:00+00:00,Allegany,37.0,23828,71.0,19520,6.0,2159,43.0,77.0,21679,25987,43348
1339,1339,1339,1339,1339,1339,1339,1339,1340,2021-05-04 15:00:00+00:00,Allegany,95.0,23923,62.0,19582,11.0,2170,106.0,73.0,21752,26093,43505
1340,1340,1340,1340,1340,1340,1340,1340,1341,2021-05-05 15:00:00+00:00,Allegany,44.0,23967,447.0,20029,4.0,2174,48.0,451.0,22203,26141,43996
1341,1341,1341,1341,1341,1341,1341,1341,1342,2021-05-06 15:00:00+00:00,Allegany,137.0,24104,176.0,20205,19.0,2193,156.0,195.0,22398,26297,44309
1342,1342,1342,1342,1342,1342,1342,1342,1343,2021-05-07 15:00:00+00:00,Allegany,171.0,24275,154.0,20359,36.0,2229,207.0,190.0,22588,26504,44634
1343,1343,1343,1343,1343,1343,1343,1343,1344,2021-05-08 15:00:00+00:00,Allegany,13.0,24288,17.0,20376,5.0,2234,18.0,22.0,22610,26522,44664
1344,1344,1344,1344,1344,1344,1344,1344,1345,2021-05-09 15:00:00+00:00,Allegany,10.0,24298,14.0,20390,1.0,2235,11.0,15.0,22625,26533,44688
1345,1345,1345,1345,1345,1345,1345,1345,1346,2021-05-10 15:00:00+00:00,Allegany,24.0,24322,106.0,20496,5.0,2240,29.0,111.0,22736,26562,44818
1346,1346,1346,1346,1346,1346,1346,1346,1347,2021-05-11 15:00:00+00:00,Allegany,36.0,24358,78.0,20574,12.0,2252,48.0,90.0,22826,26610,44932
1347,1347,1347,1347,1347,1347,1347,1347,1348,2021-05-12 15:00:00+00:00,Allegany,43.0,24401,390.0,20964,12.0,2264,55.0,402.0,23228,26665,45365
1348,1348,1348,1348,1348,1348,1348,1348,1349,2021-05-13 15:00:00+00:00,Allegany,94.0,24495,76.0,21040,41.0,2305,135.0,117.0,23345,26800,45535
1349,1349,1349,1349,1349,1349,1349,1349,1350,2021-05-14 15:00:00+00:00,Allegany,96.0,24591,598.0,21638,14.0,2319,110.0,612.0,23957,26910,46229
1350,1350,1350,1350,1350,1350,1350,1350,1351,2021-05-15 15:00:00+00:00,Allegany,39.0,24630,71.0,21709,17.0,2336,56.0,88.0,24045,26966,46339
1351,1351,1351,1351,1351,1351,1351,1351,1352,2021-05-16 15:00:00+00:00,Allegany,35.0,24665,11.0,21720,3.0,2339,38.0,14.0,24059,27004,46385
1352,1352,1352,1352,1352,1352,1352,1352,1353,2021-05-17 15:00:00+00:00,Allegany,132.0,24797,95.0,21815,23.0,2362,155.0,118.0,24177,27159,46612
1353,1353,1353,1353,1353,1353,1353,1353,1354,2021-05-18 15:00:00+00:00,Allegany,66.0,24863,86.0,21901,21.0,2383,87.0,107.0,24284,27246,46764
1354,1354,1354,1354,1354,1354,1354,1354,1355,2021-05-19 15:00:00+00:00,Allegany,162.0,25025,195.0,22096,14.0,2397,176.0,209.0,24493,27422,47121
1355,1355,1355,1355,1355,1355,1355,1355,1356,2021-05-20 15:00:00+00:00,Allegany,172.0,25197,210.0,22306,84.0,2481,256.0,294.0,24787,27678,47503
1356,1356,1356,1356,1356,1356,1356,1356,1357,2021-05-21 15:00:00+00:00,Allegany,308.0,25505,229.0,22535,26.0,2507,334.0,255.0,25042,28012,48040
1357,1357,1357,1357,1357,1357,1357,1357,1358,2021-05-22 15:00:00+00:00,Allegany,35.0,25540,13.0,22548,15.0,2522,50.0,28.0,25070,28062,48088
1358,1358,1358,1358,1358,1358,1358,1358,1359,2021-05-23 15:00:00+00:00,Allegany,20.0,25560,11.0,22559,4.0,2526,24.0,15.0,25085,28086,48119
1359,1359,1359,1359,1359,1359,1359,1359,1360,2021-05-24 15:00:00+00:00,Allegany,68.0,25628,35.0,22594,11.0,2537,79.0,46.0,25131,28165,48222
1360,1360,1360,1360,1360,1360,1360,1360,1361,2021-05-25 15:00:00+00:00,Allegany,59.0,25687,75.0,22669,25.0,2562,84.0,100.0,25231,28249,48356
1361,1361,1361,1361,1361,1361,1361,1361,1362,2021-05-26 15:00:00+00:00,Allegany,68.0,25755,44.0,22713,17.0,2579,85.0,61.0,25292,28334,48468
1362,1362,1362,1362,1362,1362,1362,1362,1363,2021-05-27 15:00:00+00:00,Allegany,150.0,25905,152.0,22865,20.0,2599,170.0,172.0,25464,28504,48770
1363,1363,1363,1363,1363,1363,1363,1363,1364,2021-05-28 15:00:00+00:00,Allegany,29.0,25934,160.0,23025,10.0,2609,39.0,170.0,25634,28543,48959
1364,1364,1364,1364,1364,1364,1364,1364,1365,2021-05-29 15:00:00+00:00,Allegany,25.0,25959,21.0,23046,2.0,2611,27.0,23.0,25657,28570,49005
1365,1365,1365,1365,1365,1365,1365,1365,1366,2021-05-30 15:00:00+00:00,Allegany,13.0,25972,9.0,23055,4.0,2615,17.0,13.0,25670,28587,49027
1366,1366,1366,1366,1366,1366,1366,1366,1367,2021-05-31 15:00:00+00:00,Allegany,6.0,25978,9.0,23064,1.0,2616,7.0,10.0,25680,28594,49042
1367,1367,1367,1367,1367,1367,1367,1367,1368,2021-06-01 15:00:00+00:00,Allegany,48.0,26026,122.0,23186,22.0,2638,70.0,144.0,25824,28664,49212
1368,1368,1368,1368,1368,1368,1368,1368,1369,2021-06-02 15:00:00+00:00,Allegany,32.0,26058,44.0,23230,15.0,2653,47.0,59.0,25883,28711,49288
1369,1369,1369,1369,1369,1369,1369,1369,1370,2021-06-03 15:00:00+00:00,Allegany,34.0,26092,76.0,23306,51.0,2704,85.0,127.0,26010,28796,49398
1370,1370,1370,1370,1370,1370,1370,1370,1371,2021-06-04 15:00:00+00:00,Allegany,52.0,26144,131.0,23437,23.0,2727,75.0,154.0,26164,28871,49581
1371,1371,1371,1371,1371,1371,1371,1371,1372,2021-06-05 15:00:00+00:00,Allegany,13.0,26157,27.0,23464,10.0,2737,23.0,37.0,26201,28894,49621
1372,1372,1372,1372,1372,1372,1372,1372,1373,2021-06-06 15:00:00+00:00,Allegany,10.0,26167,25.0,23489,2.0,2739,12.0,27.0,26228,28906,49656
1373,1373,1373,1373,1373,1373,1373,1373,1374,2021-06-07 15:00:00+00:00,Allegany,20.0,26187,65.0,23554,7.0,2746,27.0,72.0,26300,28933,49741
1374,1374,1374,1374,1374,1374,1374,1374,1375,2021-06-08 15:00:00+00:00,Allegany,128.0,26315,65.0,23619,7.0,2753,135.0,72.0,26372,29068,49934
1375,1375,1375,1375,1375,1375,1375,1375,1376,2021-06-09 15:00:00+00:00,Allegany,39.0,26354,118.0,23737,6.0,2759,45.0,124.0,26496,29113,50091
1376,1376,1376,1376,1376,1376,1376,1376,1377,2021-06-10 15:00:00+00:00,Allegany,35.0,26389,82.0,23819,16.0,2775,51.0,98.0,26594,29164,50208
1377,1377,1377,1377,1377,1377,1377,1377,1378,2021-06-11 15:00:00+00:00,Allegany,41.0,26430,275.0,24094,11.0,2786,52.0,286.0,26880,29216,50524
1378,1378,1378,1378,1378,1378,1378,1378,1379,2021-06-12 15:00:00+00:00,Allegany,13.0,26443,30.0,24124,4.0,2790,17.0,34.0,26914,29233,50567
1379,1379,1379,1379,1379,1379,1379,1379,1380,2021-06-13 15:00:00+00:00,Allegany,6.0,26449,18.0,24142,3.0,2793,9.0,21.0,26935,29242,50591
1380,1380,1380,1380,1380,1380,1380,1380,1381,2021-06-14 15:00:00+00:00,Allegany,30.0,26479,75.0,24217,9.0,2802,39.0,84.0,27019,29281,50696
1381,1381,1381,1381,1381,1381,1381,1381,1382,2021-06-15 15:00:00+00:00,Allegany,30.0,26509,55.0,24272,13.0,2815,43.0,68.0,27087,29324,50781
1382,1382,1382,1382,1382,1382,1382,1382,1383,2021-06-16 15:00:00+00:00,Allegany,45.0,26554,56.0,24328,8.0,2823,53.0,64.0,27151,29377,50882
1383,1383,1383,1383,1383,1383,1383,1383,1384,2021-06-17 15:00:00+00:00,Allegany,35.0,26589,218.0,24546,7.0,2830,42.0,225.0,27376,29419,51135
1384,1384,1384,1384,1384,1384,1384,1384,1385,2021-02-01 15:00:00+00:00,Caroline,17.0,3444,19.0,832,,0,,,832,3444,4276
1385,1385,1385,1385,1385,1385,1385,1385,1386,2021-02-02 15:00:00+00:00,Caroline,143.0,3587,87.0,919,,0,,,919,3587,4506
1386,1386,1386,1386,1386,1386,1386,1386,1387,2021-02-03 15:00:00+00:00,Caroline,106.0,3693,120.0,1039,,0,,,1039,3693,4732
1387,1387,1387,1387,1387,1387,1387,1387,1388,2021-02-04 15:00:00+00:00,Caroline,175.0,3868,135.0,1174,,0,,,1174,3868,5042
1388,1388,1388,1388,1388,1388,1388,1388,1389,2021-02-05 15:00:00+00:00,Caroline,70.0,3938,199.0,1373,,0,,,1373,3938,5311
1389,1389,1389,1389,1389,1389,1389,1389,1390,2021-02-06 15:00:00+00:00,Caroline,9.0,3947,3.0,1376,,0,,,1376,3947,5323
1390,1390,1390,1390,1390,1390,1390,1390,1391,2021-02-07 15:00:00+00:00,Caroline,3.0,3950,43.0,1419,,0,,,1419,3950,5369
1391,1391,1391,1391,1391,1391,1391,1391,1392,2021-02-08 15:00:00+00:00,Caroline,21.0,3971,29.0,1448,,0,,,1448,3971,5419
1392,1392,1392,1392,1392,1392,1392,1392,1393,2021-02-09 15:00:00+00:00,Caroline,27.0,3998,23.0,1471,,0,,,1471,3998,5469
1393,1393,1393,1393,1393,1393,1393,1393,1394,2021-02-10 15:00:00+00:00,Caroline,141.0,4139,132.0,1603,,0,,,1603,4139,5742
1394,1394,1394,1394,1394,1394,1394,1394,1395,2021-02-11 15:00:00+00:00,Caroline,50.0,4189,25.0,1628,,0,,,1628,4189,5817
1395,1395,1395,1395,1395,1395,1395,1395,1396,2021-02-12 15:00:00+00:00,Caroline,36.0,4225,41.0,1669,,0,,,1669,4225,5894
1396,1396,1396,1396,1396,1396,1396,1396,1397,2021-02-13 15:00:00+00:00,Caroline,4.0,4229,6.0,1675,,0,,,1675,4229,5904
1397,1397,1397,1397,1397,1397,1397,1397,1398,2021-02-14 15:00:00+00:00,Caroline,3.0,4232,8.0,1683,,0,,,1683,4232,5915
1398,1398,1398,1398,1398,1398,1398,1398,1399,2021-02-15 15:00:00+00:00,Caroline,7.0,4239,60.0,1743,,0,,,1743,4239,5982
1399,1399,1399,1399,1399,1399,1399,1399,1400,2021-02-16 15:00:00+00:00,Caroline,12.0,4251,41.0,1784,,0,,,1784,4251,6035
1400,1400,1400,1400,1400,1400,1400,1400,1401,2021-02-17 15:00:00+00:00,Caroline,169.0,4420,73.0,1857,,0,,,1857,4420,6277
1401,1401,1401,1401,1401,1401,1401,1401,1402,2021-02-18 15:00:00+00:00,Caroline,17.0,4437,50.0,1907,,0,,,1907,4437,6344
1402,1402,1402,1402,1402,1402,1402,1402,1403,2021-02-19 15:00:00+00:00,Caroline,43.0,4480,512.0,2419,,0,,,2419,4480,6899
1403,1403,1403,1403,1403,1403,1403,1403,1404,2021-02-20 15:00:00+00:00,Caroline,23.0,4503,30.0,2449,,0,,,2449,4503,6952
1404,1404,1404,1404,1404,1404,1404,1404,1405,2021-02-21 15:00:00+00:00,Caroline,6.0,4509,3.0,2452,,0,,,2452,4509,6961
1405,1405,1405,1405,1405,1405,1405,1405,1406,2021-02-22 15:00:00+00:00,Caroline,8.0,4517,32.0,2484,,0,,,2484,4517,7001
1406,1406,1406,1406,1406,1406,1406,1406,1407,2021-02-23 15:00:00+00:00,Caroline,6.0,4523,63.0,2547,,0,,,2547,4523,7070
1407,1407,1407,1407,1407,1407,1407,1407,1408,2021-02-24 15:00:00+00:00,Caroline,106.0,4629,145.0,2692,,0,,,2692,4629,7321
1408,1408,1408,1408,1408,1408,1408,1408,1409,2021-02-25 15:00:00+00:00,Caroline,224.0,4853,216.0,2908,,0,,,2908,4853,7761
1409,1409,1409,1409,1409,1409,1409,1409,1410,2021-02-26 15:00:00+00:00,Caroline,312.0,5165,365.0,3273,,0,,,3273,5165,8438
1410,1410,1410,1410,1410,1410,1410,1410,1411,2021-02-27 15:00:00+00:00,Caroline,7.0,5172,3.0,3276,,0,,,3276,5172,8448
1411,1411,1411,1411,1411,1411,1411,1411,1412,2021-02-28 15:00:00+00:00,Caroline,11.0,5183,1.0,3277,,0,,,3277,5183,8460
1412,1412,1412,1412,1412,1412,1412,1412,1413,2021-06-18 15:00:00+00:00,Allegany,26.0,26615,54.0,24600,7.0,2837,33.0,61.0,27437,29452,51215
1413,1413,1413,1413,1413,1413,1413,1413,1414,2021-06-19 15:00:00+00:00,Allegany,11.0,26626,20.0,24620,6.0,2843,17.0,26.0,27463,29469,51246
1414,1414,1414,1414,1414,1414,1414,1414,1415,2021-06-20 15:00:00+00:00,Allegany,6.0,26632,11.0,24631,1.0,2844,7.0,12.0,27475,29476,51263
1415,1415,1415,1415,1415,1415,1415,1415,1416,2021-06-21 15:00:00+00:00,Allegany,12.0,26644,52.0,24683,6.0,2850,18.0,58.0,27533,29494,51327
1416,1416,1416,1416,1416,1416,1416,1416,1417,2021-06-22 15:00:00+00:00,Allegany,22.0,26666,43.0,24726,4.0,2854,26.0,47.0,27580,29520,51392
1417,1417,1417,1417,1417,1417,1417,1417,1418,2021-06-23 15:00:00+00:00,Allegany,26.0,26692,54.0,24780,5.0,2859,31.0,59.0,27639,29551,51472
1418,1418,1418,1418,1418,1418,1418,1418,1419,2021-06-24 15:00:00+00:00,Allegany,36.0,26728,59.0,24839,11.0,2870,47.0,70.0,27709,29598,51567
1419,1419,1419,1419,1419,1419,1419,1419,1420,2021-06-25 15:00:00+00:00,Allegany,31.0,26759,36.0,24875,6.0,2876,37.0,42.0,27751,29635,51634
1420,1420,1420,1420,1420,1420,1420,1420,1421,2021-06-26 15:00:00+00:00,Allegany,10.0,26769,16.0,24891,10.0,2886,20.0,26.0,27777,29655,51660
1421,1421,1421,1421,1421,1421,1421,1421,1422,2021-06-27 15:00:00+00:00,Allegany,7.0,26776,13.0,24904,1.0,2887,8.0,14.0,27791,29663,51680
1422,1422,1422,1422,1422,1422,1422,1422,1423,2021-06-28 15:00:00+00:00,Allegany,19.0,26795,16.0,24920,3.0,2890,22.0,19.0,27810,29685,51715
1423,1423,1423,1423,1423,1423,1423,1423,1424,2021-06-29 15:00:00+00:00,Allegany,24.0,26819,105.0,25025,14.0,2904,38.0,119.0,27929,29723,51844
1424,1424,1424,1424,1424,1424,1424,1424,1425,2021-06-30 15:00:00+00:00,Allegany,38.0,26857,28.0,25053,6.0,2910,44.0,34.0,27963,29767,51910
1425,1425,1425,1425,1425,1425,1425,1425,1426,2021-07-01 15:00:00+00:00,Allegany,26.0,26883,26.0,25079,12.0,2922,38.0,38.0,28001,29805,51962
1426,1426,1426,1426,1426,1426,1426,1426,1427,2021-07-02 15:00:00+00:00,Allegany,21.0,26904,39.0,25118,4.0,2926,25.0,43.0,28044,29830,52022
1427,1427,1427,1427,1427,1427,1427,1427,1428,2021-07-03 15:00:00+00:00,Allegany,7.0,26911,12.0,25130,3.0,2929,10.0,15.0,28059,29840,52041
1428,1428,1428,1428,1428,1428,1428,1428,1429,2021-07-04 15:00:00+00:00,Allegany,1.0,26912,2.0,25132,,2929,,,28061,29841,52044
1429,1429,1429,1429,1429,1429,1429,1429,1430,2021-07-05 15:00:00+00:00,Allegany,7.0,26919,35.0,25167,10.0,2939,17.0,45.0,28106,29858,52086
1430,1430,1430,1430,1430,1430,1430,1430,1431,2021-07-06 15:00:00+00:00,Allegany,13.0,26932,12.0,25179,9.0,2948,22.0,21.0,28127,29880,52111
1431,1431,1431,1431,1431,1431,1431,1431,1432,2021-07-07 15:00:00+00:00,Allegany,14.0,26946,40.0,25219,9.0,2957,23.0,49.0,28176,29903,52165
1432,1432,1432,1432,1432,1432,1432,1432,1433,2021-07-08 15:00:00+00:00,Allegany,16.0,26962,25.0,25244,3.0,2960,19.0,28.0,28204,29922,52206
1433,1433,1433,1433,1433,1433,1433,1433,1434,2021-07-09 15:00:00+00:00,Allegany,44.0,27006,33.0,25277,7.0,2967,51.0,40.0,28244,29973,52283
1434,1434,1434,1434,1434,1434,1434,1434,1435,2021-07-10 15:00:00+00:00,Allegany,12.0,27018,4.0,25281,1.0,2968,13.0,5.0,28249,29986,52299
1435,1435,1435,1435,1435,1435,1435,1435,1436,2021-07-11 15:00:00+00:00,Allegany,8.0,27026,5.0,25286,2.0,2970,10.0,7.0,28256,29996,52312
1436,1436,1436,1436,1436,1436,1436,1436,1437,2021-07-12 15:00:00+00:00,Allegany,22.0,27048,30.0,25316,2.0,2972,24.0,32.0,28288,30020,52364
1437,1437,1437,1437,1437,1437,1437,1437,1438,2021-07-13 15:00:00+00:00,Allegany,28.0,27076,29.0,25345,3.0,2975,31.0,32.0,28320,30051,52421
1438,1438,1438,1438,1438,1438,1438,1438,1439,2021-07-14 15:00:00+00:00,Allegany,32.0,27108,15.0,25360,8.0,2983,40.0,23.0,28343,30091,52468
1439,1439,1439,1439,1439,1439,1439,1439,1440,2021-07-15 15:00:00+00:00,Allegany,28.0,27136,32.0,25392,,2983,,,28375,30119,52528
1440,1440,1440,1440,1440,1440,1440,1440,1441,2021-03-01 15:00:00+00:00,Caroline,23.0,5206,21.0,3298,,0,,,3298,5206,8504
1441,1441,1441,1441,1441,1441,1441,1441,1442,2021-03-02 15:00:00+00:00,Caroline,42.0,5248,23.0,3321,,0,,,3321,5248,8569
1442,1442,1442,1442,1442,1442,1442,1442,1443,2021-03-03 15:00:00+00:00,Caroline,93.0,5341,116.0,3437,,0,,,3437,5341,8778
1443,1443,1443,1443,1443,1443,1443,1443,1444,2021-03-04 15:00:00+00:00,Caroline,271.0,5612,209.0,3646,5.0,5,276.0,214.0,3651,5617,9258
1444,1444,1444,1444,1444,1444,1444,1444,1445,2021-03-05 15:00:00+00:00,Caroline,482.0,6094,105.0,3751,3.0,8,485.0,108.0,3759,6102,9845
1445,1445,1445,1445,1445,1445,1445,1445,1446,2021-03-06 15:00:00+00:00,Caroline,18.0,6112,8.0,3759,91.0,99,109.0,99.0,3858,6211,9871
1446,1446,1446,1446,1446,1446,1446,1446,1447,2021-03-07 15:00:00+00:00,Caroline,19.0,6131,5.0,3764,17.0,116,36.0,22.0,3880,6247,9895
1447,1447,1447,1447,1447,1447,1447,1447,1448,2021-03-08 15:00:00+00:00,Caroline,35.0,6166,33.0,3797,11.0,127,46.0,44.0,3924,6293,9963
1448,1448,1448,1448,1448,1448,1448,1448,1449,2021-03-09 15:00:00+00:00,Caroline,44.0,6210,12.0,3809,2.0,129,46.0,14.0,3938,6339,10019
1449,1449,1449,1449,1449,1449,1449,1449,1450,2021-03-10 15:00:00+00:00,Caroline,45.0,6255,166.0,3975,4.0,133,49.0,170.0,4108,6388,10230
1450,1450,1450,1450,1450,1450,1450,1450,1451,2021-03-11 15:00:00+00:00,Caroline,249.0,6504,76.0,4051,2.0,135,251.0,78.0,4186,6639,10555
1451,1451,1451,1451,1451,1451,1451,1451,1452,2021-03-12 15:00:00+00:00,Caroline,296.0,6800,17.0,4068,175.0,310,471.0,192.0,4378,7110,10868
1452,1452,1452,1452,1452,1452,1452,1452,1453,2021-03-13 15:00:00+00:00,Caroline,14.0,6814,20.0,4088,24.0,334,38.0,44.0,4422,7148,10902
1453,1453,1453,1453,1453,1453,1453,1453,1454,2021-03-14 15:00:00+00:00,Caroline,16.0,6830,3.0,4091,74.0,408,90.0,77.0,4499,7238,10921
1454,1454,1454,1454,1454,1454,1454,1454,1455,2021-03-15 15:00:00+00:00,Caroline,38.0,6868,24.0,4115,2.0,410,40.0,26.0,4525,7278,10983
1455,1455,1455,1455,1455,1455,1455,1455,1456,2021-03-16 15:00:00+00:00,Caroline,61.0,6929,26.0,4141,,410,,,4551,7339,11070
1456,1456,1456,1456,1456,1456,1456,1456,1457,2021-03-17 15:00:00+00:00,Caroline,104.0,7033,160.0,4301,1.0,411,105.0,161.0,4712,7444,11334
1457,1457,1457,1457,1457,1457,1457,1457,1458,2021-03-18 15:00:00+00:00,Caroline,193.0,7226,39.0,4340,40.0,451,233.0,79.0,4791,7677,11566
1458,1458,1458,1458,1458,1458,1458,1458,1459,2021-03-19 15:00:00+00:00,Caroline,244.0,7470,40.0,4380,30.0,481,274.0,70.0,4861,7951,11850
1459,1459,1459,1459,1459,1459,1459,1459,1460,2021-03-20 15:00:00+00:00,Caroline,41.0,7511,5.0,4385,3.0,484,44.0,8.0,4869,7995,11896
1460,1460,1460,1460,1460,1460,1460,1460,1461,2021-03-21 15:00:00+00:00,Caroline,27.0,7538,4.0,4389,3.0,487,30.0,7.0,4876,8025,11927
1461,1461,1461,1461,1461,1461,1461,1461,1462,2021-03-22 15:00:00+00:00,Caroline,38.0,7576,12.0,4401,19.0,506,57.0,31.0,4907,8082,11977
1462,1462,1462,1462,1462,1462,1462,1462,1463,2021-03-23 15:00:00+00:00,Caroline,61.0,7637,12.0,4413,35.0,541,96.0,47.0,4954,8178,12050
1463,1463,1463,1463,1463,1463,1463,1463,1464,2021-03-24 15:00:00+00:00,Caroline,106.0,7743,178.0,4591,3.0,544,109.0,181.0,5135,8287,12334
1464,1464,1464,1464,1464,1464,1464,1464,1465,2021-03-25 15:00:00+00:00,Caroline,420.0,8163,158.0,4749,3.0,547,423.0,161.0,5296,8710,12912
1465,1465,1465,1465,1465,1465,1465,1465,1466,2021-03-26 15:00:00+00:00,Caroline,67.0,8230,299.0,5048,5.0,552,72.0,304.0,5600,8782,13278
1466,1466,1466,1466,1466,1466,1466,1466,1467,2021-03-27 15:00:00+00:00,Caroline,33.0,8263,8.0,5056,10.0,562,43.0,18.0,5618,8825,13319
1467,1467,1467,1467,1467,1467,1467,1467,1468,2021-03-28 15:00:00+00:00,Caroline,37.0,8300,10.0,5066,4.0,566,41.0,14.0,5632,8866,13366
1468,1468,1468,1468,1468,1468,1468,1468,1469,2021-03-29 15:00:00+00:00,Caroline,76.0,8376,22.0,5088,21.0,587,97.0,43.0,5675,8963,13464
1469,1469,1469,1469,1469,1469,1469,1469,1470,2021-03-30 15:00:00+00:00,Caroline,82.0,8458,37.0,5125,41.0,628,123.0,78.0,5753,9086,13583
1470,1470,1470,1470,1470,1470,1470,1470,1471,2021-03-31 15:00:00+00:00,Caroline,90.0,8548,108.0,5233,50.0,678,140.0,158.0,5911,9226,13781
1471,1471,1471,1471,1471,1471,1471,1471,1472,2021-04-01 15:00:00+00:00,Caroline,204.0,8752,263.0,5496,51.0,729,255.0,314.0,6225,9481,14248
1472,1472,1472,1472,1472,1472,1472,1472,1473,2021-04-02 15:00:00+00:00,Caroline,105.0,8857,474.0,5970,54.0,783,159.0,528.0,6753,9640,14827
1473,1473,1473,1473,1473,1473,1473,1473,1474,2021-04-03 15:00:00+00:00,Caroline,45.0,8902,25.0,5995,66.0,849,111.0,91.0,6844,9751,14897
1474,1474,1474,1474,1474,1474,1474,1474,1475,2021-04-04 15:00:00+00:00,Caroline,15.0,8917,13.0,6008,42.0,891,57.0,55.0,6899,9808,14925
1475,1475,1475,1475,1475,1475,1475,1475,1476,2021-04-05 15:00:00+00:00,Caroline,43.0,8960,27.0,6035,185.0,1076,228.0,212.0,7111,10036,14995
1476,1476,1476,1476,1476,1476,1476,1476,1477,2021-04-06 15:00:00+00:00,Caroline,56.0,9016,34.0,6069,188.0,1264,244.0,222.0,7333,10280,15085
1477,1477,1477,1477,1477,1477,1477,1477,1478,2021-04-07 15:00:00+00:00,Caroline,44.0,9060,31.0,6100,186.0,1450,230.0,217.0,7550,10510,15160
1478,1478,1478,1478,1478,1478,1478,1478,1479,2021-04-08 15:00:00+00:00,Caroline,62.0,9122,252.0,6352,594.0,2044,656.0,846.0,8396,11166,15474
1479,1479,1479,1479,1479,1479,1479,1479,1480,2021-04-09 15:00:00+00:00,Caroline,125.0,9247,319.0,6671,145.0,2189,270.0,464.0,8860,11436,15918
1480,1480,1480,1480,1480,1480,1480,1480,1481,2021-04-10 15:00:00+00:00,Caroline,38.0,9285,22.0,6693,100.0,2289,138.0,122.0,8982,11574,15978
1481,1481,1481,1481,1481,1481,1481,1481,1482,2021-04-11 15:00:00+00:00,Caroline,12.0,9297,24.0,6717,79.0,2368,91.0,103.0,9085,11665,16014
1482,1482,1482,1482,1482,1482,1482,1482,1483,2021-04-12 15:00:00+00:00,Caroline,27.0,9324,61.0,6778,24.0,2392,51.0,85.0,9170,11716,16102
1483,1483,1483,1483,1483,1483,1483,1483,1484,2021-04-13 15:00:00+00:00,Caroline,38.0,9362,68.0,6846,,2392,,,9238,11754,16208
1484,1484,1484,1484,1484,1484,1484,1484,1485,2021-04-14 15:00:00+00:00,Caroline,206.0,9568,117.0,6963,,2392,,,9355,11960,16531
1485,1485,1485,1485,1485,1485,1485,1485,1486,2021-04-15 15:00:00+00:00,Caroline,68.0,9636,201.0,7164,,2392,,,9556,12028,16800
1486,1486,1486,1486,1486,1486,1486,1486,1487,2021-04-16 15:00:00+00:00,Caroline,111.0,9747,232.0,7396,,2392,,,9788,12139,17143
1487,1487,1487,1487,1487,1487,1487,1487,1488,2021-04-17 15:00:00+00:00,Caroline,22.0,9769,26.0,7422,,2392,,,9814,12161,17191
1488,1488,1488,1488,1488,1488,1488,1488,1489,2021-04-18 15:00:00+00:00,Caroline,18.0,9787,18.0,7440,,2392,,,9832,12179,17227
1489,1489,1489,1489,1489,1489,1489,1489,1490,2021-04-19 15:00:00+00:00,Caroline,28.0,9815,51.0,7491,,2392,,,9883,12207,17306
1490,1490,1490,1490,1490,1490,1490,1490,1491,2021-04-20 15:00:00+00:00,Caroline,47.0,9862,86.0,7577,,2392,,,9969,12254,17439
1491,1491,1491,1491,1491,1491,1491,1491,1492,2021-04-21 15:00:00+00:00,Caroline,147.0,10009,117.0,7694,,2392,,,10086,12401,17703
1492,1492,1492,1492,1492,1492,1492,1492,1493,2021-04-22 15:00:00+00:00,Caroline,112.0,10121,428.0,8122,,2392,,,10514,12513,18243
1493,1493,1493,1493,1493,1493,1493,1493,1494,2021-04-23 15:00:00+00:00,Caroline,109.0,10230,78.0,8200,,2392,,,10592,12622,18430
1494,1494,1494,1494,1494,1494,1494,1494,1495,2021-04-24 15:00:00+00:00,Caroline,83.0,10313,47.0,8247,,2392,,,10639,12705,18560
1495,1495,1495,1495,1495,1495,1495,1495,1496,2021-04-25 15:00:00+00:00,Caroline,11.0,10324,10.0,8257,,2392,,,10649,12716,18581
1496,1496,1496,1496,1496,1496,1496,1496,1497,2021-07-16 15:00:00+00:00,Allegany,36.0,27172,23.0,25415,4.0,2987,40.0,27.0,28402,30159,52587
1497,1497,1497,1497,1497,1497,1497,1497,1498,2021-07-17 15:00:00+00:00,Allegany,17.0,27189,12.0,25427,,2987,,,28414,30176,52616
1498,1498,1498,1498,1498,1498,1498,1498,1499,2021-07-18 15:00:00+00:00,Allegany,7.0,27196,8.0,25435,,2987,,,28422,30183,52631
1499,1499,1499,1499,1499,1499,1499,1499,1500,2021-07-19 15:00:00+00:00,Allegany,27.0,27223,22.0,25457,2.0,2989,29.0,24.0,28446,30212,52680
1500,1500,1500,1500,1500,1500,1500,1500,1501,2021-07-20 15:00:00+00:00,Allegany,27.0,27250,18.0,25475,,2989,,,28464,30239,52725
1501,1501,1501,1501,1501,1501,1501,1501,1502,2021-07-21 15:00:00+00:00,Allegany,91.0,27341,35.0,25510,17.0,3006,108.0,52.0,28516,30347,52851
1502,1502,1502,1502,1502,1502,1502,1502,1503,2021-07-22 15:00:00+00:00,Allegany,31.0,27372,31.0,25541,1.0,3007,32.0,32.0,28548,30379,52913
1503,1503,1503,1503,1503,1503,1503,1503,1504,2021-07-23 15:00:00+00:00,Allegany,39.0,27411,20.0,25561,5.0,3012,44.0,25.0,28573,30423,52972
1504,1504,1504,1504,1504,1504,1504,1504,1505,2021-07-24 15:00:00+00:00,Allegany,17.0,27428,10.0,25571,,3012,,,28583,30440,52999
1505,1505,1505,1505,1505,1505,1505,1505,1506,2021-07-25 15:00:00+00:00,Allegany,7.0,27435,3.0,25574,,3012,,,28586,30447,53009
1506,1506,1506,1506,1506,1506,1506,1506,1507,2021-07-26 15:00:00+00:00,Allegany,28.0,27463,12.0,25586,1.0,3013,29.0,13.0,28599,30476,53049
1507,1507,1507,1507,1507,1507,1507,1507,1508,2021-07-27 15:00:00+00:00,Allegany,51.0,27514,20.0,25606,8.0,3021,59.0,28.0,28627,30535,53120
1508,1508,1508,1508,1508,1508,1508,1508,1509,2021-07-28 15:00:00+00:00,Allegany,100.0,27614,28.0,25634,10.0,3031,110.0,38.0,28665,30645,53248
1509,1509,1509,1509,1509,1509,1509,1509,1510,2021-07-29 15:00:00+00:00,Allegany,43.0,27657,20.0,25654,6.0,3037,49.0,26.0,28691,30694,53311
1510,1510,1510,1510,1510,1510,1510,1510,1511,2021-07-30 15:00:00+00:00,Allegany,37.0,27694,28.0,25682,5.0,3042,42.0,33.0,28724,30736,53376
1511,1511,1511,1511,1511,1511,1511,1511,1512,2021-07-31 15:00:00+00:00,Allegany,28.0,27722,7.0,25689,2.0,3044,30.0,9.0,28733,30766,53411
1512,1512,1512,1512,1512,1512,1512,1512,1513,2021-08-01 15:00:00+00:00,Allegany,13.0,27735,6.0,25695,1.0,3045,14.0,7.0,28740,30780,53430
1513,1513,1513,1513,1513,1513,1513,1513,1514,2021-08-02 15:00:00+00:00,Allegany,32.0,27767,14.0,25709,1.0,3046,33.0,15.0,28755,30813,53476
1514,1514,1514,1514,1514,1514,1514,1514,1515,2021-08-03 15:00:00+00:00,Allegany,49.0,27816,22.0,25731,2.0,3048,51.0,24.0,28779,30864,53547
1515,1515,1515,1515,1515,1515,1515,1515,1516,2021-08-04 15:00:00+00:00,Allegany,63.0,27879,21.0,25752,25.0,3073,88.0,46.0,28825,30952,53631
1516,1516,1516,1516,1516,1516,1516,1516,1517,2021-08-05 15:00:00+00:00,Allegany,56.0,27935,22.0,25774,7.0,3080,63.0,29.0,28854,31015,53709
1517,1517,1517,1517,1517,1517,1517,1517,1518,2021-08-06 15:00:00+00:00,Allegany,52.0,27987,37.0,25811,3.0,3083,55.0,40.0,28894,31070,53798
1518,1518,1518,1518,1518,1518,1518,1518,1519,2021-08-07 15:00:00+00:00,Allegany,20.0,28007,17.0,25828,1.0,3084,21.0,18.0,28912,31091,53835
1519,1519,1519,1519,1519,1519,1519,1519,1520,2021-08-08 15:00:00+00:00,Allegany,15.0,28022,4.0,25832,1.0,3085,16.0,5.0,28917,31107,53854
1520,1520,1520,1520,1520,1520,1520,1520,1521,2021-08-09 15:00:00+00:00,Allegany,54.0,28076,23.0,25855,5.0,3090,59.0,28.0,28945,31166,53931
1521,1521,1521,1521,1521,1521,1521,1521,1522,2021-08-10 15:00:00+00:00,Allegany,37.0,28113,21.0,25876,2.0,3092,39.0,23.0,28968,31205,53989
1522,1522,1522,1522,1522,1522,1522,1522,1523,2021-08-11 15:00:00+00:00,Allegany,84.0,28197,64.0,25940,20.0,3112,104.0,84.0,29052,31309,54137
1523,1523,1523,1523,1523,1523,1523,1523,1524,2021-08-12 15:00:00+00:00,Allegany,43.0,28240,30.0,25970,2.0,3114,45.0,32.0,29084,31354,54210
1524,1524,1524,1524,1524,1524,1524,1524,1525,2021-08-13 15:00:00+00:00,Allegany,89.0,28329,26.0,25996,3.0,3117,92.0,29.0,29113,31446,54325
1525,1525,1525,1525,1525,1525,1525,1525,1526,2021-08-14 15:00:00+00:00,Allegany,40.0,28369,15.0,26011,2.0,3119,42.0,17.0,29130,31488,54380
1526,1526,1526,1526,1526,1526,1526,1526,1527,2021-08-15 15:00:00+00:00,Allegany,25.0,28394,10.0,26021,1.0,3120,26.0,11.0,29141,31514,54415
1527,1527,1527,1527,1527,1527,1527,1527,1528,2021-08-16 15:00:00+00:00,Allegany,58.0,28452,24.0,26045,2.0,3122,60.0,26.0,29167,31574,54497
1528,1528,1528,1528,1528,1528,1528,1528,1529,2021-08-17 15:00:00+00:00,Allegany,42.0,28494,23.0,26068,2.0,3124,44.0,25.0,29192,31618,54562
1529,1529,1529,1529,1529,1529,1529,1529,1530,2021-08-18 15:00:00+00:00,Allegany,140.0,28634,76.0,26144,32.0,3156,172.0,108.0,29300,31790,54778
1530,1530,1530,1530,1530,1530,1530,1530,1531,2021-08-19 15:00:00+00:00,Allegany,69.0,28703,29.0,26173,8.0,3164,77.0,37.0,29337,31867,54876
1531,1531,1531,1531,1531,1531,1531,1531,1532,2021-08-20 15:00:00+00:00,Allegany,79.0,28782,40.0,26213,17.0,3181,96.0,57.0,29394,31963,54995
1532,1532,1532,1532,1532,1532,1532,1532,1533,2021-08-21 15:00:00+00:00,Allegany,27.0,28809,21.0,26234,1.0,3182,28.0,22.0,29416,31991,55043
1533,1533,1533,1533,1533,1533,1533,1533,1534,2021-08-22 15:00:00+00:00,Allegany,25.0,28834,9.0,26243,1.0,3183,26.0,10.0,29426,32017,55077
1534,1534,1534,1534,1534,1534,1534,1534,1535,2021-08-23 15:00:00+00:00,Allegany,60.0,28894,23.0,26266,7.0,3190,67.0,30.0,29456,32084,55160
1535,1535,1535,1535,1535,1535,1535,1535,1536,2021-08-24 15:00:00+00:00,Allegany,57.0,28951,28.0,26294,5.0,3195,62.0,33.0,29489,32146,55245
1536,1536,1536,1536,1536,1536,1536,1536,1537,2021-08-25 15:00:00+00:00,Allegany,160.0,29111,87.0,26381,35.0,3230,195.0,122.0,29611,32341,55492
1537,1537,1537,1537,1537,1537,1537,1537,1538,2021-08-26 15:00:00+00:00,Allegany,135.0,29246,46.0,26427,6.0,3236,141.0,52.0,29663,32482,55673
1538,1538,1538,1538,1538,1538,1538,1538,1539,2021-08-27 15:00:00+00:00,Allegany,131.0,29377,44.0,26471,4.0,3240,135.0,48.0,29711,32617,55848
1539,1539,1539,1539,1539,1539,1539,1539,1540,2021-08-28 15:00:00+00:00,Allegany,33.0,29410,26.0,26497,3.0,3243,36.0,29.0,29740,32653,55907
1540,1540,1540,1540,1540,1540,1540,1540,1541,2021-08-29 15:00:00+00:00,Allegany,20.0,29430,18.0,26515,,3243,,,29758,32673,55945
1541,1541,1541,1541,1541,1541,1541,1541,1542,2021-08-30 15:00:00+00:00,Allegany,57.0,29487,41.0,26556,4.0,3247,61.0,45.0,29803,32734,56043
1542,1542,1542,1542,1542,1542,1542,1542,1543,2021-08-31 15:00:00+00:00,Allegany,62.0,29549,42.0,26598,5.0,3252,67.0,47.0,29850,32801,56147
1543,1543,1543,1543,1543,1543,1543,1543,1544,2021-09-01 15:00:00+00:00,Allegany,71.0,29620,44.0,26642,19.0,3271,90.0,63.0,29913,32891,56262
1544,1544,1544,1544,1544,1544,1544,1544,1545,2021-09-02 15:00:00+00:00,Allegany,45.0,29665,48.0,26690,1.0,3272,46.0,49.0,29962,32937,56355
1545,1545,1545,1545,1545,1545,1545,1545,1546,2021-09-03 15:00:00+00:00,Allegany,66.0,29731,44.0,26734,3.0,3275,69.0,47.0,30009,33006,56465
1546,1546,1546,1546,1546,1546,1546,1546,1547,2021-09-04 15:00:00+00:00,Allegany,19.0,29750,40.0,26774,1.0,3276,20.0,41.0,30050,33026,56524
1547,1547,1547,1547,1547,1547,1547,1547,1548,2021-09-05 15:00:00+00:00,Allegany,9.0,29759,20.0,26794,1.0,3277,10.0,21.0,30071,33036,56553
1548,1548,1548,1548,1548,1548,1548,1548,1549,2021-09-06 15:00:00+00:00,Allegany,5.0,29764,10.0,26804,,3277,,,30081,33041,56568
1549,1549,1549,1549,1549,1549,1549,1549,1550,2021-09-07 15:00:00+00:00,Allegany,32.0,29796,54.0,26858,4.0,3281,36.0,58.0,30139,33077,56654
1550,1550,1550,1550,1550,1550,1550,1550,1551,2021-09-08 15:00:00+00:00,Allegany,57.0,29853,90.0,26948,11.0,3292,68.0,101.0,30240,33145,56801
1551,1551,1551,1551,1551,1551,1551,1551,1552,2021-09-09 15:00:00+00:00,Allegany,44.0,29897,46.0,26994,5.0,3297,49.0,51.0,30291,33194,56891
1552,1552,1552,1552,1552,1552,1552,1552,1553,2021-04-26 15:00:00+00:00,Caroline,18.0,10342,71.0,8328,1.0,2393,19.0,72.0,10721,12735,18670
1553,1553,1553,1553,1553,1553,1553,1553,1554,2021-04-27 15:00:00+00:00,Caroline,31.0,10373,60.0,8388,8.0,2401,39.0,68.0,10789,12774,18761
1554,1554,1554,1554,1554,1554,1554,1554,1555,2021-04-28 15:00:00+00:00,Caroline,122.0,10495,88.0,8476,9.0,2410,131.0,97.0,10886,12905,18971
1555,1555,1555,1555,1555,1555,1555,1555,1556,2021-04-29 15:00:00+00:00,Caroline,62.0,10557,180.0,8656,14.0,2424,76.0,194.0,11080,12981,19213
1556,1556,1556,1556,1556,1556,1556,1556,1557,2021-04-30 15:00:00+00:00,Caroline,169.0,10726,56.0,8712,19.0,2443,188.0,75.0,11155,13169,19438
1557,1557,1557,1557,1557,1557,1557,1557,1558,2021-05-01 15:00:00+00:00,Caroline,21.0,10747,39.0,8751,,2443,,,11194,13190,19498
1558,1558,1558,1558,1558,1558,1558,1558,1559,2021-05-02 15:00:00+00:00,Caroline,10.0,10757,14.0,8765,,2443,,,11208,13200,19522
1559,1559,1559,1559,1559,1559,1559,1559,1560,2021-05-03 15:00:00+00:00,Caroline,9.0,10766,35.0,8800,6.0,2449,15.0,41.0,11249,13215,19566
1560,1560,1560,1560,1560,1560,1560,1560,1561,2021-05-04 15:00:00+00:00,Caroline,27.0,10793,37.0,8837,16.0,2465,43.0,53.0,11302,13258,19630
1561,1561,1561,1561,1561,1561,1561,1561,1562,2021-05-05 15:00:00+00:00,Caroline,67.0,10860,33.0,8870,3.0,2468,70.0,36.0,11338,13328,19730
1562,1562,1562,1562,1562,1562,1562,1562,1563,2021-05-06 15:00:00+00:00,Caroline,42.0,10902,134.0,9004,13.0,2481,55.0,147.0,11485,13383,19906
1563,1563,1563,1563,1563,1563,1563,1563,1564,2021-05-07 15:00:00+00:00,Caroline,23.0,10925,45.0,9049,17.0,2498,40.0,62.0,11547,13423,19974
1564,1564,1564,1564,1564,1564,1564,1564,1565,2021-05-08 15:00:00+00:00,Caroline,7.0,10932,19.0,9068,3.0,2501,10.0,22.0,11569,13433,20000
1565,1565,1565,1565,1565,1565,1565,1565,1566,2021-05-09 15:00:00+00:00,Caroline,2.0,10934,6.0,9074,1.0,2502,3.0,7.0,11576,13436,20008
1566,1566,1566,1566,1566,1566,1566,1566,1567,2021-05-10 15:00:00+00:00,Caroline,14.0,10948,27.0,9101,3.0,2505,17.0,30.0,11606,13453,20049
1567,1567,1567,1567,1567,1567,1567,1567,1568,2021-05-11 15:00:00+00:00,Caroline,17.0,10965,41.0,9142,4.0,2509,21.0,45.0,11651,13474,20107
1568,1568,1568,1568,1568,1568,1568,1568,1569,2021-05-12 15:00:00+00:00,Caroline,37.0,11002,69.0,9211,6.0,2515,43.0,75.0,11726,13517,20213
1569,1569,1569,1569,1569,1569,1569,1569,1570,2021-05-13 15:00:00+00:00,Caroline,63.0,11065,179.0,9390,9.0,2524,72.0,188.0,11914,13589,20455
1570,1570,1570,1570,1570,1570,1570,1570,1571,2021-05-14 15:00:00+00:00,Caroline,41.0,11106,118.0,9508,29.0,2553,70.0,147.0,12061,13659,20614
1571,1571,1571,1571,1571,1571,1571,1571,1572,2021-05-15 15:00:00+00:00,Caroline,28.0,11134,21.0,9529,1.0,2554,29.0,22.0,12083,13688,20663
1572,1572,1572,1572,1572,1572,1572,1572,1573,2021-05-16 15:00:00+00:00,Caroline,20.0,11154,12.0,9541,7.0,2561,27.0,19.0,12102,13715,20695
1573,1573,1573,1573,1573,1573,1573,1573,1574,2021-05-17 15:00:00+00:00,Caroline,28.0,11182,18.0,9559,,2561,,,12120,13743,20741
1574,1574,1574,1574,1574,1574,1574,1574,1575,2021-05-18 15:00:00+00:00,Caroline,64.0,11246,51.0,9610,1.0,2562,65.0,52.0,12172,13808,20856
1575,1575,1575,1575,1575,1575,1575,1575,1576,2021-05-19 15:00:00+00:00,Caroline,101.0,11347,112.0,9722,19.0,2581,120.0,131.0,12303,13928,21069
1576,1576,1576,1576,1576,1576,1576,1576,1577,2021-05-20 15:00:00+00:00,Caroline,64.0,11411,144.0,9866,9.0,2590,73.0,153.0,12456,14001,21277
1577,1577,1577,1577,1577,1577,1577,1577,1578,2021-05-21 15:00:00+00:00,Caroline,42.0,11453,149.0,10015,21.0,2611,63.0,170.0,12626,14064,21468
1578,1578,1578,1578,1578,1578,1578,1578,1579,2021-05-22 15:00:00+00:00,Caroline,57.0,11510,75.0,10090,2.0,2613,59.0,77.0,12703,14123,21600
1579,1579,1579,1579,1579,1579,1579,1579,1580,2021-05-23 15:00:00+00:00,Caroline,26.0,11536,9.0,10099,,2613,,,12712,14149,21635
1580,1580,1580,1580,1580,1580,1580,1580,1581,2021-09-10 15:00:00+00:00,Allegany,68.0,29965,87.0,27081,6.0,3303,74.0,93.0,30384,33268,57046
1581,1581,1581,1581,1581,1581,1581,1581,1582,2021-09-11 15:00:00+00:00,Allegany,14.0,29979,35.0,27116,2.0,3305,16.0,37.0,30421,33284,57095
1582,1582,1582,1582,1582,1582,1582,1582,1583,2021-09-12 15:00:00+00:00,Allegany,19.0,29998,23.0,27139,2.0,3307,21.0,25.0,30446,33305,57137
1583,1583,1583,1583,1583,1583,1583,1583,1584,2021-09-13 15:00:00+00:00,Allegany,39.0,30037,45.0,27184,6.0,3313,45.0,51.0,30497,33350,57221
1584,1584,1584,1584,1584,1584,1584,1584,1585,2021-09-14 15:00:00+00:00,Allegany,43.0,30080,47.0,27231,4.0,3317,47.0,51.0,30548,33397,57311
1585,1585,1585,1585,1585,1585,1585,1585,1586,2021-09-15 15:00:00+00:00,Allegany,85.0,30165,125.0,27356,18.0,3335,103.0,143.0,30691,33500,57521
1586,1586,1586,1586,1586,1586,1586,1586,1587,2021-09-16 15:00:00+00:00,Allegany,54.0,30219,53.0,27409,2.0,3337,56.0,55.0,30746,33556,57628
1587,1587,1587,1587,1587,1587,1587,1587,1588,2021-09-17 15:00:00+00:00,Allegany,88.0,30307,194.0,27603,8.0,3345,96.0,202.0,30948,33652,57910
1588,1588,1588,1588,1588,1588,1588,1588,1589,2021-09-18 15:00:00+00:00,Allegany,31.0,30338,20.0,27623,4.0,3349,35.0,24.0,30972,33687,57961
1589,1589,1589,1589,1589,1589,1589,1589,1590,2021-09-19 15:00:00+00:00,Allegany,4.0,30342,15.0,27638,2.0,3351,6.0,17.0,30989,33693,57980
1590,1590,1590,1590,1590,1590,1590,1590,1591,2021-09-20 15:00:00+00:00,Allegany,43.0,30385,51.0,27689,,3351,,,31040,33736,58074
1591,1591,1591,1591,1591,1591,1591,1591,1592,2021-09-21 15:00:00+00:00,Allegany,31.0,30416,49.0,27738,2.0,3353,33.0,51.0,31091,33769,58154
1592,1592,1592,1592,1592,1592,1592,1592,1593,2021-09-22 15:00:00+00:00,Allegany,109.0,30525,101.0,27839,25.0,3378,134.0,126.0,31217,33903,58364
1593,1593,1593,1593,1593,1593,1593,1593,1594,2021-09-23 15:00:00+00:00,Allegany,29.0,30554,29.0,27868,1.0,3379,30.0,30.0,31247,33933,58422
1594,1594,1594,1594,1594,1594,1594,1594,1595,2021-09-24 15:00:00+00:00,Allegany,66.0,30620,88.0,27956,6.0,3385,72.0,94.0,31341,34005,58576
1595,1595,1595,1595,1595,1595,1595,1595,1596,2021-09-25 15:00:00+00:00,Allegany,34.0,30654,22.0,27978,1.0,3386,35.0,23.0,31364,34040,58632
1596,1596,1596,1596,1596,1596,1596,1596,1597,2021-09-26 15:00:00+00:00,Allegany,7.0,30661,12.0,27990,2.0,3388,9.0,14.0,31378,34049,58651
1597,1597,1597,1597,1597,1597,1597,1597,1598,2021-09-27 15:00:00+00:00,Allegany,27.0,30688,36.0,28026,2.0,3390,29.0,38.0,31416,34078,58714
1598,1598,1598,1598,1598,1598,1598,1598,1599,2021-09-28 15:00:00+00:00,Allegany,39.0,30727,47.0,28073,,3390,,,31463,34117,58800
1599,1599,1599,1599,1599,1599,1599,1599,1600,2021-09-29 15:00:00+00:00,Allegany,57.0,30784,70.0,28143,9.0,3399,66.0,79.0,31542,34183,58927
1600,1600,1600,1600,1600,1600,1600,1600,1601,2021-09-30 15:00:00+00:00,Allegany,42.0,30826,40.0,28183,4.0,3403,46.0,44.0,31586,34229,59009
1601,1601,1601,1601,1601,1601,1601,1601,1602,2021-10-01 15:00:00+00:00,Allegany,37.0,30863,61.0,28244,,3403,,,31647,34266,59107
1602,1602,1602,1602,1602,1602,1602,1602,1603,2021-10-02 15:00:00+00:00,Allegany,11.0,30874,15.0,28259,1.0,3404,12.0,16.0,31663,34278,59133
1603,1603,1603,1603,1603,1603,1603,1603,1604,2021-10-03 15:00:00+00:00,Allegany,12.0,30886,13.0,28272,,3404,,,31676,34290,59158
1604,1604,1604,1604,1604,1604,1604,1604,1605,2021-10-04 15:00:00+00:00,Allegany,26.0,30912,26.0,28298,3.0,3407,29.0,29.0,31705,34319,59210
1605,1605,1605,1605,1605,1605,1605,1605,1606,2021-10-05 15:00:00+00:00,Allegany,36.0,30948,41.0,28339,4.0,3411,40.0,45.0,31750,34359,59287
1606,1606,1606,1606,1606,1606,1606,1606,1607,2021-10-06 15:00:00+00:00,Allegany,34.0,30982,48.0,28387,9.0,3420,43.0,57.0,31807,34402,59369
1607,1607,1607,1607,1607,1607,1607,1607,1608,2021-10-07 15:00:00+00:00,Allegany,34.0,31016,31.0,28418,3.0,3423,37.0,34.0,31841,34439,59434
1608,1608,1608,1608,1608,1608,1608,1608,1609,2021-10-08 15:00:00+00:00,Allegany,46.0,31062,54.0,28472,2.0,3425,48.0,56.0,31897,34487,59534
1609,1609,1609,1609,1609,1609,1609,1609,1610,2021-10-09 15:00:00+00:00,Allegany,15.0,31077,17.0,28489,,3425,,,31914,34502,59566
1610,1610,1610,1610,1610,1610,1610,1610,1611,2021-10-10 15:00:00+00:00,Allegany,3.0,31080,7.0,28496,,3425,,,31921,34505,59576
1611,1611,1611,1611,1611,1611,1611,1611,1612,2021-10-11 15:00:00+00:00,Allegany,34.0,31114,39.0,28535,2.0,3427,36.0,41.0,31962,34541,59649
1612,1612,1612,1612,1612,1612,1612,1612,1613,2021-10-12 15:00:00+00:00,Allegany,19.0,31133,27.0,28562,4.0,3431,23.0,31.0,31993,34564,59695
1613,1613,1613,1613,1613,1613,1613,1613,1614,2021-10-13 15:00:00+00:00,Allegany,33.0,31166,60.0,28622,6.0,3437,39.0,66.0,32059,34603,59788
1614,1614,1614,1614,1614,1614,1614,1614,1615,2021-10-14 15:00:00+00:00,Allegany,26.0,31192,40.0,28662,1.0,3438,27.0,41.0,32100,34630,59854
1615,1615,1615,1615,1615,1615,1615,1615,1616,2021-10-15 15:00:00+00:00,Allegany,52.0,31244,86.0,28748,4.0,3442,56.0,90.0,32190,34686,59992
1616,1616,1616,1616,1616,1616,1616,1616,1617,2021-10-16 15:00:00+00:00,Allegany,17.0,31261,18.0,28766,3.0,3445,20.0,21.0,32211,34706,60027
1617,1617,1617,1617,1617,1617,1617,1617,1618,2021-10-17 15:00:00+00:00,Allegany,8.0,31269,11.0,28777,,3445,,,32222,34714,60046
1618,1618,1618,1618,1618,1618,1618,1618,1619,2021-10-18 15:00:00+00:00,Allegany,24.0,31293,39.0,28816,,3445,,,32261,34738,60109
1619,1619,1619,1619,1619,1619,1619,1619,1620,2021-10-19 15:00:00+00:00,Allegany,19.0,31312,21.0,28837,2.0,3447,21.0,23.0,32284,34759,60149
1620,1620,1620,1620,1620,1620,1620,1620,1621,2021-10-20 15:00:00+00:00,Allegany,38.0,31350,62.0,28899,9.0,3456,47.0,71.0,32355,34806,60249
1621,1621,1621,1621,1621,1621,1621,1621,1622,2021-10-21 15:00:00+00:00,Allegany,17.0,31367,32.0,28931,,3456,,,32387,34823,60298
1622,1622,1622,1622,1622,1622,1622,1622,1623,2021-10-22 15:00:00+00:00,Allegany,45.0,31412,54.0,28985,8.0,3464,53.0,62.0,32449,34876,60397
1623,1623,1623,1623,1623,1623,1623,1623,1624,2021-10-23 15:00:00+00:00,Allegany,16.0,31428,17.0,29002,,3464,,,32466,34892,60430
1624,1624,1624,1624,1624,1624,1624,1624,1625,2021-10-24 15:00:00+00:00,Allegany,9.0,31437,4.0,29006,,3464,,,32470,34901,60443
1625,1625,1625,1625,1625,1625,1625,1625,1626,2021-10-25 15:00:00+00:00,Allegany,29.0,31466,30.0,29036,4.0,3468,33.0,34.0,32504,34934,60502
1626,1626,1626,1626,1626,1626,1626,1626,1627,2021-10-26 15:00:00+00:00,Allegany,47.0,31513,64.0,29100,5.0,3473,52.0,69.0,32573,34986,60613
1627,1627,1627,1627,1627,1627,1627,1627,1628,2021-10-27 15:00:00+00:00,Allegany,57.0,31570,56.0,29156,14.0,3487,71.0,70.0,32643,35057,60726
1628,1628,1628,1628,1628,1628,1628,1628,1629,2021-10-28 15:00:00+00:00,Allegany,22.0,31592,48.0,29204,1.0,3488,23.0,49.0,32692,35080,60796
1629,1629,1629,1629,1629,1629,1629,1629,1630,2021-10-29 15:00:00+00:00,Allegany,40.0,31632,49.0,29253,5.0,3493,45.0,54.0,32746,35125,60885
1630,1630,1630,1630,1630,1630,1630,1630,1631,2021-10-30 15:00:00+00:00,Allegany,18.0,31650,19.0,29272,2.0,3495,20.0,21.0,32767,35145,60922
1631,1631,1631,1631,1631,1631,1631,1631,1632,2021-10-31 15:00:00+00:00,Allegany,2.0,31652,9.0,29281,,3495,,,32776,35147,60933
1632,1632,1632,1632,1632,1632,1632,1632,1633,2021-11-01 15:00:00+00:00,Allegany,16.0,31668,27.0,29308,4.0,3499,20.0,31.0,32807,35167,60976
1633,1633,1633,1633,1633,1633,1633,1633,1634,2021-11-02 15:00:00+00:00,Allegany,64.0,31732,40.0,29348,9.0,3508,73.0,49.0,32856,35240,61080
1634,1634,1634,1634,1634,1634,1634,1634,1635,2021-11-03 15:00:00+00:00,Allegany,43.0,31775,36.0,29384,6.0,3514,49.0,42.0,32898,35289,61159
1635,1635,1635,1635,1635,1635,1635,1635,1636,2021-11-04 15:00:00+00:00,Allegany,25.0,31800,26.0,29410,4.0,3518,29.0,30.0,32928,35318,61210
1636,1636,1636,1636,1636,1636,1636,1636,1637,2021-11-05 15:00:00+00:00,Allegany,33.0,31833,49.0,29459,10.0,3528,43.0,59.0,32987,35361,61292
1637,1637,1637,1637,1637,1637,1637,1637,1638,2021-11-06 15:00:00+00:00,Allegany,7.0,31840,8.0,29467,1.0,3529,8.0,9.0,32996,35369,61307
1638,1638,1638,1638,1638,1638,1638,1638,1639,2020-12-14 15:00:00+00:00,Carroll,1.0,1,,0,,0,,,0,1,1
1639,1639,1639,1639,1639,1639,1639,1639,1640,2020-12-16 15:00:00+00:00,Carroll,5.0,6,,0,,0,,,0,6,6
1640,1640,1640,1640,1640,1640,1640,1640,1641,2020-12-17 15:00:00+00:00,Carroll,20.0,26,1.0,1,,0,,,1,26,27
1641,1641,1641,1641,1641,1641,1641,1641,1642,2020-12-18 15:00:00+00:00,Carroll,79.0,105,1.0,2,,0,,,2,105,107
1642,1642,1642,1642,1642,1642,1642,1642,1643,2020-12-19 15:00:00+00:00,Carroll,14.0,119,,2,,0,,,2,119,121
1643,1643,1643,1643,1643,1643,1643,1643,1644,2020-12-20 15:00:00+00:00,Carroll,3.0,122,,2,,0,,,2,122,124
1644,1644,1644,1644,1644,1644,1644,1644,1645,2020-12-21 15:00:00+00:00,Carroll,139.0,261,1.0,3,,0,,,3,261,264
1645,1645,1645,1645,1645,1645,1645,1645,1646,2020-12-22 15:00:00+00:00,Carroll,269.0,530,,3,,0,,,3,530,533
1646,1646,1646,1646,1646,1646,1646,1646,1647,2020-12-23 15:00:00+00:00,Carroll,180.0,710,1.0,4,,0,,,4,710,714
1647,1647,1647,1647,1647,1647,1647,1647,1648,2020-12-24 15:00:00+00:00,Carroll,103.0,813,1.0,5,,0,,,5,813,818
1648,1648,1648,1648,1648,1648,1648,1648,1649,2020-12-25 15:00:00+00:00,Carroll,112.0,925,,5,,0,,,5,925,930
1649,1649,1649,1649,1649,1649,1649,1649,1650,2020-12-26 15:00:00+00:00,Carroll,15.0,940,,5,,0,,,5,940,945
1650,1650,1650,1650,1650,1650,1650,1650,1651,2020-12-27 15:00:00+00:00,Carroll,28.0,968,,5,,0,,,5,968,973
1651,1651,1651,1651,1651,1651,1651,1651,1652,2020-12-28 15:00:00+00:00,Carroll,349.0,1317,3.0,8,,0,,,8,1317,1325
1652,1652,1652,1652,1652,1652,1652,1652,1653,2020-12-29 15:00:00+00:00,Carroll,311.0,1628,2.0,10,,0,,,10,1628,1638
1653,1653,1653,1653,1653,1653,1653,1653,1654,2020-12-30 15:00:00+00:00,Carroll,478.0,2106,2.0,12,,0,,,12,2106,2118
1654,1654,1654,1654,1654,1654,1654,1654,1655,2020-12-31 15:00:00+00:00,Carroll,255.0,2361,3.0,15,,0,,,15,2361,2376
1655,1655,1655,1655,1655,1655,1655,1655,1656,2021-01-01 15:00:00+00:00,Carroll,43.0,2404,3.0,18,,0,,,18,2404,2422
1656,1656,1656,1656,1656,1656,1656,1656,1657,2021-01-02 15:00:00+00:00,Carroll,58.0,2462,2.0,20,,0,,,20,2462,2482
1657,1657,1657,1657,1657,1657,1657,1657,1658,2021-01-03 15:00:00+00:00,Carroll,66.0,2528,,20,,0,,,20,2528,2548
1658,1658,1658,1658,1658,1658,1658,1658,1659,2021-01-04 15:00:00+00:00,Carroll,352.0,2880,9.0,29,,0,,,29,2880,2909
1659,1659,1659,1659,1659,1659,1659,1659,1660,2021-01-05 15:00:00+00:00,Carroll,439.0,3319,8.0,37,,0,,,37,3319,3356
1660,1660,1660,1660,1660,1660,1660,1660,1661,2021-01-06 15:00:00+00:00,Carroll,781.0,4100,19.0,56,,0,,,56,4100,4156
1661,1661,1661,1661,1661,1661,1661,1661,1662,2021-01-07 15:00:00+00:00,Carroll,401.0,4501,35.0,91,,0,,,91,4501,4592
1662,1662,1662,1662,1662,1662,1662,1662,1663,2021-01-08 15:00:00+00:00,Carroll,752.0,5253,66.0,157,,0,,,157,5253,5410
1663,1663,1663,1663,1663,1663,1663,1663,1664,2021-01-09 15:00:00+00:00,Carroll,68.0,5321,22.0,179,,0,,,179,5321,5500
1664,1664,1664,1664,1664,1664,1664,1664,1665,2021-01-10 15:00:00+00:00,Carroll,113.0,5434,20.0,199,,0,,,199,5434,5633
1665,1665,1665,1665,1665,1665,1665,1665,1666,2021-01-11 15:00:00+00:00,Carroll,557.0,5991,124.0,323,,0,,,323,5991,6314
1666,1666,1666,1666,1666,1666,1666,1666,1667,2021-01-12 15:00:00+00:00,Carroll,511.0,6502,231.0,554,,0,,,554,6502,7056
1667,1667,1667,1667,1667,1667,1667,1667,1668,2021-01-13 15:00:00+00:00,Carroll,858.0,7360,152.0,706,,0,,,706,7360,8066
1668,1668,1668,1668,1668,1668,1668,1668,1669,2021-01-14 15:00:00+00:00,Carroll,688.0,8048,67.0,773,,0,,,773,8048,8821
1669,1669,1669,1669,1669,1669,1669,1669,1670,2021-01-15 15:00:00+00:00,Carroll,940.0,8988,129.0,902,,0,,,902,8988,9890
1670,1670,1670,1670,1670,1670,1670,1670,1671,2021-01-16 15:00:00+00:00,Carroll,81.0,9069,147.0,1049,,0,,,1049,9069,10118
1671,1671,1671,1671,1671,1671,1671,1671,1672,2021-01-17 15:00:00+00:00,Carroll,31.0,9100,13.0,1062,,0,,,1062,9100,10162
1672,1672,1672,1672,1672,1672,1672,1672,1673,2021-01-18 15:00:00+00:00,Carroll,144.0,9244,53.0,1115,,0,,,1115,9244,10359
1673,1673,1673,1673,1673,1673,1673,1673,1674,2021-01-19 15:00:00+00:00,Carroll,252.0,9496,96.0,1211,,0,,,1211,9496,10707
1674,1674,1674,1674,1674,1674,1674,1674,1675,2021-01-20 15:00:00+00:00,Carroll,801.0,10297,137.0,1348,,0,,,1348,10297,11645
1675,1675,1675,1675,1675,1675,1675,1675,1676,2021-01-21 15:00:00+00:00,Carroll,798.0,11095,109.0,1457,,0,,,1457,11095,12552
1676,1676,1676,1676,1676,1676,1676,1676,1677,2021-01-22 15:00:00+00:00,Carroll,771.0,11866,58.0,1515,,0,,,1515,11866,13381
1677,1677,1677,1677,1677,1677,1677,1677,1678,2021-01-23 15:00:00+00:00,Carroll,92.0,11958,18.0,1533,,0,,,1533,11958,13491
1678,1678,1678,1678,1678,1678,1678,1678,1679,2021-01-24 15:00:00+00:00,Carroll,79.0,12037,47.0,1580,,0,,,1580,12037,13617
1679,1679,1679,1679,1679,1679,1679,1679,1680,2021-01-25 15:00:00+00:00,Carroll,276.0,12313,290.0,1870,,0,,,1870,12313,14183
1680,1680,1680,1680,1680,1680,1680,1680,1681,2021-01-26 15:00:00+00:00,Carroll,333.0,12646,368.0,2238,,0,,,2238,12646,14884
1681,1681,1681,1681,1681,1681,1681,1681,1682,2021-01-27 15:00:00+00:00,Carroll,1067.0,13713,464.0,2702,,0,,,2702,13713,16415
1682,1682,1682,1682,1682,1682,1682,1682,1683,2021-01-28 15:00:00+00:00,Carroll,840.0,14553,286.0,2988,,0,,,2988,14553,17541
1683,1683,1683,1683,1683,1683,1683,1683,1684,2021-01-29 15:00:00+00:00,Carroll,571.0,15124,180.0,3168,,0,,,3168,15124,18292
1684,1684,1684,1684,1684,1684,1684,1684,1685,2021-01-30 15:00:00+00:00,Carroll,469.0,15593,70.0,3238,,0,,,3238,15593,18831
1685,1685,1685,1685,1685,1685,1685,1685,1686,2021-01-31 15:00:00+00:00,Carroll,33.0,15626,14.0,3252,,0,,,3252,15626,18878
1686,1686,1686,1686,1686,1686,1686,1686,1687,2021-02-01 15:00:00+00:00,Carroll,276.0,15902,366.0,3618,,0,,,3618,15902,19520
1687,1687,1687,1687,1687,1687,1687,1687,1688,2021-02-02 15:00:00+00:00,Carroll,236.0,16138,274.0,3892,,0,,,3892,16138,20030
1688,1688,1688,1688,1688,1688,1688,1688,1689,2021-02-03 15:00:00+00:00,Carroll,553.0,16691,1026.0,4918,,0,,,4918,16691,21609
1689,1689,1689,1689,1689,1689,1689,1689,1690,2021-02-04 15:00:00+00:00,Carroll,827.0,17518,395.0,5313,,0,,,5313,17518,22831
1690,1690,1690,1690,1690,1690,1690,1690,1691,2021-02-05 15:00:00+00:00,Carroll,351.0,17869,1057.0,6370,,0,,,6370,17869,24239
1691,1691,1691,1691,1691,1691,1691,1691,1692,2021-02-06 15:00:00+00:00,Carroll,204.0,18073,69.0,6439,,0,,,6439,18073,24512
1692,1692,1692,1692,1692,1692,1692,1692,1693,2021-02-07 15:00:00+00:00,Carroll,86.0,18159,17.0,6456,,0,,,6456,18159,24615
1693,1693,1693,1693,1693,1693,1693,1693,1694,2021-02-08 15:00:00+00:00,Carroll,169.0,18328,290.0,6746,,0,,,6746,18328,25074
1694,1694,1694,1694,1694,1694,1694,1694,1695,2021-02-09 15:00:00+00:00,Carroll,828.0,19156,273.0,7019,,0,,,7019,19156,26175
1695,1695,1695,1695,1695,1695,1695,1695,1696,2021-02-10 15:00:00+00:00,Carroll,913.0,20069,777.0,7796,,0,,,7796,20069,27865
1696,1696,1696,1696,1696,1696,1696,1696,1697,2021-02-11 15:00:00+00:00,Carroll,606.0,20675,666.0,8462,,0,,,8462,20675,29137
1697,1697,1697,1697,1697,1697,1697,1697,1698,2021-02-12 15:00:00+00:00,Carroll,539.0,21214,634.0,9096,,0,,,9096,21214,30310
1698,1698,1698,1698,1698,1698,1698,1698,1699,2021-02-13 15:00:00+00:00,Carroll,247.0,21461,100.0,9196,,0,,,9196,21461,30657
1699,1699,1699,1699,1699,1699,1699,1699,1700,2021-02-14 15:00:00+00:00,Carroll,146.0,21607,27.0,9223,,0,,,9223,21607,30830
1700,1700,1700,1700,1700,1700,1700,1700,1701,2021-02-15 15:00:00+00:00,Carroll,270.0,21877,305.0,9528,,0,,,9528,21877,31405
1701,1701,1701,1701,1701,1701,1701,1701,1702,2021-02-16 15:00:00+00:00,Carroll,494.0,22371,543.0,10071,,0,,,10071,22371,32442
1702,1702,1702,1702,1702,1702,1702,1702,1703,2021-02-17 15:00:00+00:00,Carroll,1055.0,23426,1046.0,11117,,0,,,11117,23426,34543
1703,1703,1703,1703,1703,1703,1703,1703,1704,2021-02-18 15:00:00+00:00,Carroll,49.0,23475,64.0,11181,,0,,,11181,23475,34656
1704,1704,1704,1704,1704,1704,1704,1704,1705,2021-02-19 15:00:00+00:00,Carroll,211.0,23686,277.0,11458,,0,,,11458,23686,35144
1705,1705,1705,1705,1705,1705,1705,1705,1706,2021-02-20 15:00:00+00:00,Carroll,168.0,23854,807.0,12265,,0,,,12265,23854,36119
1706,1706,1706,1706,1706,1706,1706,1706,1707,2021-02-21 15:00:00+00:00,Carroll,104.0,23958,106.0,12371,,0,,,12371,23958,36329
1707,1707,1707,1707,1707,1707,1707,1707,1708,2021-02-22 15:00:00+00:00,Carroll,305.0,24263,353.0,12724,,0,,,12724,24263,36987
1708,1708,1708,1708,1708,1708,1708,1708,1709,2021-02-23 15:00:00+00:00,Carroll,862.0,25125,197.0,12921,,0,,,12921,25125,38046
1709,1709,1709,1709,1709,1709,1709,1709,1710,2021-02-24 15:00:00+00:00,Carroll,772.0,25897,1079.0,14000,,0,,,14000,25897,39897
1710,1710,1710,1710,1710,1710,1710,1710,1711,2021-02-25 15:00:00+00:00,Carroll,740.0,26637,1070.0,15070,,0,,,15070,26637,41707
1711,1711,1711,1711,1711,1711,1711,1711,1712,2021-02-26 15:00:00+00:00,Carroll,659.0,27296,824.0,15894,,0,,,15894,27296,43190
1712,1712,1712,1712,1712,1712,1712,1712,1713,2021-02-27 15:00:00+00:00,Carroll,390.0,27686,360.0,16254,,0,,,16254,27686,43940
1713,1713,1713,1713,1713,1713,1713,1713,1714,2021-02-28 15:00:00+00:00,Carroll,404.0,28090,74.0,16328,,0,,,16328,28090,44418
1714,1714,1714,1714,1714,1714,1714,1714,1715,2021-03-01 15:00:00+00:00,Carroll,673.0,28763,134.0,16462,,0,,,16462,28763,45225
1715,1715,1715,1715,1715,1715,1715,1715,1716,2021-03-02 15:00:00+00:00,Carroll,933.0,29696,200.0,16662,1.0,1,934.0,201.0,16663,29697,46358
1716,1716,1716,1716,1716,1716,1716,1716,1717,2021-03-03 15:00:00+00:00,Carroll,1327.0,31023,625.0,17287,4.0,5,1331.0,629.0,17292,31028,48310
1717,1717,1717,1717,1717,1717,1717,1717,1718,2021-03-04 15:00:00+00:00,Carroll,674.0,31697,753.0,18040,304.0,309,978.0,1057.0,18349,32006,49737
1718,1718,1718,1718,1718,1718,1718,1718,1719,2021-03-05 15:00:00+00:00,Carroll,516.0,32213,537.0,18577,503.0,812,1019.0,1040.0,19389,33025,50790
1719,1719,1719,1719,1719,1719,1719,1719,1720,2021-03-06 15:00:00+00:00,Carroll,418.0,32631,173.0,18750,154.0,966,572.0,327.0,19716,33597,51381
1720,1720,1720,1720,1720,1720,1720,1720,1721,2021-03-07 15:00:00+00:00,Carroll,374.0,33005,72.0,18822,197.0,1163,571.0,269.0,19985,34168,51827
1721,1721,1721,1721,1721,1721,1721,1721,1722,2021-03-08 15:00:00+00:00,Carroll,575.0,33580,156.0,18978,213.0,1376,788.0,369.0,20354,34956,52558
1722,1722,1722,1722,1722,1722,1722,1722,1723,2021-03-09 15:00:00+00:00,Carroll,479.0,34059,729.0,19707,209.0,1585,688.0,938.0,21292,35644,53766
1723,1723,1723,1723,1723,1723,1723,1723,1724,2021-03-10 15:00:00+00:00,Carroll,631.0,34690,738.0,20445,223.0,1808,854.0,961.0,22253,36498,55135
1724,1724,1724,1724,1724,1724,1724,1724,1725,2021-03-11 15:00:00+00:00,Carroll,1145.0,35835,247.0,20692,123.0,1931,1268.0,370.0,22623,37766,56527
1725,1725,1725,1725,1725,1725,1725,1725,1726,2021-03-12 15:00:00+00:00,Carroll,1219.0,37054,482.0,21174,29.0,1960,1248.0,511.0,23134,39014,58228
1726,1726,1726,1726,1726,1726,1726,1726,1727,2021-03-13 15:00:00+00:00,Carroll,505.0,37559,228.0,21402,11.0,1971,516.0,239.0,23373,39530,58961
1727,1727,1727,1727,1727,1727,1727,1727,1728,2021-03-14 15:00:00+00:00,Carroll,435.0,37994,189.0,21591,34.0,2005,469.0,223.0,23596,39999,59585
1728,1728,1728,1728,1728,1728,1728,1728,1729,2021-03-15 15:00:00+00:00,Carroll,768.0,38762,290.0,21881,19.0,2024,787.0,309.0,23905,40786,60643
1729,1729,1729,1729,1729,1729,1729,1729,1730,2021-03-16 15:00:00+00:00,Carroll,727.0,39489,531.0,22412,9.0,2033,736.0,540.0,24445,41522,61901
1730,1730,1730,1730,1730,1730,1730,1730,1731,2021-03-17 15:00:00+00:00,Carroll,1226.0,40715,984.0,23396,6.0,2039,1232.0,990.0,25435,42754,64111
1731,1731,1731,1731,1731,1731,1731,1731,1732,2021-03-18 15:00:00+00:00,Carroll,1272.0,41987,530.0,23926,42.0,2081,1314.0,572.0,26007,44068,65913
1732,1732,1732,1732,1732,1732,1732,1732,1733,2021-03-19 15:00:00+00:00,Carroll,1312.0,43299,318.0,24244,29.0,2110,1341.0,347.0,26354,45409,67543
1733,1733,1733,1733,1733,1733,1733,1733,1734,2021-03-20 15:00:00+00:00,Carroll,565.0,43864,219.0,24463,10.0,2120,575.0,229.0,26583,45984,68327
1734,1734,1734,1734,1734,1734,1734,1734,1735,2021-03-21 15:00:00+00:00,Carroll,423.0,44287,201.0,24664,6.0,2126,429.0,207.0,26790,46413,68951
1735,1735,1735,1735,1735,1735,1735,1735,1736,2021-03-22 15:00:00+00:00,Carroll,678.0,44965,449.0,25113,51.0,2177,729.0,500.0,27290,47142,70078
1736,1736,1736,1736,1736,1736,1736,1736,1737,2021-03-23 15:00:00+00:00,Carroll,759.0,45724,917.0,26030,101.0,2278,860.0,1018.0,28308,48002,71754
1737,1737,1737,1737,1737,1737,1737,1737,1738,2021-03-24 15:00:00+00:00,Carroll,1612.0,47336,862.0,26892,60.0,2338,1672.0,922.0,29230,49674,74228
1738,1738,1738,1738,1738,1738,1738,1738,1739,2021-03-25 15:00:00+00:00,Carroll,1267.0,48603,447.0,27339,158.0,2496,1425.0,605.0,29835,51099,75942
1739,1739,1739,1739,1739,1739,1739,1739,1740,2021-03-26 15:00:00+00:00,Carroll,682.0,49285,510.0,27849,147.0,2643,829.0,657.0,30492,51928,77134
1740,1740,1740,1740,1740,1740,1740,1740,1741,2021-03-27 15:00:00+00:00,Carroll,1311.0,50596,361.0,28210,105.0,2748,1416.0,466.0,30958,53344,78806
1741,1741,1741,1741,1741,1741,1741,1741,1742,2021-03-28 15:00:00+00:00,Carroll,376.0,50972,365.0,28575,97.0,2845,473.0,462.0,31420,53817,79547
1742,1742,1742,1742,1742,1742,1742,1742,1743,2021-03-29 15:00:00+00:00,Carroll,617.0,51589,563.0,29138,33.0,2878,650.0,596.0,32016,54467,80727
1743,1743,1743,1743,1743,1743,1743,1743,1744,2021-03-30 15:00:00+00:00,Carroll,892.0,52481,1001.0,30139,99.0,2977,991.0,1100.0,33116,55458,82620
1744,1744,1744,1744,1744,1744,1744,1744,1745,2021-03-31 15:00:00+00:00,Carroll,1185.0,53666,1273.0,31412,246.0,3223,1431.0,1519.0,34635,56889,85078
1745,1745,1745,1745,1745,1745,1745,1745,1746,2021-04-01 15:00:00+00:00,Carroll,1570.0,55236,939.0,32351,200.0,3423,1770.0,1139.0,35774,58659,87587
1746,1746,1746,1746,1746,1746,1746,1746,1747,2021-04-02 15:00:00+00:00,Carroll,1413.0,56649,684.0,33035,231.0,3654,1644.0,915.0,36689,60303,89684
1747,1747,1747,1747,1747,1747,1747,1747,1748,2021-04-03 15:00:00+00:00,Carroll,389.0,57038,399.0,33434,199.0,3853,588.0,598.0,37287,60891,90472
1748,1748,1748,1748,1748,1748,1748,1748,1749,2021-04-04 15:00:00+00:00,Carroll,170.0,57208,267.0,33701,14.0,3867,184.0,281.0,37568,61075,90909
1749,1749,1749,1749,1749,1749,1749,1749,1750,2021-04-05 15:00:00+00:00,Carroll,471.0,57679,748.0,34449,211.0,4078,682.0,959.0,38527,61757,92128
1750,1750,1750,1750,1750,1750,1750,1750,1751,2021-04-06 15:00:00+00:00,Carroll,1233.0,58912,612.0,35061,323.0,4401,1556.0,935.0,39462,63313,93973
1751,1751,1751,1751,1751,1751,1751,1751,1752,2021-04-07 15:00:00+00:00,Carroll,1242.0,60154,739.0,35800,382.0,4783,1624.0,1121.0,40583,64937,95954
1752,1752,1752,1752,1752,1752,1752,1752,1753,2021-04-08 15:00:00+00:00,Carroll,760.0,60914,1131.0,36931,558.0,5341,1318.0,1689.0,42272,66255,97845
1753,1753,1753,1753,1753,1753,1753,1753,1754,2021-04-09 15:00:00+00:00,Carroll,533.0,61447,1702.0,38633,375.0,5716,908.0,2077.0,44349,67163,100080
1754,1754,1754,1754,1754,1754,1754,1754,1755,2021-04-10 15:00:00+00:00,Carroll,291.0,61738,487.0,39120,146.0,5862,437.0,633.0,44982,67600,100858
1755,1755,1755,1755,1755,1755,1755,1755,1756,2021-04-11 15:00:00+00:00,Carroll,255.0,61993,318.0,39438,388.0,6250,643.0,706.0,45688,68243,101431
1756,1756,1756,1756,1756,1756,1756,1756,1757,2021-04-12 15:00:00+00:00,Carroll,380.0,62373,644.0,40082,442.0,6692,822.0,1086.0,46774,69065,102455
1757,1757,1757,1757,1757,1757,1757,1757,1758,2021-04-13 15:00:00+00:00,Carroll,601.0,62974,849.0,40931,6.0,6698,607.0,855.0,47629,69672,103905
1758,1758,1758,1758,1758,1758,1758,1758,1759,2021-04-14 15:00:00+00:00,Carroll,1231.0,64205,1104.0,42035,1.0,6699,1232.0,1105.0,48734,70904,106240
1759,1759,1759,1759,1759,1759,1759,1759,1760,2021-04-15 15:00:00+00:00,Carroll,813.0,65018,1278.0,43313,1.0,6700,814.0,1279.0,50013,71718,108331
1760,1760,1760,1760,1760,1760,1760,1760,1761,2021-04-16 15:00:00+00:00,Carroll,1099.0,66117,703.0,44016,,6700,,,50716,72817,110133
1761,1761,1761,1761,1761,1761,1761,1761,1762,2021-04-17 15:00:00+00:00,Carroll,669.0,66786,1213.0,45229,,6700,,,51929,73486,112015
1762,1762,1762,1762,1762,1762,1762,1762,1763,2021-04-18 15:00:00+00:00,Carroll,285.0,67071,410.0,45639,,6700,,,52339,73771,112710
1763,1763,1763,1763,1763,1763,1763,1763,1764,2021-04-19 15:00:00+00:00,Carroll,1095.0,68166,624.0,46263,,6700,,,52963,74866,114429
1764,1764,1764,1764,1764,1764,1764,1764,1765,2021-04-20 15:00:00+00:00,Carroll,1200.0,69366,779.0,47042,,6700,,,53742,76066,116408
1765,1765,1765,1765,1765,1765,1765,1765,1766,2021-04-21 15:00:00+00:00,Carroll,1055.0,70421,1583.0,48625,,6700,,,55325,77121,119046
1766,1766,1766,1766,1766,1766,1766,1766,1767,2021-04-22 15:00:00+00:00,Carroll,1020.0,71441,1292.0,49917,,6700,,,56617,78141,121358
1767,1767,1767,1767,1767,1767,1767,1767,1768,2021-04-23 15:00:00+00:00,Carroll,662.0,72103,1355.0,51272,3.0,6703,665.0,1358.0,57975,78806,123375
1768,1768,1768,1768,1768,1768,1768,1768,1769,2021-04-24 15:00:00+00:00,Carroll,609.0,72712,450.0,51722,,6703,,,58425,79415,124434
1769,1769,1769,1769,1769,1769,1769,1769,1770,2021-04-25 15:00:00+00:00,Carroll,717.0,73429,257.0,51979,5.0,6708,722.0,262.0,58687,80137,125408
1770,1770,1770,1770,1770,1770,1770,1770,1771,2021-04-26 15:00:00+00:00,Carroll,521.0,73950,535.0,52514,17.0,6725,538.0,552.0,59239,80675,126464
1771,1771,1771,1771,1771,1771,1771,1771,1772,2021-04-27 15:00:00+00:00,Carroll,1046.0,74996,581.0,53095,34.0,6759,1080.0,615.0,59854,81755,128091
1772,1772,1772,1772,1772,1772,1772,1772,1773,2021-04-28 15:00:00+00:00,Carroll,855.0,75851,1150.0,54245,49.0,6808,904.0,1199.0,61053,82659,130096
1773,1773,1773,1773,1773,1773,1773,1773,1774,2021-04-29 15:00:00+00:00,Carroll,585.0,76436,1529.0,55774,64.0,6872,649.0,1593.0,62646,83308,132210
1774,1774,1774,1774,1774,1774,1774,1774,1775,2021-04-30 15:00:00+00:00,Carroll,582.0,77018,609.0,56383,107.0,6979,689.0,716.0,63362,83997,133401
1775,1775,1775,1775,1775,1775,1775,1775,1776,2021-05-01 15:00:00+00:00,Carroll,373.0,77391,438.0,56821,35.0,7014,408.0,473.0,63835,84405,134212
1776,1776,1776,1776,1776,1776,1776,1776,1777,2021-05-02 15:00:00+00:00,Carroll,205.0,77596,284.0,57105,35.0,7049,240.0,319.0,64154,84645,134701
1777,1777,1777,1777,1777,1777,1777,1777,1778,2021-05-03 15:00:00+00:00,Carroll,215.0,77811,475.0,57580,77.0,7126,292.0,552.0,64706,84937,135391
1778,1778,1778,1778,1778,1778,1778,1778,1779,2021-05-04 15:00:00+00:00,Carroll,305.0,78116,1155.0,58735,111.0,7237,416.0,1266.0,65972,85353,136851
1779,1779,1779,1779,1779,1779,1779,1779,1780,2021-05-05 15:00:00+00:00,Carroll,474.0,78590,1318.0,60053,123.0,7360,597.0,1441.0,67413,85950,138643
1780,1780,1780,1780,1780,1780,1780,1780,1781,2021-05-06 15:00:00+00:00,Carroll,577.0,79167,683.0,60736,75.0,7435,652.0,758.0,68171,86602,139903
1781,1781,1781,1781,1781,1781,1781,1781,1782,2021-05-07 15:00:00+00:00,Carroll,321.0,79488,545.0,61281,174.0,7609,495.0,719.0,68890,87097,140769
1782,1782,1782,1782,1782,1782,1782,1782,1783,2021-05-08 15:00:00+00:00,Carroll,193.0,79681,517.0,61798,35.0,7644,228.0,552.0,69442,87325,141479
1783,1783,1783,1783,1783,1783,1783,1783,1784,2021-05-09 15:00:00+00:00,Carroll,97.0,79778,227.0,62025,29.0,7673,126.0,256.0,69698,87451,141803
1784,1784,1784,1784,1784,1784,1784,1784,1785,2021-05-10 15:00:00+00:00,Carroll,186.0,79964,483.0,62508,47.0,7720,233.0,530.0,70228,87684,142472
1785,1785,1785,1785,1785,1785,1785,1785,1786,2021-05-11 15:00:00+00:00,Carroll,324.0,80288,608.0,63116,45.0,7765,369.0,653.0,70881,88053,143404
1786,1786,1786,1786,1786,1786,1786,1786,1787,2021-05-12 15:00:00+00:00,Carroll,267.0,80555,1470.0,64586,59.0,7824,326.0,1529.0,72410,88379,145141
1787,1787,1787,1787,1787,1787,1787,1787,1788,2021-05-13 15:00:00+00:00,Carroll,553.0,81108,746.0,65332,50.0,7874,603.0,796.0,73206,88982,146440
1788,1788,1788,1788,1788,1788,1788,1788,1789,2021-05-14 15:00:00+00:00,Carroll,398.0,81506,1069.0,66401,63.0,7937,461.0,1132.0,74338,89443,147907
1789,1789,1789,1789,1789,1789,1789,1789,1790,2021-05-15 15:00:00+00:00,Carroll,263.0,81769,473.0,66874,33.0,7970,296.0,506.0,74844,89739,148643
1790,1790,1790,1790,1790,1790,1790,1790,1791,2021-05-16 15:00:00+00:00,Carroll,199.0,81968,321.0,67195,40.0,8010,239.0,361.0,75205,89978,149163
1791,1791,1791,1791,1791,1791,1791,1791,1792,2021-05-17 15:00:00+00:00,Carroll,313.0,82281,1085.0,68280,65.0,8075,378.0,1150.0,76355,90356,150561
1792,1792,1792,1792,1792,1792,1792,1792,1793,2021-05-18 15:00:00+00:00,Carroll,414.0,82695,1195.0,69475,61.0,8136,475.0,1256.0,77611,90831,152170
1793,1793,1793,1793,1793,1793,1793,1793,1794,2021-05-19 15:00:00+00:00,Carroll,1502.0,84197,826.0,70301,49.0,8185,1551.0,875.0,78486,92382,154498
1794,1794,1794,1794,1794,1794,1794,1794,1795,2021-05-20 15:00:00+00:00,Carroll,572.0,84769,781.0,71082,40.0,8225,612.0,821.0,79307,92994,155851
1795,1795,1795,1795,1795,1795,1795,1795,1796,2021-05-21 15:00:00+00:00,Carroll,450.0,85219,648.0,71730,67.0,8292,517.0,715.0,80022,93511,156949
1796,1796,1796,1796,1796,1796,1796,1796,1797,2021-05-22 15:00:00+00:00,Carroll,306.0,85525,493.0,72223,29.0,8321,335.0,522.0,80544,93846,157748
1797,1797,1797,1797,1797,1797,1797,1797,1798,2021-05-23 15:00:00+00:00,Carroll,248.0,85773,538.0,72761,23.0,8344,271.0,561.0,81105,94117,158534
1798,1798,1798,1798,1798,1798,1798,1798,1799,2021-05-24 15:00:00+00:00,Carroll,236.0,86009,394.0,73155,48.0,8392,284.0,442.0,81547,94401,159164
1799,1799,1799,1799,1799,1799,1799,1799,1800,2021-05-25 15:00:00+00:00,Carroll,301.0,86310,858.0,74013,48.0,8440,349.0,906.0,82453,94750,160323
1800,1800,1800,1800,1800,1800,1800,1800,1801,2021-05-26 15:00:00+00:00,Carroll,1015.0,87325,645.0,74658,42.0,8482,1057.0,687.0,83140,95807,161983
1801,1801,1801,1801,1801,1801,1801,1801,1802,2021-05-27 15:00:00+00:00,Carroll,316.0,87641,512.0,75170,48.0,8530,364.0,560.0,83700,96171,162811
1802,1802,1802,1802,1802,1802,1802,1802,1803,2021-05-28 15:00:00+00:00,Carroll,313.0,87954,427.0,75597,35.0,8565,348.0,462.0,84162,96519,163551
1803,1803,1803,1803,1803,1803,1803,1803,1804,2021-05-29 15:00:00+00:00,Carroll,188.0,88142,242.0,75839,13.0,8578,201.0,255.0,84417,96720,163981
1804,1804,1804,1804,1804,1804,1804,1804,1805,2021-05-30 15:00:00+00:00,Carroll,111.0,88253,145.0,75984,16.0,8594,127.0,161.0,84578,96847,164237
1805,1805,1805,1805,1805,1805,1805,1805,1806,2021-05-31 15:00:00+00:00,Carroll,43.0,88296,85.0,76069,15.0,8609,58.0,100.0,84678,96905,164365
1806,1806,1806,1806,1806,1806,1806,1806,1807,2021-06-01 15:00:00+00:00,Carroll,220.0,88516,339.0,76408,22.0,8631,242.0,361.0,85039,97147,164924
1807,1807,1807,1807,1807,1807,1807,1807,1808,2021-06-02 15:00:00+00:00,Carroll,186.0,88702,411.0,76819,26.0,8657,212.0,437.0,85476,97359,165521
1808,1808,1808,1808,1808,1808,1808,1808,1809,2021-06-03 15:00:00+00:00,Carroll,194.0,88896,659.0,77478,84.0,8741,278.0,743.0,86219,97637,166374
1809,1809,1809,1809,1809,1809,1809,1809,1810,2021-06-04 15:00:00+00:00,Carroll,176.0,89072,404.0,77882,45.0,8786,221.0,449.0,86668,97858,166954
1810,1810,1810,1810,1810,1810,1810,1810,1811,2021-06-05 15:00:00+00:00,Carroll,125.0,89197,228.0,78110,21.0,8807,146.0,249.0,86917,98004,167307
1811,1811,1811,1811,1811,1811,1811,1811,1812,2021-06-06 15:00:00+00:00,Carroll,71.0,89268,188.0,78298,12.0,8819,83.0,200.0,87117,98087,167566
1812,1812,1812,1812,1812,1812,1812,1812,1813,2021-06-07 15:00:00+00:00,Carroll,145.0,89413,267.0,78565,22.0,8841,167.0,289.0,87406,98254,167978
1813,1813,1813,1813,1813,1813,1813,1813,1814,2021-06-08 15:00:00+00:00,Carroll,137.0,89550,453.0,79018,32.0,8873,169.0,485.0,87891,98423,168568
1814,1814,1814,1814,1814,1814,1814,1814,1815,2021-06-09 15:00:00+00:00,Carroll,144.0,89694,1304.0,80322,22.0,8895,166.0,1326.0,89217,98589,170016
1815,1815,1815,1815,1815,1815,1815,1815,1816,2021-06-10 15:00:00+00:00,Carroll,159.0,89853,541.0,80863,22.0,8917,181.0,563.0,89780,98770,170716
1816,1816,1816,1816,1816,1816,1816,1816,1817,2021-06-11 15:00:00+00:00,Carroll,124.0,89977,396.0,81259,31.0,8948,155.0,427.0,90207,98925,171236
1817,1817,1817,1817,1817,1817,1817,1817,1818,2021-06-12 15:00:00+00:00,Carroll,75.0,90052,240.0,81499,10.0,8958,85.0,250.0,90457,99010,171551
1818,1818,1818,1818,1818,1818,1818,1818,1819,2021-06-13 15:00:00+00:00,Carroll,41.0,90093,214.0,81713,11.0,8969,52.0,225.0,90682,99062,171806
1819,1819,1819,1819,1819,1819,1819,1819,1820,2021-06-14 15:00:00+00:00,Carroll,119.0,90212,279.0,81992,16.0,8985,135.0,295.0,90977,99197,172204
1820,1820,1820,1820,1820,1820,1820,1820,1821,2021-06-15 15:00:00+00:00,Carroll,113.0,90325,338.0,82330,19.0,9004,132.0,357.0,91334,99329,172655
1821,1821,1821,1821,1821,1821,1821,1821,1822,2021-06-16 15:00:00+00:00,Carroll,204.0,90529,971.0,83301,20.0,9024,224.0,991.0,92325,99553,173830
1822,1822,1822,1822,1822,1822,1822,1822,1823,2021-06-17 15:00:00+00:00,Carroll,122.0,90651,456.0,83757,26.0,9050,148.0,482.0,92807,99701,174408
1823,1823,1823,1823,1823,1823,1823,1823,1824,2021-06-18 15:00:00+00:00,Carroll,126.0,90777,302.0,84059,21.0,9071,147.0,323.0,93130,99848,174836
1824,1824,1824,1824,1824,1824,1824,1824,1825,2021-06-19 15:00:00+00:00,Carroll,66.0,90843,194.0,84253,8.0,9079,74.0,202.0,93332,99922,175096
1825,1825,1825,1825,1825,1825,1825,1825,1826,2021-06-20 15:00:00+00:00,Carroll,52.0,90895,145.0,84398,1.0,9080,53.0,146.0,93478,99975,175293
1826,1826,1826,1826,1826,1826,1826,1826,1827,2021-06-21 15:00:00+00:00,Carroll,111.0,91006,158.0,84556,23.0,9103,134.0,181.0,93659,100109,175562
1827,1827,1827,1827,1827,1827,1827,1827,1828,2021-06-22 15:00:00+00:00,Carroll,134.0,91140,266.0,84822,13.0,9116,147.0,279.0,93938,100256,175962
1828,1828,1828,1828,1828,1828,1828,1828,1829,2021-06-23 15:00:00+00:00,Carroll,124.0,91264,185.0,85007,16.0,9132,140.0,201.0,94139,100396,176271
1829,1829,1829,1829,1829,1829,1829,1829,1830,2021-06-24 15:00:00+00:00,Carroll,102.0,91366,237.0,85244,18.0,9150,120.0,255.0,94394,100516,176610
1830,1830,1830,1830,1830,1830,1830,1830,1831,2021-06-25 15:00:00+00:00,Carroll,121.0,91487,185.0,85429,14.0,9164,135.0,199.0,94593,100651,176916
1831,1831,1831,1831,1831,1831,1831,1831,1832,2021-06-26 15:00:00+00:00,Carroll,71.0,91558,112.0,85541,2.0,9166,73.0,114.0,94707,100724,177099
1832,1832,1832,1832,1832,1832,1832,1832,1833,2021-06-27 15:00:00+00:00,Carroll,49.0,91607,100.0,85641,1.0,9167,50.0,101.0,94808,100774,177248
1833,1833,1833,1833,1833,1833,1833,1833,1834,2021-06-28 15:00:00+00:00,Carroll,76.0,91683,116.0,85757,22.0,9189,98.0,138.0,94946,100872,177440
1834,1834,1834,1834,1834,1834,1834,1834,1835,2021-06-29 15:00:00+00:00,Carroll,103.0,91786,142.0,85899,6.0,9195,109.0,148.0,95094,100981,177685
1835,1835,1835,1835,1835,1835,1835,1835,1836,2021-06-30 15:00:00+00:00,Carroll,106.0,91892,167.0,86066,16.0,9211,122.0,183.0,95277,101103,177958
1836,1836,1836,1836,1836,1836,1836,1836,1837,2021-07-01 15:00:00+00:00,Carroll,110.0,92002,167.0,86233,15.0,9226,125.0,182.0,95459,101228,178235
1837,1837,1837,1837,1837,1837,1837,1837,1838,2021-07-02 15:00:00+00:00,Carroll,113.0,92115,118.0,86351,21.0,9247,134.0,139.0,95598,101362,178466
1838,1838,1838,1838,1838,1838,1838,1838,1839,2021-07-03 15:00:00+00:00,Carroll,56.0,92171,77.0,86428,9.0,9256,65.0,86.0,95684,101427,178599
1839,1839,1839,1839,1839,1839,1839,1839,1840,2021-07-04 15:00:00+00:00,Carroll,2.0,92173,14.0,86442,,9256,,,95698,101429,178615
1840,1840,1840,1840,1840,1840,1840,1840,1841,2021-07-05 15:00:00+00:00,Carroll,87.0,92260,102.0,86544,17.0,9273,104.0,119.0,95817,101533,178804
1841,1841,1841,1841,1841,1841,1841,1841,1842,2021-07-06 15:00:00+00:00,Carroll,85.0,92345,143.0,86687,25.0,9298,110.0,168.0,95985,101643,179032
1842,1842,1842,1842,1842,1842,1842,1842,1843,2021-07-07 15:00:00+00:00,Carroll,77.0,92422,188.0,86875,21.0,9319,98.0,209.0,96194,101741,179297
1843,1843,1843,1843,1843,1843,1843,1843,1844,2021-07-08 15:00:00+00:00,Carroll,104.0,92526,169.0,87044,12.0,9331,116.0,181.0,96375,101857,179570
1844,1844,1844,1844,1844,1844,1844,1844,1845,2021-07-09 15:00:00+00:00,Carroll,87.0,92613,131.0,87175,20.0,9351,107.0,151.0,96526,101964,179788
1845,1845,1845,1845,1845,1845,1845,1845,1846,2021-07-10 15:00:00+00:00,Carroll,62.0,92675,66.0,87241,12.0,9363,74.0,78.0,96604,102038,179916
1846,1846,1846,1846,1846,1846,1846,1846,1847,2021-07-11 15:00:00+00:00,Carroll,34.0,92709,58.0,87299,2.0,9365,36.0,60.0,96664,102074,180008
1847,1847,1847,1847,1847,1847,1847,1847,1848,2021-07-12 15:00:00+00:00,Carroll,97.0,92806,110.0,87409,22.0,9387,119.0,132.0,96796,102193,180215
1848,1848,1848,1848,1848,1848,1848,1848,1849,2021-07-13 15:00:00+00:00,Carroll,99.0,92905,99.0,87508,11.0,9398,110.0,110.0,96906,102303,180413
1849,1849,1849,1849,1849,1849,1849,1849,1850,2021-07-14 15:00:00+00:00,Carroll,78.0,92983,125.0,87633,6.0,9404,84.0,131.0,97037,102387,180616
1850,1850,1850,1850,1850,1850,1850,1850,1851,2021-07-15 15:00:00+00:00,Carroll,97.0,93080,95.0,87728,22.0,9426,119.0,117.0,97154,102506,180808
1851,1851,1851,1851,1851,1851,1851,1851,1852,2021-07-16 15:00:00+00:00,Carroll,103.0,93183,121.0,87849,5.0,9431,108.0,126.0,97280,102614,181032
1852,1852,1852,1852,1852,1852,1852,1852,1853,2021-07-17 15:00:00+00:00,Carroll,55.0,93238,60.0,87909,9.0,9440,64.0,69.0,97349,102678,181147
1853,1853,1853,1853,1853,1853,1853,1853,1854,2021-07-18 15:00:00+00:00,Carroll,47.0,93285,65.0,87974,2.0,9442,49.0,67.0,97416,102727,181259
1854,1854,1854,1854,1854,1854,1854,1854,1855,2021-07-19 15:00:00+00:00,Carroll,136.0,93421,105.0,88079,25.0,9467,161.0,130.0,97546,102888,181500
1855,1855,1855,1855,1855,1855,1855,1855,1856,2021-07-20 15:00:00+00:00,Carroll,135.0,93556,120.0,88199,20.0,9487,155.0,140.0,97686,103043,181755
1856,1856,1856,1856,1856,1856,1856,1856,1857,2021-07-21 15:00:00+00:00,Carroll,134.0,93690,105.0,88304,13.0,9500,147.0,118.0,97804,103190,181994
1857,1857,1857,1857,1857,1857,1857,1857,1858,2021-07-22 15:00:00+00:00,Carroll,156.0,93846,101.0,88405,17.0,9517,173.0,118.0,97922,103363,182251
1858,1858,1858,1858,1858,1858,1858,1858,1859,2021-07-23 15:00:00+00:00,Carroll,168.0,94014,136.0,88541,24.0,9541,192.0,160.0,98082,103555,182555
1859,1859,1859,1859,1859,1859,1859,1859,1860,2021-07-24 15:00:00+00:00,Carroll,104.0,94118,66.0,88607,1.0,9542,105.0,67.0,98149,103660,182725
1860,1860,1860,1860,1860,1860,1860,1860,1861,2021-10-18 15:00:00+00:00,Anne Arundel,361.0,356006,299.0,329790,25.0,25151,386.0,324.0,354941,381157,685796
1861,1861,1861,1861,1861,1861,1861,1861,1862,2021-10-19 15:00:00+00:00,Anne Arundel,289.0,356295,252.0,330042,15.0,25166,304.0,267.0,355208,381461,686337
1862,1862,1862,1862,1862,1862,1862,1862,1863,2021-10-20 15:00:00+00:00,Anne Arundel,270.0,356565,285.0,330327,28.0,25194,298.0,313.0,355521,381759,686892
1863,1863,1863,1863,1863,1863,1863,1863,1864,2021-10-21 15:00:00+00:00,Anne Arundel,301.0,356866,273.0,330600,30.0,25224,331.0,303.0,355824,382090,687466
1864,1864,1864,1864,1864,1864,1864,1864,1865,2021-10-22 15:00:00+00:00,Anne Arundel,347.0,357213,473.0,331073,22.0,25246,369.0,495.0,356319,382459,688286
1865,1865,1865,1865,1865,1865,1865,1865,1866,2021-10-23 15:00:00+00:00,Anne Arundel,180.0,357393,294.0,331367,11.0,25257,191.0,305.0,356624,382650,688760
1866,1866,1866,1866,1866,1866,1866,1866,1867,2021-10-24 15:00:00+00:00,Anne Arundel,96.0,357489,200.0,331567,6.0,25263,102.0,206.0,356830,382752,689056
1867,1867,1867,1867,1867,1867,1867,1867,1868,2021-10-25 15:00:00+00:00,Anne Arundel,357.0,357846,563.0,332130,16.0,25279,373.0,579.0,357409,383125,689976
1868,1868,1868,1868,1868,1868,1868,1868,1869,2021-10-26 15:00:00+00:00,Anne Arundel,352.0,358198,594.0,332724,24.0,25303,376.0,618.0,358027,383501,690922
1869,1869,1869,1869,1869,1869,1869,1869,1870,2021-10-27 15:00:00+00:00,Anne Arundel,303.0,358501,546.0,333270,59.0,25362,362.0,605.0,358632,383863,691771
1870,1870,1870,1870,1870,1870,1870,1870,1871,2021-10-28 15:00:00+00:00,Anne Arundel,362.0,358863,540.0,333810,36.0,25398,398.0,576.0,359208,384261,692673
1871,1871,1871,1871,1871,1871,1871,1871,1872,2021-10-29 15:00:00+00:00,Anne Arundel,332.0,359195,562.0,334372,37.0,25435,369.0,599.0,359807,384630,693567
1872,1872,1872,1872,1872,1872,1872,1872,1873,2021-10-30 15:00:00+00:00,Anne Arundel,194.0,359389,219.0,334591,8.0,25443,202.0,227.0,360034,384832,693980
1873,1873,1873,1873,1873,1873,1873,1873,1874,2021-10-31 15:00:00+00:00,Anne Arundel,104.0,359493,181.0,334772,11.0,25454,115.0,192.0,360226,384947,694265
1874,1874,1874,1874,1874,1874,1874,1874,1875,2021-11-01 15:00:00+00:00,Anne Arundel,328.0,359821,538.0,335310,36.0,25490,364.0,574.0,360800,385311,695131
1875,1875,1875,1875,1875,1875,1875,1875,1876,2021-11-02 15:00:00+00:00,Anne Arundel,333.0,360154,478.0,335788,37.0,25527,370.0,515.0,361315,385681,695942
1876,1876,1876,1876,1876,1876,1876,1876,1877,2021-11-03 15:00:00+00:00,Anne Arundel,291.0,360445,470.0,336258,55.0,25582,346.0,525.0,361840,386027,696703
1877,1877,1877,1877,1877,1877,1877,1877,1878,2021-11-04 15:00:00+00:00,Anne Arundel,278.0,360723,478.0,336736,40.0,25622,318.0,518.0,362358,386345,697459
1878,1878,1878,1878,1878,1878,1878,1878,1879,2021-11-05 15:00:00+00:00,Anne Arundel,330.0,361053,469.0,337205,27.0,25649,357.0,496.0,362854,386702,698258
1879,1879,1879,1879,1879,1879,1879,1879,1880,2021-11-06 15:00:00+00:00,Anne Arundel,77.0,361130,89.0,337294,6.0,25655,83.0,95.0,362949,386785,698424
1880,1880,1880,1880,1880,1880,1880,1880,1881,2020-12-15 15:00:00+00:00,Calvert,1.0,1,,0,,0,,,0,1,1
1881,1881,1881,1881,1881,1881,1881,1881,1882,2020-12-16 15:00:00+00:00,Calvert,1.0,2,,0,,0,,,0,2,2
1882,1882,1882,1882,1882,1882,1882,1882,1883,2020-12-17 15:00:00+00:00,Calvert,5.0,7,,0,,0,,,0,7,7
1883,1883,1883,1883,1883,1883,1883,1883,1884,2020-12-18 15:00:00+00:00,Calvert,11.0,18,,0,,0,,,0,18,18
1884,1884,1884,1884,1884,1884,1884,1884,1885,2020-12-19 15:00:00+00:00,Calvert,1.0,19,,0,,0,,,0,19,19
1885,1885,1885,1885,1885,1885,1885,1885,1886,2020-12-20 15:00:00+00:00,Calvert,3.0,22,,0,,0,,,0,22,22
1886,1886,1886,1886,1886,1886,1886,1886,1887,2020-12-21 15:00:00+00:00,Calvert,15.0,37,,0,,0,,,0,37,37
1887,1887,1887,1887,1887,1887,1887,1887,1888,2020-12-22 15:00:00+00:00,Calvert,32.0,69,,0,,0,,,0,69,69
1888,1888,1888,1888,1888,1888,1888,1888,1889,2020-12-23 15:00:00+00:00,Calvert,114.0,183,,0,,0,,,0,183,183
1889,1889,1889,1889,1889,1889,1889,1889,1890,2020-12-24 15:00:00+00:00,Calvert,35.0,218,,0,,0,,,0,218,218
1890,1890,1890,1890,1890,1890,1890,1890,1891,2020-12-25 15:00:00+00:00,Calvert,84.0,302,,0,,0,,,0,302,302
1891,1891,1891,1891,1891,1891,1891,1891,1892,2020-12-26 15:00:00+00:00,Calvert,4.0,306,,0,,0,,,0,306,306
1892,1892,1892,1892,1892,1892,1892,1892,1893,2020-12-27 15:00:00+00:00,Calvert,9.0,315,,0,,0,,,0,315,315
1893,1893,1893,1893,1893,1893,1893,1893,1894,2020-12-28 15:00:00+00:00,Calvert,76.0,391,,0,,0,,,0,391,391
1894,1894,1894,1894,1894,1894,1894,1894,1895,2020-12-29 15:00:00+00:00,Calvert,148.0,539,1.0,1,,0,,,1,539,540
1895,1895,1895,1895,1895,1895,1895,1895,1896,2020-12-30 15:00:00+00:00,Calvert,551.0,1090,,1,,0,,,1,1090,1091
1896,1896,1896,1896,1896,1896,1896,1896,1897,2020-12-31 15:00:00+00:00,Calvert,372.0,1462,3.0,4,,0,,,4,1462,1466
1897,1897,1897,1897,1897,1897,1897,1897,1898,2021-01-01 15:00:00+00:00,Calvert,7.0,1469,1.0,5,,0,,,5,1469,1474
1898,1898,1898,1898,1898,1898,1898,1898,1899,2021-01-02 15:00:00+00:00,Calvert,6.0,1475,,5,,0,,,5,1475,1480
1899,1899,1899,1899,1899,1899,1899,1899,1900,2021-01-03 15:00:00+00:00,Calvert,11.0,1486,,5,,0,,,5,1486,1491
1900,1900,1900,1900,1900,1900,1900,1900,1901,2021-01-04 15:00:00+00:00,Calvert,112.0,1598,1.0,6,,0,,,6,1598,1604
1901,1901,1901,1901,1901,1901,1901,1901,1902,2021-01-05 15:00:00+00:00,Calvert,86.0,1684,1.0,7,,0,,,7,1684,1691
1902,1902,1902,1902,1902,1902,1902,1902,1903,2021-01-06 15:00:00+00:00,Calvert,142.0,1826,2.0,9,,0,,,9,1826,1835
1903,1903,1903,1903,1903,1903,1903,1903,1904,2021-01-07 15:00:00+00:00,Calvert,144.0,1970,3.0,12,,0,,,12,1970,1982
1904,1904,1904,1904,1904,1904,1904,1904,1905,2021-01-08 15:00:00+00:00,Calvert,502.0,2472,14.0,26,,0,,,26,2472,2498
1905,1905,1905,1905,1905,1905,1905,1905,1906,2021-01-09 15:00:00+00:00,Calvert,412.0,2884,3.0,29,,0,,,29,2884,2913
1906,1906,1906,1906,1906,1906,1906,1906,1907,2021-01-10 15:00:00+00:00,Calvert,26.0,2910,,29,,0,,,29,2910,2939
1907,1907,1907,1907,1907,1907,1907,1907,1908,2021-01-11 15:00:00+00:00,Calvert,132.0,3042,21.0,50,,0,,,50,3042,3092
1908,1908,1908,1908,1908,1908,1908,1908,1909,2021-01-12 15:00:00+00:00,Calvert,252.0,3294,25.0,75,,0,,,75,3294,3369
1909,1909,1909,1909,1909,1909,1909,1909,1910,2021-01-13 15:00:00+00:00,Calvert,400.0,3694,21.0,96,,0,,,96,3694,3790
1910,1910,1910,1910,1910,1910,1910,1910,1911,2021-01-14 15:00:00+00:00,Calvert,504.0,4198,9.0,105,,0,,,105,4198,4303
1911,1911,1911,1911,1911,1911,1911,1911,1912,2021-01-15 15:00:00+00:00,Calvert,644.0,4842,75.0,180,,0,,,180,4842,5022
1912,1912,1912,1912,1912,1912,1912,1912,1913,2021-01-16 15:00:00+00:00,Calvert,57.0,4899,1.0,181,,0,,,181,4899,5080
1913,1913,1913,1913,1913,1913,1913,1913,1914,2021-01-17 15:00:00+00:00,Calvert,6.0,4905,6.0,187,,0,,,187,4905,5092
1914,1914,1914,1914,1914,1914,1914,1914,1915,2021-01-18 15:00:00+00:00,Calvert,29.0,4934,24.0,211,,0,,,211,4934,5145
1915,1915,1915,1915,1915,1915,1915,1915,1916,2021-01-19 15:00:00+00:00,Calvert,117.0,5051,60.0,271,,0,,,271,5051,5322
1916,1916,1916,1916,1916,1916,1916,1916,1917,2021-07-25 15:00:00+00:00,Carroll,56.0,94174,22.0,88629,2.0,9544,58.0,24.0,98173,103718,182803
1917,1917,1917,1917,1917,1917,1917,1917,1918,2021-07-26 15:00:00+00:00,Carroll,143.0,94317,85.0,88714,16.0,9560,159.0,101.0,98274,103877,183031
1918,1918,1918,1918,1918,1918,1918,1918,1919,2021-07-27 15:00:00+00:00,Carroll,160.0,94477,96.0,88810,20.0,9580,180.0,116.0,98390,104057,183287
1919,1919,1919,1919,1919,1919,1919,1919,1920,2021-07-28 15:00:00+00:00,Carroll,136.0,94613,82.0,88892,17.0,9597,153.0,99.0,98489,104210,183505
1920,1920,1920,1920,1920,1920,1920,1920,1921,2021-07-29 15:00:00+00:00,Carroll,154.0,94767,80.0,88972,14.0,9611,168.0,94.0,98583,104378,183739
1921,1921,1921,1921,1921,1921,1921,1921,1922,2021-07-30 15:00:00+00:00,Carroll,183.0,94950,124.0,89096,26.0,9637,209.0,150.0,98733,104587,184046
1922,1922,1922,1922,1922,1922,1922,1922,1923,2021-07-31 15:00:00+00:00,Carroll,91.0,95041,49.0,89145,4.0,9641,95.0,53.0,98786,104682,184186
1923,1923,1923,1923,1923,1923,1923,1923,1924,2021-08-01 15:00:00+00:00,Carroll,73.0,95114,39.0,89184,7.0,9648,80.0,46.0,98832,104762,184298
1924,1924,1924,1924,1924,1924,1924,1924,1925,2021-08-02 15:00:00+00:00,Carroll,194.0,95308,89.0,89273,11.0,9659,205.0,100.0,98932,104967,184581
1925,1925,1925,1925,1925,1925,1925,1925,1926,2021-08-03 15:00:00+00:00,Carroll,168.0,95476,82.0,89355,16.0,9675,184.0,98.0,99030,105151,184831
1926,1926,1926,1926,1926,1926,1926,1926,1927,2021-08-04 15:00:00+00:00,Carroll,146.0,95622,70.0,89425,11.0,9686,157.0,81.0,99111,105308,185047
1927,1927,1927,1927,1927,1927,1927,1927,1928,2021-08-05 15:00:00+00:00,Carroll,155.0,95777,72.0,89497,13.0,9699,168.0,85.0,99196,105476,185274
1928,1928,1928,1928,1928,1928,1928,1928,1929,2021-08-06 15:00:00+00:00,Carroll,200.0,95977,103.0,89600,25.0,9724,225.0,128.0,99324,105701,185577
1929,1929,1929,1929,1929,1929,1929,1929,1930,2021-08-07 15:00:00+00:00,Carroll,130.0,96107,54.0,89654,7.0,9731,137.0,61.0,99385,105838,185761
1930,1930,1930,1930,1930,1930,1930,1930,1931,2021-08-08 15:00:00+00:00,Carroll,94.0,96201,47.0,89701,1.0,9732,95.0,48.0,99433,105933,185902
1931,1931,1931,1931,1931,1931,1931,1931,1932,2021-08-09 15:00:00+00:00,Carroll,158.0,96359,133.0,89834,15.0,9747,173.0,148.0,99581,106106,186193
1932,1932,1932,1932,1932,1932,1932,1932,1933,2021-08-10 15:00:00+00:00,Carroll,162.0,96521,113.0,89947,18.0,9765,180.0,131.0,99712,106286,186468
1933,1933,1933,1933,1933,1933,1933,1933,1934,2021-08-11 15:00:00+00:00,Carroll,148.0,96669,94.0,90041,17.0,9782,165.0,111.0,99823,106451,186710
1934,1934,1934,1934,1934,1934,1934,1934,1935,2021-08-12 15:00:00+00:00,Carroll,153.0,96822,118.0,90159,13.0,9795,166.0,131.0,99954,106617,186981
1935,1935,1935,1935,1935,1935,1935,1935,1936,2021-08-13 15:00:00+00:00,Carroll,194.0,97016,117.0,90276,22.0,9817,216.0,139.0,100093,106833,187292
1936,1936,1936,1936,1936,1936,1936,1936,1937,2021-08-14 15:00:00+00:00,Carroll,130.0,97146,63.0,90339,10.0,9827,140.0,73.0,100166,106973,187485
1937,1937,1937,1937,1937,1937,1937,1937,1938,2021-08-15 15:00:00+00:00,Carroll,92.0,97238,58.0,90397,2.0,9829,94.0,60.0,100226,107067,187635
1938,1938,1938,1938,1938,1938,1938,1938,1939,2021-08-16 15:00:00+00:00,Carroll,155.0,97393,121.0,90518,13.0,9842,168.0,134.0,100360,107235,187911
1939,1939,1939,1939,1939,1939,1939,1939,1940,2021-08-17 15:00:00+00:00,Carroll,191.0,97584,160.0,90678,21.0,9863,212.0,181.0,100541,107447,188262
1940,1940,1940,1940,1940,1940,1940,1940,1941,2021-08-18 15:00:00+00:00,Carroll,118.0,97702,99.0,90777,14.0,9877,132.0,113.0,100654,107579,188479
1941,1941,1941,1941,1941,1941,1941,1941,1942,2021-08-19 15:00:00+00:00,Carroll,150.0,97852,121.0,90898,14.0,9891,164.0,135.0,100789,107743,188750
1942,1942,1942,1942,1942,1942,1942,1942,1943,2021-08-20 15:00:00+00:00,Carroll,177.0,98029,190.0,91088,18.0,9909,195.0,208.0,100997,107938,189117
1943,1943,1943,1943,1943,1943,1943,1943,1944,2021-08-21 15:00:00+00:00,Carroll,70.0,98099,86.0,91174,4.0,9913,74.0,90.0,101087,108012,189273
1944,1944,1944,1944,1944,1944,1944,1944,1945,2020-12-15 15:00:00+00:00,Cecil,1.0,1,,0,,0,,,0,1,1
1945,1945,1945,1945,1945,1945,1945,1945,1946,2020-12-16 15:00:00+00:00,Cecil,3.0,4,,0,,0,,,0,4,4
1946,1946,1946,1946,1946,1946,1946,1946,1947,2020-12-17 15:00:00+00:00,Cecil,4.0,8,,0,,0,,,0,8,8
1947,1947,1947,1947,1947,1947,1947,1947,1948,2020-12-18 15:00:00+00:00,Cecil,26.0,34,,0,,0,,,0,34,34
1948,1948,1948,1948,1948,1948,1948,1948,1949,2020-12-19 15:00:00+00:00,Cecil,20.0,54,,0,,0,,,0,54,54
1949,1949,1949,1949,1949,1949,1949,1949,1950,2020-12-20 15:00:00+00:00,Cecil,2.0,56,,0,,0,,,0,56,56
1950,1950,1950,1950,1950,1950,1950,1950,1951,2020-12-21 15:00:00+00:00,Cecil,53.0,109,1.0,1,,0,,,1,109,110
1951,1951,1951,1951,1951,1951,1951,1951,1952,2020-12-22 15:00:00+00:00,Cecil,115.0,224,2.0,3,,0,,,3,224,227
1952,1952,1952,1952,1952,1952,1952,1952,1953,2020-12-23 15:00:00+00:00,Cecil,102.0,326,2.0,5,,0,,,5,326,331
1953,1953,1953,1953,1953,1953,1953,1953,1954,2020-12-24 15:00:00+00:00,Cecil,34.0,360,,5,,0,,,5,360,365
1954,1954,1954,1954,1954,1954,1954,1954,1955,2020-12-25 15:00:00+00:00,Cecil,6.0,366,,5,,0,,,5,366,371
1955,1955,1955,1955,1955,1955,1955,1955,1956,2020-12-26 15:00:00+00:00,Cecil,43.0,409,1.0,6,,0,,,6,409,415
1956,1956,1956,1956,1956,1956,1956,1956,1957,2020-12-27 15:00:00+00:00,Cecil,25.0,434,,6,,0,,,6,434,440
1957,1957,1957,1957,1957,1957,1957,1957,1958,2020-12-28 15:00:00+00:00,Cecil,130.0,564,1.0,7,,0,,,7,564,571
1958,1958,1958,1958,1958,1958,1958,1958,1959,2020-12-29 15:00:00+00:00,Cecil,153.0,717,2.0,9,,0,,,9,717,726
1959,1959,1959,1959,1959,1959,1959,1959,1960,2020-12-30 15:00:00+00:00,Cecil,215.0,932,1.0,10,,0,,,10,932,942
1960,1960,1960,1960,1960,1960,1960,1960,1961,2020-12-31 15:00:00+00:00,Cecil,158.0,1090,2.0,12,,0,,,12,1090,1102
1961,1961,1961,1961,1961,1961,1961,1961,1962,2021-01-01 15:00:00+00:00,Cecil,68.0,1158,4.0,16,,0,,,16,1158,1174
1962,1962,1962,1962,1962,1962,1962,1962,1963,2021-01-02 15:00:00+00:00,Cecil,69.0,1227,,16,,0,,,16,1227,1243
1963,1963,1963,1963,1963,1963,1963,1963,1964,2021-01-03 15:00:00+00:00,Cecil,5.0,1232,,16,,0,,,16,1232,1248
1964,1964,1964,1964,1964,1964,1964,1964,1965,2021-01-04 15:00:00+00:00,Cecil,116.0,1348,,16,,0,,,16,1348,1364
1965,1965,1965,1965,1965,1965,1965,1965,1966,2021-01-05 15:00:00+00:00,Cecil,295.0,1643,6.0,22,,0,,,22,1643,1665
1966,1966,1966,1966,1966,1966,1966,1966,1967,2021-01-06 15:00:00+00:00,Cecil,214.0,1857,4.0,26,,0,,,26,1857,1883
1967,1967,1967,1967,1967,1967,1967,1967,1968,2021-01-07 15:00:00+00:00,Cecil,321.0,2178,14.0,40,,0,,,40,2178,2218
1968,1968,1968,1968,1968,1968,1968,1968,1969,2021-01-08 15:00:00+00:00,Cecil,130.0,2308,31.0,71,,0,,,71,2308,2379
1969,1969,1969,1969,1969,1969,1969,1969,1970,2021-01-09 15:00:00+00:00,Cecil,42.0,2350,17.0,88,,0,,,88,2350,2438
1970,1970,1970,1970,1970,1970,1970,1970,1971,2021-01-10 15:00:00+00:00,Cecil,4.0,2354,,88,,0,,,88,2354,2442
1971,1971,1971,1971,1971,1971,1971,1971,1972,2021-01-11 15:00:00+00:00,Cecil,143.0,2497,43.0,131,,0,,,131,2497,2628
1972,1972,1972,1972,1972,1972,1972,1972,1973,2021-01-12 15:00:00+00:00,Cecil,211.0,2708,55.0,186,,0,,,186,2708,2894
1973,1973,1973,1973,1973,1973,1973,1973,1974,2021-01-13 15:00:00+00:00,Cecil,517.0,3225,34.0,220,,0,,,220,3225,3445
1974,1974,1974,1974,1974,1974,1974,1974,1975,2021-01-14 15:00:00+00:00,Cecil,291.0,3516,8.0,228,,0,,,228,3516,3744
1975,1975,1975,1975,1975,1975,1975,1975,1976,2021-01-15 15:00:00+00:00,Cecil,371.0,3887,12.0,240,,0,,,240,3887,4127
1976,1976,1976,1976,1976,1976,1976,1976,1977,2021-01-16 15:00:00+00:00,Cecil,51.0,3938,4.0,244,,0,,,244,3938,4182
1977,1977,1977,1977,1977,1977,1977,1977,1978,2021-01-17 15:00:00+00:00,Cecil,78.0,4016,21.0,265,,0,,,265,4016,4281
1978,1978,1978,1978,1978,1978,1978,1978,1979,2021-01-18 15:00:00+00:00,Cecil,73.0,4089,48.0,313,,0,,,313,4089,4402
1979,1979,1979,1979,1979,1979,1979,1979,1980,2021-01-19 15:00:00+00:00,Cecil,435.0,4524,54.0,367,,0,,,367,4524,4891
1980,1980,1980,1980,1980,1980,1980,1980,1981,2021-01-20 15:00:00+00:00,Cecil,363.0,4887,88.0,455,,0,,,455,4887,5342
1981,1981,1981,1981,1981,1981,1981,1981,1982,2021-01-21 15:00:00+00:00,Cecil,685.0,5572,62.0,517,,0,,,517,5572,6089
1982,1982,1982,1982,1982,1982,1982,1982,1983,2021-01-22 15:00:00+00:00,Cecil,434.0,6006,58.0,575,,0,,,575,6006,6581
1983,1983,1983,1983,1983,1983,1983,1983,1984,2021-01-23 15:00:00+00:00,Cecil,126.0,6132,29.0,604,,0,,,604,6132,6736
1984,1984,1984,1984,1984,1984,1984,1984,1985,2021-01-24 15:00:00+00:00,Cecil,33.0,6165,2.0,606,,0,,,606,6165,6771
1985,1985,1985,1985,1985,1985,1985,1985,1986,2021-01-25 15:00:00+00:00,Cecil,305.0,6470,107.0,713,,0,,,713,6470,7183
1986,1986,1986,1986,1986,1986,1986,1986,1987,2021-01-26 15:00:00+00:00,Cecil,599.0,7069,332.0,1045,,0,,,1045,7069,8114
1987,1987,1987,1987,1987,1987,1987,1987,1988,2021-01-27 15:00:00+00:00,Cecil,361.0,7430,113.0,1158,,0,,,1158,7430,8588
1988,1988,1988,1988,1988,1988,1988,1988,1989,2021-01-28 15:00:00+00:00,Cecil,602.0,8032,157.0,1315,,0,,,1315,8032,9347
1989,1989,1989,1989,1989,1989,1989,1989,1990,2021-01-29 15:00:00+00:00,Cecil,477.0,8509,82.0,1397,,0,,,1397,8509,9906
1990,1990,1990,1990,1990,1990,1990,1990,1991,2021-01-30 15:00:00+00:00,Cecil,354.0,8863,60.0,1457,,0,,,1457,8863,10320
1991,1991,1991,1991,1991,1991,1991,1991,1992,2021-01-31 15:00:00+00:00,Cecil,16.0,8879,2.0,1459,,0,,,1459,8879,10338
1992,1992,1992,1992,1992,1992,1992,1992,1993,2021-02-01 15:00:00+00:00,Cecil,46.0,8925,54.0,1513,,0,,,1513,8925,10438
1993,1993,1993,1993,1993,1993,1993,1993,1994,2021-02-02 15:00:00+00:00,Cecil,43.0,8968,165.0,1678,,0,,,1678,8968,10646
1994,1994,1994,1994,1994,1994,1994,1994,1995,2021-02-03 15:00:00+00:00,Cecil,111.0,9079,171.0,1849,,0,,,1849,9079,10928
1995,1995,1995,1995,1995,1995,1995,1995,1996,2021-02-04 15:00:00+00:00,Cecil,83.0,9162,374.0,2223,,0,,,2223,9162,11385
1996,1996,1996,1996,1996,1996,1996,1996,1997,2021-02-05 15:00:00+00:00,Cecil,346.0,9508,102.0,2325,,0,,,2325,9508,11833
1997,1997,1997,1997,1997,1997,1997,1997,1998,2021-02-06 15:00:00+00:00,Cecil,320.0,9828,57.0,2382,,0,,,2382,9828,12210
1998,1998,1998,1998,1998,1998,1998,1998,1999,2021-02-07 15:00:00+00:00,Cecil,16.0,9844,47.0,2429,,0,,,2429,9844,12273
1999,1999,1999,1999,1999,1999,1999,1999,2000,2021-02-08 15:00:00+00:00,Cecil,40.0,9884,112.0,2541,,0,,,2541,9884,12425
2000,2000,2000,2000,2000,2000,2000,2000,2001,2021-02-09 15:00:00+00:00,Cecil,446.0,10330,228.0,2769,,0,,,2769,10330,13099
2001,2001,2001,2001,2001,2001,2001,2001,2002,2021-02-10 15:00:00+00:00,Cecil,339.0,10669,489.0,3258,,0,,,3258,10669,13927
2002,2002,2002,2002,2002,2002,2002,2002,2003,2021-02-11 15:00:00+00:00,Cecil,183.0,10852,234.0,3492,,0,,,3492,10852,14344
2003,2003,2003,2003,2003,2003,2003,2003,2004,2021-02-12 15:00:00+00:00,Cecil,88.0,10940,374.0,3866,,0,,,3866,10940,14806
2004,2004,2004,2004,2004,2004,2004,2004,2005,2021-02-13 15:00:00+00:00,Cecil,281.0,11221,34.0,3900,,0,,,3900,11221,15121
2005,2005,2005,2005,2005,2005,2005,2005,2006,2021-02-14 15:00:00+00:00,Cecil,6.0,11227,3.0,3903,,0,,,3903,11227,15130
2006,2006,2006,2006,2006,2006,2006,2006,2007,2021-02-15 15:00:00+00:00,Cecil,248.0,11475,89.0,3992,,0,,,3992,11475,15467
2007,2007,2007,2007,2007,2007,2007,2007,2008,2021-02-16 15:00:00+00:00,Cecil,239.0,11714,517.0,4509,,0,,,4509,11714,16223
2008,2008,2008,2008,2008,2008,2008,2008,2009,2021-02-17 15:00:00+00:00,Cecil,200.0,11914,416.0,4925,,0,,,4925,11914,16839
2009,2009,2009,2009,2009,2009,2009,2009,2010,2021-02-18 15:00:00+00:00,Cecil,16.0,11930,20.0,4945,,0,,,4945,11930,16875
2010,2010,2010,2010,2010,2010,2010,2010,2011,2021-02-19 15:00:00+00:00,Cecil,92.0,12022,547.0,5492,,0,,,5492,12022,17514
2011,2011,2011,2011,2011,2011,2011,2011,2012,2021-02-20 15:00:00+00:00,Cecil,207.0,12229,284.0,5776,,0,,,5776,12229,18005
2012,2012,2012,2012,2012,2012,2012,2012,2013,2021-02-21 15:00:00+00:00,Cecil,14.0,12243,342.0,6118,,0,,,6118,12243,18361
2013,2013,2013,2013,2013,2013,2013,2013,2014,2021-02-22 15:00:00+00:00,Cecil,124.0,12367,59.0,6177,,0,,,6177,12367,18544
2014,2014,2014,2014,2014,2014,2014,2014,2015,2021-02-23 15:00:00+00:00,Cecil,70.0,12437,832.0,7009,,0,,,7009,12437,19446
2015,2015,2015,2015,2015,2015,2015,2015,2016,2021-02-24 15:00:00+00:00,Cecil,144.0,12581,430.0,7439,,0,,,7439,12581,20020
2016,2016,2016,2016,2016,2016,2016,2016,2017,2021-02-25 15:00:00+00:00,Cecil,182.0,12763,630.0,8069,,0,,,8069,12763,20832
2017,2017,2017,2017,2017,2017,2017,2017,2018,2021-02-26 15:00:00+00:00,Cecil,550.0,13313,312.0,8381,,0,,,8381,13313,21694
2018,2018,2018,2018,2018,2018,2018,2018,2019,2021-02-27 15:00:00+00:00,Cecil,234.0,13547,182.0,8563,,0,,,8563,13547,22110
2019,2019,2019,2019,2019,2019,2019,2019,2020,2021-02-28 15:00:00+00:00,Cecil,45.0,13592,13.0,8576,,0,,,8576,13592,22168
2020,2020,2020,2020,2020,2020,2020,2020,2021,2021-03-01 15:00:00+00:00,Cecil,485.0,14077,42.0,8618,,0,,,8618,14077,22695
2021,2021,2021,2021,2021,2021,2021,2021,2022,2021-03-02 15:00:00+00:00,Cecil,407.0,14484,74.0,8692,,0,,,8692,14484,23176
2022,2022,2022,2022,2022,2022,2022,2022,2023,2021-03-03 15:00:00+00:00,Cecil,127.0,14611,53.0,8745,3.0,3,130.0,56.0,8748,14614,23356
2023,2023,2023,2023,2023,2023,2023,2023,2024,2021-03-04 15:00:00+00:00,Cecil,624.0,15235,96.0,8841,5.0,8,629.0,101.0,8849,15243,24076
2024,2024,2024,2024,2024,2024,2024,2024,2025,2021-03-05 15:00:00+00:00,Cecil,483.0,15718,313.0,9154,2.0,10,485.0,315.0,9164,15728,24872
2025,2025,2025,2025,2025,2025,2025,2025,2026,2021-03-06 15:00:00+00:00,Cecil,177.0,15895,291.0,9445,8.0,18,185.0,299.0,9463,15913,25340
2026,2026,2026,2026,2026,2026,2026,2026,2027,2021-03-07 15:00:00+00:00,Cecil,63.0,15958,9.0,9454,16.0,34,79.0,25.0,9488,15992,25412
2027,2027,2027,2027,2027,2027,2027,2027,2028,2021-03-08 15:00:00+00:00,Cecil,368.0,16326,40.0,9494,33.0,67,401.0,73.0,9561,16393,25820
2028,2028,2028,2028,2028,2028,2028,2028,2029,2021-03-09 15:00:00+00:00,Cecil,272.0,16598,467.0,9961,23.0,90,295.0,490.0,10051,16688,26559
2029,2029,2029,2029,2029,2029,2029,2029,2030,2021-03-10 15:00:00+00:00,Cecil,584.0,17182,259.0,10220,9.0,99,593.0,268.0,10319,17281,27402
2030,2030,2030,2030,2030,2030,2030,2030,2031,2021-03-11 15:00:00+00:00,Cecil,892.0,18074,166.0,10386,1.0,100,893.0,167.0,10486,18174,28460
2031,2031,2031,2031,2031,2031,2031,2031,2032,2021-03-12 15:00:00+00:00,Cecil,858.0,18932,191.0,10577,2.0,102,860.0,193.0,10679,19034,29509
2032,2032,2032,2032,2032,2032,2032,2032,2033,2021-03-13 15:00:00+00:00,Cecil,163.0,19095,278.0,10855,1.0,103,164.0,279.0,10958,19198,29950
2033,2033,2033,2033,2033,2033,2033,2033,2034,2021-03-14 15:00:00+00:00,Cecil,100.0,19195,9.0,10864,4.0,107,104.0,13.0,10971,19302,30059
2034,2034,2034,2034,2034,2034,2034,2034,2035,2021-03-15 15:00:00+00:00,Cecil,121.0,19316,227.0,11091,2.0,109,123.0,229.0,11200,19425,30407
2035,2035,2035,2035,2035,2035,2035,2035,2036,2021-03-16 15:00:00+00:00,Cecil,482.0,19798,275.0,11366,1.0,110,483.0,276.0,11476,19908,31164
2036,2036,2036,2036,2036,2036,2036,2036,2037,2021-03-17 15:00:00+00:00,Cecil,403.0,20201,179.0,11545,27.0,137,430.0,206.0,11682,20338,31746
2037,2037,2037,2037,2037,2037,2037,2037,2038,2021-03-18 15:00:00+00:00,Cecil,696.0,20897,36.0,11581,4.0,141,700.0,40.0,11722,21038,32478
2038,2038,2038,2038,2038,2038,2038,2038,2039,2021-03-19 15:00:00+00:00,Cecil,677.0,21574,46.0,11627,4.0,145,681.0,50.0,11772,21719,33201
2039,2039,2039,2039,2039,2039,2039,2039,2040,2021-03-20 15:00:00+00:00,Cecil,308.0,21882,219.0,11846,1.0,146,309.0,220.0,11992,22028,33728
2040,2040,2040,2040,2040,2040,2040,2040,2041,2021-03-21 15:00:00+00:00,Cecil,123.0,22005,11.0,11857,4.0,150,127.0,15.0,12007,22155,33862
2041,2041,2041,2041,2041,2041,2041,2041,2042,2021-03-22 15:00:00+00:00,Cecil,288.0,22293,120.0,11977,3.0,153,291.0,123.0,12130,22446,34270
2042,2042,2042,2042,2042,2042,2042,2042,2043,2021-03-23 15:00:00+00:00,Cecil,351.0,22644,89.0,12066,4.0,157,355.0,93.0,12223,22801,34710
2043,2043,2043,2043,2043,2043,2043,2043,2044,2021-03-24 15:00:00+00:00,Cecil,294.0,22938,130.0,12196,2.0,159,296.0,132.0,12355,23097,35134
2044,2044,2044,2044,2044,2044,2044,2044,2045,2021-03-25 15:00:00+00:00,Cecil,309.0,23247,180.0,12376,13.0,172,322.0,193.0,12548,23419,35623
2045,2045,2045,2045,2045,2045,2045,2045,2046,2021-03-26 15:00:00+00:00,Cecil,193.0,23440,537.0,12913,6.0,178,199.0,543.0,13091,23618,36353
2046,2046,2046,2046,2046,2046,2046,2046,2047,2021-03-27 15:00:00+00:00,Cecil,227.0,23667,208.0,13121,49.0,227,276.0,257.0,13348,23894,36788
2047,2047,2047,2047,2047,2047,2047,2047,2048,2021-03-28 15:00:00+00:00,Cecil,112.0,23779,36.0,13157,6.0,233,118.0,42.0,13390,24012,36936
2048,2048,2048,2048,2048,2048,2048,2048,2049,2021-03-29 15:00:00+00:00,Cecil,95.0,23874,423.0,13580,5.0,238,100.0,428.0,13818,24112,37454
2049,2049,2049,2049,2049,2049,2049,2049,2050,2021-03-30 15:00:00+00:00,Cecil,746.0,24620,255.0,13835,3.0,241,749.0,258.0,14076,24861,38455
2050,2050,2050,2050,2050,2050,2050,2050,2051,2021-03-31 15:00:00+00:00,Cecil,518.0,25138,549.0,14384,237.0,478,755.0,786.0,14862,25616,39522
2051,2051,2051,2051,2051,2051,2051,2051,2052,2021-04-01 15:00:00+00:00,Cecil,282.0,25420,864.0,15248,38.0,516,320.0,902.0,15764,25936,40668
2052,2052,2052,2052,2052,2052,2052,2052,2053,2021-04-02 15:00:00+00:00,Cecil,472.0,25892,599.0,15847,182.0,698,654.0,781.0,16545,26590,41739
2053,2053,2053,2053,2053,2053,2053,2053,2054,2021-04-03 15:00:00+00:00,Cecil,56.0,25948,169.0,16016,26.0,724,82.0,195.0,16740,26672,41964
2054,2054,2054,2054,2054,2054,2054,2054,2055,2021-04-04 15:00:00+00:00,Cecil,63.0,26011,50.0,16066,10.0,734,73.0,60.0,16800,26745,42077
2055,2055,2055,2055,2055,2055,2055,2055,2056,2021-04-05 15:00:00+00:00,Cecil,122.0,26133,342.0,16408,76.0,810,198.0,418.0,17218,26943,42541
2056,2056,2056,2056,2056,2056,2056,2056,2057,2021-04-06 15:00:00+00:00,Cecil,417.0,26550,777.0,17185,308.0,1118,725.0,1085.0,18303,27668,43735
2057,2057,2057,2057,2057,2057,2057,2057,2058,2021-04-07 15:00:00+00:00,Cecil,219.0,26769,302.0,17487,433.0,1551,652.0,735.0,19038,28320,44256
2058,2058,2058,2058,2058,2058,2058,2058,2059,2021-04-08 15:00:00+00:00,Cecil,318.0,27087,981.0,18468,107.0,1658,425.0,1088.0,20126,28745,45555
2059,2059,2059,2059,2059,2059,2059,2059,2060,2021-04-09 15:00:00+00:00,Cecil,189.0,27276,855.0,19323,93.0,1751,282.0,948.0,21074,29027,46599
2060,2060,2060,2060,2060,2060,2060,2060,2061,2021-04-10 15:00:00+00:00,Cecil,562.0,27838,184.0,19507,61.0,1812,623.0,245.0,21319,29650,47345
2061,2061,2061,2061,2061,2061,2061,2061,2062,2021-04-11 15:00:00+00:00,Cecil,130.0,27968,61.0,19568,45.0,1857,175.0,106.0,21425,29825,47536
2062,2062,2062,2062,2062,2062,2062,2062,2063,2021-04-12 15:00:00+00:00,Cecil,350.0,28318,301.0,19869,175.0,2032,525.0,476.0,21901,30350,48187
2063,2063,2063,2063,2063,2063,2063,2063,2064,2021-04-13 15:00:00+00:00,Cecil,517.0,28835,509.0,20378,5.0,2037,522.0,514.0,22415,30872,49213
2064,2064,2064,2064,2064,2064,2064,2064,2065,2021-04-14 15:00:00+00:00,Cecil,566.0,29401,152.0,20530,,2037,,,22567,31438,49931
2065,2065,2065,2065,2065,2065,2065,2065,2066,2021-04-15 15:00:00+00:00,Cecil,659.0,30060,384.0,20914,1.0,2038,660.0,385.0,22952,32098,50974
2066,2066,2066,2066,2066,2066,2066,2066,2067,2021-04-16 15:00:00+00:00,Cecil,248.0,30308,352.0,21266,,2038,,,23304,32346,51574
2067,2067,2067,2067,2067,2067,2067,2067,2068,2021-04-17 15:00:00+00:00,Cecil,366.0,30674,95.0,21361,,2038,,,23399,32712,52035
2068,2068,2068,2068,2068,2068,2068,2068,2069,2021-04-18 15:00:00+00:00,Cecil,67.0,30741,63.0,21424,,2038,,,23462,32779,52165
2069,2069,2069,2069,2069,2069,2069,2069,2070,2021-04-19 15:00:00+00:00,Cecil,350.0,31091,448.0,21872,,2038,,,23910,33129,52963
2070,2070,2070,2070,2070,2070,2070,2070,2071,2021-04-20 15:00:00+00:00,Cecil,708.0,31799,361.0,22233,,2038,,,24271,33837,54032
2071,2071,2071,2071,2071,2071,2071,2071,2072,2021-04-21 15:00:00+00:00,Cecil,431.0,32230,566.0,22799,,2038,,,24837,34268,55029
2072,2072,2072,2072,2072,2072,2072,2072,2073,2021-04-22 15:00:00+00:00,Cecil,371.0,32601,353.0,23152,,2038,,,25190,34639,55753
2073,2073,2073,2073,2073,2073,2073,2073,2074,2021-04-23 15:00:00+00:00,Cecil,484.0,33085,244.0,23396,,2038,,,25434,35123,56481
2074,2074,2074,2074,2074,2074,2074,2074,2075,2021-04-24 15:00:00+00:00,Cecil,333.0,33418,211.0,23607,,2038,,,25645,35456,57025
2075,2075,2075,2075,2075,2075,2075,2075,2076,2021-04-25 15:00:00+00:00,Cecil,43.0,33461,74.0,23681,2.0,2040,45.0,76.0,25721,35501,57142
2076,2076,2076,2076,2076,2076,2076,2076,2077,2021-04-26 15:00:00+00:00,Cecil,173.0,33634,107.0,23788,,2040,,,25828,35674,57422
2077,2077,2077,2077,2077,2077,2077,2077,2078,2021-04-27 15:00:00+00:00,Cecil,314.0,33948,407.0,24195,7.0,2047,321.0,414.0,26242,35995,58143
2078,2078,2078,2078,2078,2078,2078,2078,2079,2021-04-28 15:00:00+00:00,Cecil,226.0,34174,243.0,24438,10.0,2057,236.0,253.0,26495,36231,58612
2079,2079,2079,2079,2079,2079,2079,2079,2080,2021-04-29 15:00:00+00:00,Cecil,276.0,34450,210.0,24648,13.0,2070,289.0,223.0,26718,36520,59098
2080,2080,2080,2080,2080,2080,2080,2080,2081,2021-04-30 15:00:00+00:00,Cecil,192.0,34642,133.0,24781,50.0,2120,242.0,183.0,26901,36762,59423
2081,2081,2081,2081,2081,2081,2081,2081,2082,2021-05-01 15:00:00+00:00,Cecil,90.0,34732,89.0,24870,8.0,2128,98.0,97.0,26998,36860,59602
2082,2082,2082,2082,2082,2082,2082,2082,2083,2021-05-02 15:00:00+00:00,Cecil,36.0,34768,54.0,24924,14.0,2142,50.0,68.0,27066,36910,59692
2083,2083,2083,2083,2083,2083,2083,2083,2084,2021-05-03 15:00:00+00:00,Cecil,188.0,34956,427.0,25351,11.0,2153,199.0,438.0,27504,37109,60307
2084,2084,2084,2084,2084,2084,2084,2084,2085,2021-05-04 15:00:00+00:00,Cecil,366.0,35322,398.0,25749,7.0,2160,373.0,405.0,27909,37482,61071
2085,2085,2085,2085,2085,2085,2085,2085,2086,2021-05-05 15:00:00+00:00,Cecil,179.0,35501,566.0,26315,16.0,2176,195.0,582.0,28491,37677,61816
2086,2086,2086,2086,2086,2086,2086,2086,2087,2021-05-06 15:00:00+00:00,Cecil,195.0,35696,645.0,26960,11.0,2187,206.0,656.0,29147,37883,62656
2087,2087,2087,2087,2087,2087,2087,2087,2088,2021-05-07 15:00:00+00:00,Cecil,306.0,36002,180.0,27140,13.0,2200,319.0,193.0,29340,38202,63142
2088,2088,2088,2088,2088,2088,2088,2088,2089,2021-05-08 15:00:00+00:00,Cecil,66.0,36068,453.0,27593,20.0,2220,86.0,473.0,29813,38288,63661
2089,2089,2089,2089,2089,2089,2089,2089,2090,2021-05-09 15:00:00+00:00,Cecil,15.0,36083,59.0,27652,5.0,2225,20.0,64.0,29877,38308,63735
2090,2090,2090,2090,2090,2090,2090,2090,2091,2021-05-10 15:00:00+00:00,Cecil,71.0,36154,396.0,28048,13.0,2238,84.0,409.0,30286,38392,64202
2091,2091,2091,2091,2091,2091,2091,2091,2092,2021-05-11 15:00:00+00:00,Cecil,151.0,36305,423.0,28471,38.0,2276,189.0,461.0,30747,38581,64776
2092,2092,2092,2092,2092,2092,2092,2092,2093,2021-05-12 15:00:00+00:00,Cecil,140.0,36445,218.0,28689,52.0,2328,192.0,270.0,31017,38773,65134
2093,2093,2093,2093,2093,2093,2093,2093,2094,2021-05-13 15:00:00+00:00,Cecil,269.0,36714,549.0,29238,19.0,2347,288.0,568.0,31585,39061,65952
2094,2094,2094,2094,2094,2094,2094,2094,2095,2021-05-14 15:00:00+00:00,Cecil,145.0,36859,272.0,29510,18.0,2365,163.0,290.0,31875,39224,66369
2095,2095,2095,2095,2095,2095,2095,2095,2096,2021-05-15 15:00:00+00:00,Cecil,118.0,36977,472.0,29982,12.0,2377,130.0,484.0,32359,39354,66959
2096,2096,2096,2096,2096,2096,2096,2096,2097,2021-05-16 15:00:00+00:00,Cecil,28.0,37005,55.0,30037,26.0,2403,54.0,81.0,32440,39408,67042
2097,2097,2097,2097,2097,2097,2097,2097,2098,2021-05-17 15:00:00+00:00,Cecil,354.0,37359,170.0,30207,58.0,2461,412.0,228.0,32668,39820,67566
2098,2098,2098,2098,2098,2098,2098,2098,2099,2021-05-18 15:00:00+00:00,Cecil,565.0,37924,858.0,31065,40.0,2501,605.0,898.0,33566,40425,68989
2099,2099,2099,2099,2099,2099,2099,2099,2100,2021-05-19 15:00:00+00:00,Cecil,384.0,38308,370.0,31435,62.0,2563,446.0,432.0,33998,40871,69743
2100,2100,2100,2100,2100,2100,2100,2100,2101,2021-05-20 15:00:00+00:00,Cecil,467.0,38775,349.0,31784,22.0,2585,489.0,371.0,34369,41360,70559
2101,2101,2101,2101,2101,2101,2101,2101,2102,2021-05-21 15:00:00+00:00,Cecil,137.0,38912,246.0,32030,19.0,2604,156.0,265.0,34634,41516,70942
2102,2102,2102,2102,2102,2102,2102,2102,2103,2021-05-22 15:00:00+00:00,Cecil,78.0,38990,139.0,32169,41.0,2645,119.0,180.0,34814,41635,71159
2103,2103,2103,2103,2103,2103,2103,2103,2104,2021-05-23 15:00:00+00:00,Cecil,57.0,39047,62.0,32231,39.0,2684,96.0,101.0,34915,41731,71278
2104,2104,2104,2104,2104,2104,2104,2104,2105,2021-05-24 15:00:00+00:00,Cecil,87.0,39134,119.0,32350,37.0,2721,124.0,156.0,35071,41855,71484
2105,2105,2105,2105,2105,2105,2105,2105,2106,2021-05-25 15:00:00+00:00,Cecil,184.0,39318,409.0,32759,17.0,2738,201.0,426.0,35497,42056,72077
2106,2106,2106,2106,2106,2106,2106,2106,2107,2021-05-26 15:00:00+00:00,Cecil,123.0,39441,225.0,32984,59.0,2797,182.0,284.0,35781,42238,72425
2107,2107,2107,2107,2107,2107,2107,2107,2108,2021-05-27 15:00:00+00:00,Cecil,138.0,39579,345.0,33329,25.0,2822,163.0,370.0,36151,42401,72908
2108,2108,2108,2108,2108,2108,2108,2108,2109,2021-05-28 15:00:00+00:00,Cecil,111.0,39690,160.0,33489,22.0,2844,133.0,182.0,36333,42534,73179
2109,2109,2109,2109,2109,2109,2109,2109,2110,2021-05-29 15:00:00+00:00,Cecil,78.0,39768,70.0,33559,7.0,2851,85.0,77.0,36410,42619,73327
2110,2110,2110,2110,2110,2110,2110,2110,2111,2021-05-30 15:00:00+00:00,Cecil,31.0,39799,25.0,33584,3.0,2854,34.0,28.0,36438,42653,73383
2111,2111,2111,2111,2111,2111,2111,2111,2112,2021-05-31 15:00:00+00:00,Cecil,19.0,39818,52.0,33636,,2854,,,36490,42672,73454
2112,2112,2112,2112,2112,2112,2112,2112,2113,2021-06-01 15:00:00+00:00,Cecil,101.0,39919,146.0,33782,9.0,2863,110.0,155.0,36645,42782,73701
2113,2113,2113,2113,2113,2113,2113,2113,2114,2021-06-02 15:00:00+00:00,Cecil,74.0,39993,204.0,33986,23.0,2886,97.0,227.0,36872,42879,73979
2114,2114,2114,2114,2114,2114,2114,2114,2115,2021-06-03 15:00:00+00:00,Cecil,92.0,40085,232.0,34218,28.0,2914,120.0,260.0,37132,42999,74303
2115,2115,2115,2115,2115,2115,2115,2115,2116,2021-06-04 15:00:00+00:00,Cecil,84.0,40169,279.0,34497,28.0,2942,112.0,307.0,37439,43111,74666
2116,2116,2116,2116,2116,2116,2116,2116,2117,2021-06-05 15:00:00+00:00,Cecil,57.0,40226,71.0,34568,20.0,2962,77.0,91.0,37530,43188,74794
2117,2117,2117,2117,2117,2117,2117,2117,2118,2021-06-06 15:00:00+00:00,Cecil,21.0,40247,17.0,34585,5.0,2967,26.0,22.0,37552,43214,74832
2118,2118,2118,2118,2118,2118,2118,2118,2119,2021-06-07 15:00:00+00:00,Cecil,58.0,40305,376.0,34961,13.0,2980,71.0,389.0,37941,43285,75266
2119,2119,2119,2119,2119,2119,2119,2119,2120,2021-06-08 15:00:00+00:00,Cecil,51.0,40356,291.0,35252,8.0,2988,59.0,299.0,38240,43344,75608
2120,2120,2120,2120,2120,2120,2120,2120,2121,2021-06-09 15:00:00+00:00,Cecil,82.0,40438,434.0,35686,26.0,3014,108.0,460.0,38700,43452,76124
2121,2121,2121,2121,2121,2121,2121,2121,2122,2021-06-10 15:00:00+00:00,Cecil,82.0,40520,517.0,36203,15.0,3029,97.0,532.0,39232,43549,76723
2122,2122,2122,2122,2122,2122,2122,2122,2123,2021-06-11 15:00:00+00:00,Cecil,53.0,40573,145.0,36348,21.0,3050,74.0,166.0,39398,43623,76921
2123,2123,2123,2123,2123,2123,2123,2123,2124,2021-06-12 15:00:00+00:00,Cecil,43.0,40616,117.0,36465,14.0,3064,57.0,131.0,39529,43680,77081
2124,2124,2124,2124,2124,2124,2124,2124,2125,2021-06-13 15:00:00+00:00,Cecil,13.0,40629,26.0,36491,1.0,3065,14.0,27.0,39556,43694,77120
2125,2125,2125,2125,2125,2125,2125,2125,2126,2021-06-14 15:00:00+00:00,Cecil,30.0,40659,63.0,36554,20.0,3085,50.0,83.0,39639,43744,77213
2126,2126,2126,2126,2126,2126,2126,2126,2127,2021-06-15 15:00:00+00:00,Cecil,35.0,40694,112.0,36666,11.0,3096,46.0,123.0,39762,43790,77360
2127,2127,2127,2127,2127,2127,2127,2127,2128,2021-06-16 15:00:00+00:00,Cecil,57.0,40751,229.0,36895,14.0,3110,71.0,243.0,40005,43861,77646
2128,2128,2128,2128,2128,2128,2128,2128,2129,2021-06-17 15:00:00+00:00,Cecil,60.0,40811,193.0,37088,15.0,3125,75.0,208.0,40213,43936,77899
2129,2129,2129,2129,2129,2129,2129,2129,2130,2021-06-18 15:00:00+00:00,Cecil,64.0,40875,104.0,37192,6.0,3131,70.0,110.0,40323,44006,78067
2130,2130,2130,2130,2130,2130,2130,2130,2131,2021-06-19 15:00:00+00:00,Cecil,12.0,40887,62.0,37254,7.0,3138,19.0,69.0,40392,44025,78141
2131,2131,2131,2131,2131,2131,2131,2131,2132,2021-06-20 15:00:00+00:00,Cecil,9.0,40896,32.0,37286,2.0,3140,11.0,34.0,40426,44036,78182
2132,2132,2132,2132,2132,2132,2132,2132,2133,2021-06-21 15:00:00+00:00,Cecil,37.0,40933,49.0,37335,4.0,3144,41.0,53.0,40479,44077,78268
2133,2133,2133,2133,2133,2133,2133,2133,2134,2021-06-22 15:00:00+00:00,Cecil,43.0,40976,100.0,37435,6.0,3150,49.0,106.0,40585,44126,78411
2134,2134,2134,2134,2134,2134,2134,2134,2135,2021-06-23 15:00:00+00:00,Cecil,48.0,41024,91.0,37526,4.0,3154,52.0,95.0,40680,44178,78550
2135,2135,2135,2135,2135,2135,2135,2135,2136,2021-06-24 15:00:00+00:00,Cecil,59.0,41083,153.0,37679,13.0,3167,72.0,166.0,40846,44250,78762
2136,2136,2136,2136,2136,2136,2136,2136,2137,2021-06-25 15:00:00+00:00,Cecil,60.0,41143,70.0,37749,18.0,3185,78.0,88.0,40934,44328,78892
2137,2137,2137,2137,2137,2137,2137,2137,2138,2021-06-26 15:00:00+00:00,Cecil,25.0,41168,27.0,37776,9.0,3194,34.0,36.0,40970,44362,78944
2138,2138,2138,2138,2138,2138,2138,2138,2139,2021-06-27 15:00:00+00:00,Cecil,13.0,41181,20.0,37796,,3194,,,40990,44375,78977
2139,2139,2139,2139,2139,2139,2139,2139,2140,2021-06-28 15:00:00+00:00,Cecil,42.0,41223,38.0,37834,11.0,3205,53.0,49.0,41039,44428,79057
2140,2140,2140,2140,2140,2140,2140,2140,2141,2021-01-20 15:00:00+00:00,Calvert,453.0,5504,113.0,384,,0,,,384,5504,5888
2141,2141,2141,2141,2141,2141,2141,2141,2142,2021-01-21 15:00:00+00:00,Calvert,718.0,6222,26.0,410,,0,,,410,6222,6632
2142,2142,2142,2142,2142,2142,2142,2142,2143,2021-01-22 15:00:00+00:00,Calvert,731.0,6953,50.0,460,,0,,,460,6953,7413
2143,2143,2143,2143,2143,2143,2143,2143,2144,2021-01-23 15:00:00+00:00,Calvert,59.0,7012,3.0,463,,0,,,463,7012,7475
2144,2144,2144,2144,2144,2144,2144,2144,2145,2021-01-24 15:00:00+00:00,Calvert,9.0,7021,6.0,469,,0,,,469,7021,7490
2145,2145,2145,2145,2145,2145,2145,2145,2146,2021-01-25 15:00:00+00:00,Calvert,61.0,7082,85.0,554,,0,,,554,7082,7636
2146,2146,2146,2146,2146,2146,2146,2146,2147,2021-01-26 15:00:00+00:00,Calvert,68.0,7150,98.0,652,,0,,,652,7150,7802
2147,2147,2147,2147,2147,2147,2147,2147,2148,2021-01-27 15:00:00+00:00,Calvert,127.0,7277,416.0,1068,,0,,,1068,7277,8345
2148,2148,2148,2148,2148,2148,2148,2148,2149,2021-01-28 15:00:00+00:00,Calvert,509.0,7786,350.0,1418,,0,,,1418,7786,9204
2149,2149,2149,2149,2149,2149,2149,2149,2150,2021-01-29 15:00:00+00:00,Calvert,862.0,8648,159.0,1577,,0,,,1577,8648,10225
2150,2150,2150,2150,2150,2150,2150,2150,2151,2021-01-30 15:00:00+00:00,Calvert,484.0,9132,23.0,1600,,0,,,1600,9132,10732
2151,2151,2151,2151,2151,2151,2151,2151,2152,2021-01-31 15:00:00+00:00,Calvert,25.0,9157,7.0,1607,,0,,,1607,9157,10764
2152,2152,2152,2152,2152,2152,2152,2152,2153,2021-02-01 15:00:00+00:00,Calvert,58.0,9215,24.0,1631,,0,,,1631,9215,10846
2153,2153,2153,2153,2153,2153,2153,2153,2154,2021-02-02 15:00:00+00:00,Calvert,66.0,9281,136.0,1767,,0,,,1767,9281,11048
2154,2154,2154,2154,2154,2154,2154,2154,2155,2021-02-03 15:00:00+00:00,Calvert,460.0,9741,174.0,1941,,0,,,1941,9741,11682
2155,2155,2155,2155,2155,2155,2155,2155,2156,2021-02-04 15:00:00+00:00,Calvert,900.0,10641,170.0,2111,,0,,,2111,10641,12752
2156,2156,2156,2156,2156,2156,2156,2156,2157,2021-02-05 15:00:00+00:00,Calvert,410.0,11051,548.0,2659,,0,,,2659,11051,13710
2157,2157,2157,2157,2157,2157,2157,2157,2158,2021-02-06 15:00:00+00:00,Calvert,72.0,11123,414.0,3073,,0,,,3073,11123,14196
2158,2158,2158,2158,2158,2158,2158,2158,2159,2021-02-07 15:00:00+00:00,Calvert,32.0,11155,11.0,3084,,0,,,3084,11155,14239
2159,2159,2159,2159,2159,2159,2159,2159,2160,2021-02-08 15:00:00+00:00,Calvert,63.0,11218,111.0,3195,,0,,,3195,11218,14413
2160,2160,2160,2160,2160,2160,2160,2160,2161,2021-02-09 15:00:00+00:00,Calvert,94.0,11312,286.0,3481,,0,,,3481,11312,14793
2161,2161,2161,2161,2161,2161,2161,2161,2162,2021-02-10 15:00:00+00:00,Calvert,268.0,11580,490.0,3971,,0,,,3971,11580,15551
2162,2162,2162,2162,2162,2162,2162,2162,2163,2021-02-11 15:00:00+00:00,Calvert,231.0,11811,116.0,4087,,0,,,4087,11811,15898
2163,2163,2163,2163,2163,2163,2163,2163,2164,2021-02-12 15:00:00+00:00,Calvert,188.0,11999,502.0,4589,,0,,,4589,11999,16588
2164,2164,2164,2164,2164,2164,2164,2164,2165,2021-02-13 15:00:00+00:00,Calvert,59.0,12058,16.0,4605,,0,,,4605,12058,16663
2165,2165,2165,2165,2165,2165,2165,2165,2166,2021-02-14 15:00:00+00:00,Calvert,95.0,12153,9.0,4614,,0,,,4614,12153,16767
2166,2166,2166,2166,2166,2166,2166,2166,2167,2021-02-15 15:00:00+00:00,Calvert,157.0,12310,21.0,4635,,0,,,4635,12310,16945
2167,2167,2167,2167,2167,2167,2167,2167,2168,2021-02-16 15:00:00+00:00,Calvert,123.0,12433,390.0,5025,,0,,,5025,12433,17458
2168,2168,2168,2168,2168,2168,2168,2168,2169,2021-06-29 15:00:00+00:00,Cecil,30.0,41253,75.0,37909,1.0,3206,31.0,76.0,41115,44459,79162
2169,2169,2169,2169,2169,2169,2169,2169,2170,2021-06-30 15:00:00+00:00,Cecil,43.0,41296,50.0,37959,1.0,3207,44.0,51.0,41166,44503,79255
2170,2170,2170,2170,2170,2170,2170,2170,2171,2021-07-01 15:00:00+00:00,Cecil,49.0,41345,69.0,38028,7.0,3214,56.0,76.0,41242,44559,79373
2171,2171,2171,2171,2171,2171,2171,2171,2172,2021-07-02 15:00:00+00:00,Cecil,47.0,41392,38.0,38066,12.0,3226,59.0,50.0,41292,44618,79458
2172,2172,2172,2172,2172,2172,2172,2172,2173,2021-07-03 15:00:00+00:00,Cecil,21.0,41413,38.0,38104,5.0,3231,26.0,43.0,41335,44644,79517
2173,2173,2173,2173,2173,2173,2173,2173,2174,2021-07-04 15:00:00+00:00,Cecil,7.0,41420,1.0,38105,1.0,3232,8.0,2.0,41337,44652,79525
2174,2174,2174,2174,2174,2174,2174,2174,2175,2021-07-05 15:00:00+00:00,Cecil,27.0,41447,49.0,38154,2.0,3234,29.0,51.0,41388,44681,79601
2175,2175,2175,2175,2175,2175,2175,2175,2176,2021-07-06 15:00:00+00:00,Cecil,38.0,41485,49.0,38203,5.0,3239,43.0,54.0,41442,44724,79688
2176,2176,2176,2176,2176,2176,2176,2176,2177,2021-07-07 15:00:00+00:00,Cecil,35.0,41520,51.0,38254,2.0,3241,37.0,53.0,41495,44761,79774
2177,2177,2177,2177,2177,2177,2177,2177,2178,2021-07-08 15:00:00+00:00,Cecil,41.0,41561,98.0,38352,6.0,3247,47.0,104.0,41599,44808,79913
2178,2178,2178,2178,2178,2178,2178,2178,2179,2021-07-09 15:00:00+00:00,Cecil,67.0,41628,65.0,38417,8.0,3255,75.0,73.0,41672,44883,80045
2179,2179,2179,2179,2179,2179,2179,2179,2180,2021-07-10 15:00:00+00:00,Cecil,26.0,41654,22.0,38439,,3255,,,41694,44909,80093
2180,2180,2180,2180,2180,2180,2180,2180,2181,2021-07-11 15:00:00+00:00,Cecil,14.0,41668,24.0,38463,,3255,,,41718,44923,80131
2181,2181,2181,2181,2181,2181,2181,2181,2182,2021-07-12 15:00:00+00:00,Cecil,37.0,41705,38.0,38501,8.0,3263,45.0,46.0,41764,44968,80206
2182,2182,2182,2182,2182,2182,2182,2182,2183,2021-07-13 15:00:00+00:00,Cecil,40.0,41745,43.0,38544,4.0,3267,44.0,47.0,41811,45012,80289
2183,2183,2183,2183,2183,2183,2183,2183,2184,2021-07-14 15:00:00+00:00,Cecil,47.0,41792,51.0,38595,3.0,3270,50.0,54.0,41865,45062,80387
2184,2184,2184,2184,2184,2184,2184,2184,2185,2021-07-15 15:00:00+00:00,Cecil,45.0,41837,63.0,38658,13.0,3283,58.0,76.0,41941,45120,80495
2185,2185,2185,2185,2185,2185,2185,2185,2186,2021-07-16 15:00:00+00:00,Cecil,52.0,41889,51.0,38709,,3283,,,41992,45172,80598
2186,2186,2186,2186,2186,2186,2186,2186,2187,2021-07-17 15:00:00+00:00,Cecil,21.0,41910,10.0,38719,3.0,3286,24.0,13.0,42005,45196,80629
2187,2187,2187,2187,2187,2187,2187,2187,2188,2021-07-18 15:00:00+00:00,Cecil,11.0,41921,8.0,38727,,3286,,,42013,45207,80648
2188,2188,2188,2188,2188,2188,2188,2188,2189,2021-07-19 15:00:00+00:00,Cecil,51.0,41972,25.0,38752,3.0,3289,54.0,28.0,42041,45261,80724
2189,2189,2189,2189,2189,2189,2189,2189,2190,2021-07-20 15:00:00+00:00,Cecil,48.0,42020,34.0,38786,4.0,3293,52.0,38.0,42079,45313,80806
2190,2190,2190,2190,2190,2190,2190,2190,2191,2021-07-21 15:00:00+00:00,Cecil,96.0,42116,17.0,38803,3.0,3296,99.0,20.0,42099,45412,80919
2191,2191,2191,2191,2191,2191,2191,2191,2192,2021-07-22 15:00:00+00:00,Cecil,97.0,42213,56.0,38859,29.0,3325,126.0,85.0,42184,45538,81072
2192,2192,2192,2192,2192,2192,2192,2192,2193,2021-07-23 15:00:00+00:00,Cecil,77.0,42290,54.0,38913,3.0,3328,80.0,57.0,42241,45618,81203
2193,2193,2193,2193,2193,2193,2193,2193,2194,2021-07-24 15:00:00+00:00,Cecil,49.0,42339,28.0,38941,3.0,3331,52.0,31.0,42272,45670,81280
2194,2194,2194,2194,2194,2194,2194,2194,2195,2021-07-25 15:00:00+00:00,Cecil,39.0,42378,10.0,38951,,3331,,,42282,45709,81329
2195,2195,2195,2195,2195,2195,2195,2195,2196,2021-07-26 15:00:00+00:00,Cecil,51.0,42429,34.0,38985,21.0,3352,72.0,55.0,42337,45781,81414
2196,2196,2196,2196,2196,2196,2196,2196,2197,2021-07-27 15:00:00+00:00,Cecil,83.0,42512,32.0,39017,16.0,3368,99.0,48.0,42385,45880,81529
2197,2197,2197,2197,2197,2197,2197,2197,2198,2021-07-28 15:00:00+00:00,Cecil,119.0,42631,37.0,39054,1.0,3369,120.0,38.0,42423,46000,81685
2198,2198,2198,2198,2198,2198,2198,2198,2199,2021-07-29 15:00:00+00:00,Cecil,120.0,42751,54.0,39108,22.0,3391,142.0,76.0,42499,46142,81859
2199,2199,2199,2199,2199,2199,2199,2199,2200,2021-07-30 15:00:00+00:00,Cecil,90.0,42841,43.0,39151,8.0,3399,98.0,51.0,42550,46240,81992
2200,2200,2200,2200,2200,2200,2200,2200,2201,2021-07-31 15:00:00+00:00,Cecil,54.0,42895,20.0,39171,7.0,3406,61.0,27.0,42577,46301,82066
2201,2201,2201,2201,2201,2201,2201,2201,2202,2021-08-01 15:00:00+00:00,Cecil,31.0,42926,10.0,39181,2.0,3408,33.0,12.0,42589,46334,82107
2202,2202,2202,2202,2202,2202,2202,2202,2203,2021-08-02 15:00:00+00:00,Cecil,101.0,43027,25.0,39206,2.0,3410,103.0,27.0,42616,46437,82233
2203,2203,2203,2203,2203,2203,2203,2203,2204,2021-08-03 15:00:00+00:00,Cecil,69.0,43096,39.0,39245,11.0,3421,80.0,50.0,42666,46517,82341
2204,2204,2204,2204,2204,2204,2204,2204,2205,2021-08-04 15:00:00+00:00,Cecil,156.0,43252,56.0,39301,3.0,3424,159.0,59.0,42725,46676,82553
2205,2205,2205,2205,2205,2205,2205,2205,2206,2021-08-05 15:00:00+00:00,Cecil,96.0,43348,52.0,39353,25.0,3449,121.0,77.0,42802,46797,82701
2206,2206,2206,2206,2206,2206,2206,2206,2207,2021-08-06 15:00:00+00:00,Cecil,83.0,43431,55.0,39408,1.0,3450,84.0,56.0,42858,46881,82839
2207,2207,2207,2207,2207,2207,2207,2207,2208,2021-08-07 15:00:00+00:00,Cecil,53.0,43484,25.0,39433,2.0,3452,55.0,27.0,42885,46936,82917
2208,2208,2208,2208,2208,2208,2208,2208,2209,2021-08-08 15:00:00+00:00,Cecil,36.0,43520,13.0,39446,1.0,3453,37.0,14.0,42899,46973,82966
2209,2209,2209,2209,2209,2209,2209,2209,2210,2021-08-09 15:00:00+00:00,Cecil,85.0,43605,37.0,39483,6.0,3459,91.0,43.0,42942,47064,83088
2210,2210,2210,2210,2210,2210,2210,2210,2211,2021-08-10 15:00:00+00:00,Cecil,84.0,43689,31.0,39514,4.0,3463,88.0,35.0,42977,47152,83203
2211,2211,2211,2211,2211,2211,2211,2211,2212,2021-08-11 15:00:00+00:00,Cecil,94.0,43783,82.0,39596,6.0,3469,100.0,88.0,43065,47252,83379
2212,2212,2212,2212,2212,2212,2212,2212,2213,2021-08-12 15:00:00+00:00,Cecil,60.0,43843,38.0,39634,26.0,3495,86.0,64.0,43129,47338,83477
2213,2213,2213,2213,2213,2213,2213,2213,2214,2021-08-13 15:00:00+00:00,Cecil,84.0,43927,50.0,39684,1.0,3496,85.0,51.0,43180,47423,83611
2214,2214,2214,2214,2214,2214,2214,2214,2215,2021-08-14 15:00:00+00:00,Cecil,54.0,43981,24.0,39708,12.0,3508,66.0,36.0,43216,47489,83689
2215,2215,2215,2215,2215,2215,2215,2215,2216,2021-08-15 15:00:00+00:00,Cecil,27.0,44008,16.0,39724,,3508,,,43232,47516,83732
2216,2216,2216,2216,2216,2216,2216,2216,2217,2021-08-16 15:00:00+00:00,Cecil,59.0,44067,30.0,39754,11.0,3519,70.0,41.0,43273,47586,83821
2217,2217,2217,2217,2217,2217,2217,2217,2218,2021-08-17 15:00:00+00:00,Cecil,59.0,44126,58.0,39812,18.0,3537,77.0,76.0,43349,47663,83938
2218,2218,2218,2218,2218,2218,2218,2218,2219,2021-08-18 15:00:00+00:00,Cecil,95.0,44221,92.0,39904,4.0,3541,99.0,96.0,43445,47762,84125
2219,2219,2219,2219,2219,2219,2219,2219,2220,2021-08-19 15:00:00+00:00,Cecil,45.0,44266,54.0,39958,7.0,3548,52.0,61.0,43506,47814,84224
2220,2220,2220,2220,2220,2220,2220,2220,2221,2021-08-20 15:00:00+00:00,Cecil,100.0,44366,58.0,40016,5.0,3553,105.0,63.0,43569,47919,84382
2221,2221,2221,2221,2221,2221,2221,2221,2222,2021-08-21 15:00:00+00:00,Cecil,51.0,44417,33.0,40049,,3553,,,43602,47970,84466
2222,2222,2222,2222,2222,2222,2222,2222,2223,2021-08-22 15:00:00+00:00,Cecil,32.0,44449,24.0,40073,,3553,,,43626,48002,84522
2223,2223,2223,2223,2223,2223,2223,2223,2224,2021-08-23 15:00:00+00:00,Cecil,62.0,44511,50.0,40123,2.0,3555,64.0,52.0,43678,48066,84634
2224,2224,2224,2224,2224,2224,2224,2224,2225,2021-08-24 15:00:00+00:00,Cecil,56.0,44567,73.0,40196,5.0,3560,61.0,78.0,43756,48127,84763
2225,2225,2225,2225,2225,2225,2225,2225,2226,2021-08-25 15:00:00+00:00,Cecil,164.0,44731,117.0,40313,2.0,3562,166.0,119.0,43875,48293,85044
2226,2226,2226,2226,2226,2226,2226,2226,2227,2021-08-26 15:00:00+00:00,Cecil,95.0,44826,131.0,40444,48.0,3610,143.0,179.0,44054,48436,85270
2227,2227,2227,2227,2227,2227,2227,2227,2228,2021-08-27 15:00:00+00:00,Cecil,48.0,44874,73.0,40517,4.0,3614,52.0,77.0,44131,48488,85391
2228,2228,2228,2228,2228,2228,2228,2228,2229,2021-08-28 15:00:00+00:00,Cecil,34.0,44908,63.0,40580,,3614,,,44194,48522,85488
2229,2229,2229,2229,2229,2229,2229,2229,2230,2021-08-29 15:00:00+00:00,Cecil,24.0,44932,33.0,40613,,3614,,,44227,48546,85545
2230,2230,2230,2230,2230,2230,2230,2230,2231,2021-08-30 15:00:00+00:00,Cecil,73.0,45005,104.0,40717,,3614,,,44331,48619,85722
2231,2231,2231,2231,2231,2231,2231,2231,2232,2021-08-31 15:00:00+00:00,Cecil,71.0,45076,70.0,40787,18.0,3632,89.0,88.0,44419,48708,85863
2232,2232,2232,2232,2232,2232,2232,2232,2233,2021-09-01 15:00:00+00:00,Cecil,62.0,45138,96.0,40883,3.0,3635,65.0,99.0,44518,48773,86021
2233,2233,2233,2233,2233,2233,2233,2233,2234,2021-09-02 15:00:00+00:00,Cecil,48.0,45186,53.0,40936,6.0,3641,54.0,59.0,44577,48827,86122
2234,2234,2234,2234,2234,2234,2234,2234,2235,2021-09-03 15:00:00+00:00,Cecil,65.0,45251,91.0,41027,1.0,3642,66.0,92.0,44669,48893,86278
2235,2235,2235,2235,2235,2235,2235,2235,2236,2021-09-04 15:00:00+00:00,Cecil,41.0,45292,29.0,41056,3.0,3645,44.0,32.0,44701,48937,86348
2236,2236,2236,2236,2236,2236,2236,2236,2237,2021-09-05 15:00:00+00:00,Cecil,32.0,45324,20.0,41076,,3645,,,44721,48969,86400
2237,2237,2237,2237,2237,2237,2237,2237,2238,2021-09-06 15:00:00+00:00,Cecil,18.0,45342,10.0,41086,,3645,,,44731,48987,86428
2238,2238,2238,2238,2238,2238,2238,2238,2239,2021-09-07 15:00:00+00:00,Cecil,63.0,45405,95.0,41181,18.0,3663,81.0,113.0,44844,49068,86586
2239,2239,2239,2239,2239,2239,2239,2239,2240,2021-09-08 15:00:00+00:00,Cecil,74.0,45479,77.0,41258,3.0,3666,77.0,80.0,44924,49145,86737
2240,2240,2240,2240,2240,2240,2240,2240,2241,2021-09-09 15:00:00+00:00,Cecil,60.0,45539,47.0,41305,3.0,3669,63.0,50.0,44974,49208,86844
2241,2241,2241,2241,2241,2241,2241,2241,2242,2021-09-10 15:00:00+00:00,Cecil,61.0,45600,92.0,41397,,3669,,,45066,49269,86997
2242,2242,2242,2242,2242,2242,2242,2242,2243,2021-09-11 15:00:00+00:00,Cecil,48.0,45648,46.0,41443,14.0,3683,62.0,60.0,45126,49331,87091
2243,2243,2243,2243,2243,2243,2243,2243,2244,2021-09-12 15:00:00+00:00,Cecil,20.0,45668,26.0,41469,1.0,3684,21.0,27.0,45153,49352,87137
2244,2244,2244,2244,2244,2244,2244,2244,2245,2021-09-13 15:00:00+00:00,Cecil,57.0,45725,46.0,41515,,3684,,,45199,49409,87240
2245,2245,2245,2245,2245,2245,2245,2245,2246,2021-09-14 15:00:00+00:00,Cecil,78.0,45803,78.0,41593,37.0,3721,115.0,115.0,45314,49524,87396
2246,2246,2246,2246,2246,2246,2246,2246,2247,2021-09-15 15:00:00+00:00,Cecil,59.0,45862,131.0,41724,8.0,3729,67.0,139.0,45453,49591,87586
2247,2247,2247,2247,2247,2247,2247,2247,2248,2021-09-16 15:00:00+00:00,Cecil,44.0,45906,62.0,41786,2.0,3731,46.0,64.0,45517,49637,87692
2248,2248,2248,2248,2248,2248,2248,2248,2249,2021-09-17 15:00:00+00:00,Cecil,72.0,45978,76.0,41862,2.0,3733,74.0,78.0,45595,49711,87840
2249,2249,2249,2249,2249,2249,2249,2249,2250,2021-09-18 15:00:00+00:00,Cecil,29.0,46007,41.0,41903,2.0,3735,31.0,43.0,45638,49742,87910
2250,2250,2250,2250,2250,2250,2250,2250,2251,2021-09-19 15:00:00+00:00,Cecil,28.0,46035,41.0,41944,2.0,3737,30.0,43.0,45681,49772,87979
2251,2251,2251,2251,2251,2251,2251,2251,2252,2021-09-20 15:00:00+00:00,Cecil,56.0,46091,73.0,42017,18.0,3755,74.0,91.0,45772,49846,88108
2252,2252,2252,2252,2252,2252,2252,2252,2253,2021-09-21 15:00:00+00:00,Cecil,45.0,46136,58.0,42075,4.0,3759,49.0,62.0,45834,49895,88211
2253,2253,2253,2253,2253,2253,2253,2253,2254,2021-09-22 15:00:00+00:00,Cecil,44.0,46180,69.0,42144,1.0,3760,45.0,70.0,45904,49940,88324
2254,2254,2254,2254,2254,2254,2254,2254,2255,2021-09-23 15:00:00+00:00,Cecil,30.0,46210,33.0,42177,3.0,3763,33.0,36.0,45940,49973,88387
2255,2255,2255,2255,2255,2255,2255,2255,2256,2021-09-24 15:00:00+00:00,Cecil,88.0,46298,61.0,42238,7.0,3770,95.0,68.0,46008,50068,88536
2256,2256,2256,2256,2256,2256,2256,2256,2257,2021-09-25 15:00:00+00:00,Cecil,30.0,46328,47.0,42285,,3770,,,46055,50098,88613
2257,2257,2257,2257,2257,2257,2257,2257,2258,2021-09-26 15:00:00+00:00,Cecil,22.0,46350,24.0,42309,1.0,3771,23.0,25.0,46080,50121,88659
2258,2258,2258,2258,2258,2258,2258,2258,2259,2021-09-27 15:00:00+00:00,Cecil,39.0,46389,38.0,42347,2.0,3773,41.0,40.0,46120,50162,88736
2259,2259,2259,2259,2259,2259,2259,2259,2260,2021-09-28 15:00:00+00:00,Cecil,47.0,46436,62.0,42409,28.0,3801,75.0,90.0,46210,50237,88845
2260,2260,2260,2260,2260,2260,2260,2260,2261,2021-09-29 15:00:00+00:00,Cecil,52.0,46488,62.0,42471,4.0,3805,56.0,66.0,46276,50293,88959
2261,2261,2261,2261,2261,2261,2261,2261,2262,2021-09-30 15:00:00+00:00,Cecil,42.0,46530,54.0,42525,1.0,3806,43.0,55.0,46331,50336,89055
2262,2262,2262,2262,2262,2262,2262,2262,2263,2021-10-01 15:00:00+00:00,Cecil,50.0,46580,60.0,42585,1.0,3807,51.0,61.0,46392,50387,89165
2263,2263,2263,2263,2263,2263,2263,2263,2264,2021-10-02 15:00:00+00:00,Cecil,18.0,46598,29.0,42614,,3807,,,46421,50405,89212
2264,2264,2264,2264,2264,2264,2264,2264,2265,2021-10-03 15:00:00+00:00,Cecil,18.0,46616,24.0,42638,1.0,3808,19.0,25.0,46446,50424,89254
2265,2265,2265,2265,2265,2265,2265,2265,2266,2021-10-04 15:00:00+00:00,Cecil,34.0,46650,34.0,42672,1.0,3809,35.0,35.0,46481,50459,89322
2266,2266,2266,2266,2266,2266,2266,2266,2267,2021-10-05 15:00:00+00:00,Cecil,56.0,46706,59.0,42731,14.0,3823,70.0,73.0,46554,50529,89437
2267,2267,2267,2267,2267,2267,2267,2267,2268,2021-10-06 15:00:00+00:00,Cecil,71.0,46777,61.0,42792,,3823,,,46615,50600,89569
2268,2268,2268,2268,2268,2268,2268,2268,2269,2021-10-07 15:00:00+00:00,Cecil,38.0,46815,33.0,42825,5.0,3828,43.0,38.0,46653,50643,89640
2269,2269,2269,2269,2269,2269,2269,2269,2270,2021-10-08 15:00:00+00:00,Cecil,57.0,46872,51.0,42876,1.0,3829,58.0,52.0,46705,50701,89748
2270,2270,2270,2270,2270,2270,2270,2270,2271,2021-10-09 15:00:00+00:00,Cecil,22.0,46894,29.0,42905,3.0,3832,25.0,32.0,46737,50726,89799
2271,2271,2271,2271,2271,2271,2271,2271,2272,2021-10-10 15:00:00+00:00,Cecil,15.0,46909,24.0,42929,1.0,3833,16.0,25.0,46762,50742,89838
2272,2272,2272,2272,2272,2272,2272,2272,2273,2021-10-11 15:00:00+00:00,Cecil,54.0,46963,46.0,42975,2.0,3835,56.0,48.0,46810,50798,89938
2273,2273,2273,2273,2273,2273,2273,2273,2274,2021-10-12 15:00:00+00:00,Cecil,67.0,47030,54.0,43029,32.0,3867,99.0,86.0,46896,50897,90059
2274,2274,2274,2274,2274,2274,2274,2274,2275,2021-10-13 15:00:00+00:00,Cecil,48.0,47078,52.0,43081,2.0,3869,50.0,54.0,46950,50947,90159
2275,2275,2275,2275,2275,2275,2275,2275,2276,2021-10-14 15:00:00+00:00,Cecil,38.0,47116,31.0,43112,,3869,,,46981,50985,90228
2276,2276,2276,2276,2276,2276,2276,2276,2277,2021-10-15 15:00:00+00:00,Cecil,47.0,47163,62.0,43174,2.0,3871,49.0,64.0,47045,51034,90337
2277,2277,2277,2277,2277,2277,2277,2277,2278,2021-10-16 15:00:00+00:00,Cecil,25.0,47188,23.0,43197,8.0,3879,33.0,31.0,47076,51067,90385
2278,2278,2278,2278,2278,2278,2278,2278,2279,2021-10-17 15:00:00+00:00,Cecil,15.0,47203,28.0,43225,2.0,3881,17.0,30.0,47106,51084,90428
2279,2279,2279,2279,2279,2279,2279,2279,2280,2021-10-18 15:00:00+00:00,Cecil,64.0,47267,61.0,43286,,3881,,,47167,51148,90553
2280,2280,2280,2280,2280,2280,2280,2280,2281,2021-10-19 15:00:00+00:00,Cecil,35.0,47302,39.0,43325,13.0,3894,48.0,52.0,47219,51196,90627
2281,2281,2281,2281,2281,2281,2281,2281,2282,2021-10-20 15:00:00+00:00,Cecil,46.0,47348,41.0,43366,5.0,3899,51.0,46.0,47265,51247,90714
2282,2282,2282,2282,2282,2282,2282,2282,2283,2021-10-21 15:00:00+00:00,Cecil,34.0,47382,27.0,43393,4.0,3903,38.0,31.0,47296,51285,90775
2283,2283,2283,2283,2283,2283,2283,2283,2284,2021-10-22 15:00:00+00:00,Cecil,55.0,47437,39.0,43432,5.0,3908,60.0,44.0,47340,51345,90869
2284,2284,2284,2284,2284,2284,2284,2284,2285,2021-10-23 15:00:00+00:00,Cecil,23.0,47460,8.0,43440,2.0,3910,25.0,10.0,47350,51370,90900
2285,2285,2285,2285,2285,2285,2285,2285,2286,2021-10-24 15:00:00+00:00,Cecil,12.0,47472,23.0,43463,1.0,3911,13.0,24.0,47374,51383,90935
2286,2286,2286,2286,2286,2286,2286,2286,2287,2021-10-25 15:00:00+00:00,Cecil,36.0,47508,36.0,43499,5.0,3916,41.0,41.0,47415,51424,91007
2287,2287,2287,2287,2287,2287,2287,2287,2288,2021-10-26 15:00:00+00:00,Cecil,75.0,47583,57.0,43556,28.0,3944,103.0,85.0,47500,51527,91139
2288,2288,2288,2288,2288,2288,2288,2288,2289,2021-10-27 15:00:00+00:00,Cecil,67.0,47650,70.0,43626,9.0,3953,76.0,79.0,47579,51603,91276
2289,2289,2289,2289,2289,2289,2289,2289,2290,2021-10-28 15:00:00+00:00,Cecil,60.0,47710,46.0,43672,12.0,3965,72.0,58.0,47637,51675,91382
2290,2290,2290,2290,2290,2290,2290,2290,2291,2021-10-29 15:00:00+00:00,Cecil,34.0,47744,76.0,43748,1.0,3966,35.0,77.0,47714,51710,91492
2291,2291,2291,2291,2291,2291,2291,2291,2292,2021-10-30 15:00:00+00:00,Cecil,24.0,47768,30.0,43778,3.0,3969,27.0,33.0,47747,51737,91546
2292,2292,2292,2292,2292,2292,2292,2292,2293,2021-10-31 15:00:00+00:00,Cecil,19.0,47787,16.0,43794,3.0,3972,22.0,19.0,47766,51759,91581
2293,2293,2293,2293,2293,2293,2293,2293,2294,2021-11-01 15:00:00+00:00,Cecil,33.0,47820,50.0,43844,7.0,3979,40.0,57.0,47823,51799,91664
2294,2294,2294,2294,2294,2294,2294,2294,2295,2021-11-02 15:00:00+00:00,Cecil,42.0,47862,69.0,43913,17.0,3996,59.0,86.0,47909,51858,91775
2295,2295,2295,2295,2295,2295,2295,2295,2296,2021-11-03 15:00:00+00:00,Cecil,28.0,47890,79.0,43992,20.0,4016,48.0,99.0,48008,51906,91882
2296,2296,2296,2296,2296,2296,2296,2296,2297,2021-11-04 15:00:00+00:00,Cecil,45.0,47935,54.0,44046,8.0,4024,53.0,62.0,48070,51959,91981
2297,2297,2297,2297,2297,2297,2297,2297,2298,2021-11-05 15:00:00+00:00,Cecil,57.0,47992,63.0,44109,1.0,4025,58.0,64.0,48134,52017,92101
2298,2298,2298,2298,2298,2298,2298,2298,2299,2021-11-06 15:00:00+00:00,Cecil,9.0,48001,9.0,44118,,4025,,,48143,52026,92119
2299,2299,2299,2299,2299,2299,2299,2299,2300,2020-12-16 15:00:00+00:00,Charles,6.0,6,,0,,0,,,0,6,6
2300,2300,2300,2300,2300,2300,2300,2300,2301,2020-12-17 15:00:00+00:00,Charles,11.0,17,,0,,0,,,0,17,17
2301,2301,2301,2301,2301,2301,2301,2301,2302,2020-12-18 15:00:00+00:00,Charles,19.0,36,,0,,0,,,0,36,36
2302,2302,2302,2302,2302,2302,2302,2302,2303,2020-12-20 15:00:00+00:00,Charles,3.0,39,,0,,0,,,0,39,39
2303,2303,2303,2303,2303,2303,2303,2303,2304,2020-12-21 15:00:00+00:00,Charles,39.0,78,,0,,0,,,0,78,78
2304,2304,2304,2304,2304,2304,2304,2304,2305,2020-12-22 15:00:00+00:00,Charles,51.0,129,,0,,0,,,0,129,129
2305,2305,2305,2305,2305,2305,2305,2305,2306,2020-12-23 15:00:00+00:00,Charles,32.0,161,,0,,0,,,0,161,161
2306,2306,2306,2306,2306,2306,2306,2306,2307,2020-12-24 15:00:00+00:00,Charles,22.0,183,,0,,0,,,0,183,183
2307,2307,2307,2307,2307,2307,2307,2307,2308,2020-12-25 15:00:00+00:00,Charles,7.0,190,,0,,0,,,0,190,190
2308,2308,2308,2308,2308,2308,2308,2308,2309,2020-12-26 15:00:00+00:00,Charles,18.0,208,,0,,0,,,0,208,208
2309,2309,2309,2309,2309,2309,2309,2309,2310,2020-12-27 15:00:00+00:00,Charles,141.0,349,,0,,0,,,0,349,349
2310,2310,2310,2310,2310,2310,2310,2310,2311,2020-12-28 15:00:00+00:00,Charles,85.0,434,,0,,0,,,0,434,434
2311,2311,2311,2311,2311,2311,2311,2311,2312,2020-12-29 15:00:00+00:00,Charles,91.0,525,1.0,1,,0,,,1,525,526
2312,2312,2312,2312,2312,2312,2312,2312,2313,2020-12-30 15:00:00+00:00,Charles,143.0,668,1.0,2,,0,,,2,668,670
2313,2313,2313,2313,2313,2313,2313,2313,2314,2020-12-31 15:00:00+00:00,Charles,105.0,773,,2,,0,,,2,773,775
2314,2314,2314,2314,2314,2314,2314,2314,2315,2021-01-01 15:00:00+00:00,Charles,9.0,782,1.0,3,,0,,,3,782,785
2315,2315,2315,2315,2315,2315,2315,2315,2316,2021-01-02 15:00:00+00:00,Charles,11.0,793,,3,,0,,,3,793,796
2316,2316,2316,2316,2316,2316,2316,2316,2317,2021-01-03 15:00:00+00:00,Charles,117.0,910,,3,,0,,,3,910,913
2317,2317,2317,2317,2317,2317,2317,2317,2318,2021-01-04 15:00:00+00:00,Charles,115.0,1025,,3,,0,,,3,1025,1028
2318,2318,2318,2318,2318,2318,2318,2318,2319,2021-01-05 15:00:00+00:00,Charles,123.0,1148,1.0,4,,0,,,4,1148,1152
2319,2319,2319,2319,2319,2319,2319,2319,2320,2021-01-06 15:00:00+00:00,Charles,507.0,1655,8.0,12,,0,,,12,1655,1667
2320,2320,2320,2320,2320,2320,2320,2320,2321,2021-01-07 15:00:00+00:00,Charles,145.0,1800,12.0,24,,0,,,24,1800,1824
2321,2321,2321,2321,2321,2321,2321,2321,2322,2021-01-08 15:00:00+00:00,Charles,163.0,1963,21.0,45,,0,,,45,1963,2008
2322,2322,2322,2322,2322,2322,2322,2322,2323,2021-01-09 15:00:00+00:00,Charles,486.0,2449,2.0,47,,0,,,47,2449,2496
2323,2323,2323,2323,2323,2323,2323,2323,2324,2021-01-10 15:00:00+00:00,Charles,33.0,2482,,47,,0,,,47,2482,2529
2324,2324,2324,2324,2324,2324,2324,2324,2325,2021-01-11 15:00:00+00:00,Charles,85.0,2567,35.0,82,,0,,,82,2567,2649
2325,2325,2325,2325,2325,2325,2325,2325,2326,2021-01-12 15:00:00+00:00,Charles,259.0,2826,48.0,130,,0,,,130,2826,2956
2326,2326,2326,2326,2326,2326,2326,2326,2327,2021-01-13 15:00:00+00:00,Charles,718.0,3544,24.0,154,,0,,,154,3544,3698
2327,2327,2327,2327,2327,2327,2327,2327,2328,2021-01-14 15:00:00+00:00,Charles,182.0,3726,22.0,176,,0,,,176,3726,3902
2328,2328,2328,2328,2328,2328,2328,2328,2329,2021-01-15 15:00:00+00:00,Charles,555.0,4281,19.0,195,,0,,,195,4281,4476
2329,2329,2329,2329,2329,2329,2329,2329,2330,2021-01-16 15:00:00+00:00,Charles,52.0,4333,20.0,215,,0,,,215,4333,4548
2330,2330,2330,2330,2330,2330,2330,2330,2331,2021-01-17 15:00:00+00:00,Charles,47.0,4380,120.0,335,,0,,,335,4380,4715
2331,2331,2331,2331,2331,2331,2331,2331,2332,2021-01-18 15:00:00+00:00,Charles,49.0,4429,21.0,356,,0,,,356,4429,4785
2332,2332,2332,2332,2332,2332,2332,2332,2333,2021-01-19 15:00:00+00:00,Charles,77.0,4506,27.0,383,,0,,,383,4506,4889
2333,2333,2333,2333,2333,2333,2333,2333,2334,2021-01-20 15:00:00+00:00,Charles,1255.0,5761,26.0,409,,0,,,409,5761,6170
2334,2334,2334,2334,2334,2334,2334,2334,2335,2021-01-21 15:00:00+00:00,Charles,180.0,5941,17.0,426,,0,,,426,5941,6367
2335,2335,2335,2335,2335,2335,2335,2335,2336,2021-01-22 15:00:00+00:00,Charles,190.0,6131,24.0,450,,0,,,450,6131,6581
2336,2336,2336,2336,2336,2336,2336,2336,2337,2021-01-23 15:00:00+00:00,Charles,937.0,7068,72.0,522,,0,,,522,7068,7590
2337,2337,2337,2337,2337,2337,2337,2337,2338,2021-01-24 15:00:00+00:00,Charles,35.0,7103,11.0,533,,0,,,533,7103,7636
2338,2338,2338,2338,2338,2338,2338,2338,2339,2021-01-25 15:00:00+00:00,Charles,159.0,7262,55.0,588,,0,,,588,7262,7850
2339,2339,2339,2339,2339,2339,2339,2339,2340,2021-01-26 15:00:00+00:00,Charles,191.0,7453,55.0,643,,0,,,643,7453,8096
2340,2340,2340,2340,2340,2340,2340,2340,2341,2021-01-27 15:00:00+00:00,Charles,1252.0,8705,214.0,857,,0,,,857,8705,9562
2341,2341,2341,2341,2341,2341,2341,2341,2342,2021-01-28 15:00:00+00:00,Charles,245.0,8950,136.0,993,,0,,,993,8950,9943
2342,2342,2342,2342,2342,2342,2342,2342,2343,2021-01-29 15:00:00+00:00,Charles,184.0,9134,101.0,1094,,0,,,1094,9134,10228
2343,2343,2343,2343,2343,2343,2343,2343,2344,2021-01-30 15:00:00+00:00,Charles,111.0,9245,26.0,1120,,0,,,1120,9245,10365
2344,2344,2344,2344,2344,2344,2344,2344,2345,2021-01-31 15:00:00+00:00,Charles,40.0,9285,4.0,1124,,0,,,1124,9285,10409
2345,2345,2345,2345,2345,2345,2345,2345,2346,2021-02-01 15:00:00+00:00,Charles,57.0,9342,71.0,1195,,0,,,1195,9342,10537
2346,2346,2346,2346,2346,2346,2346,2346,2347,2021-02-02 15:00:00+00:00,Charles,139.0,9481,289.0,1484,,0,,,1484,9481,10965
2347,2347,2347,2347,2347,2347,2347,2347,2348,2021-02-03 15:00:00+00:00,Charles,200.0,9681,245.0,1729,,0,,,1729,9681,11410
2348,2348,2348,2348,2348,2348,2348,2348,2349,2021-02-04 15:00:00+00:00,Charles,1006.0,10687,124.0,1853,,0,,,1853,10687,12540
2349,2349,2349,2349,2349,2349,2349,2349,2350,2021-02-05 15:00:00+00:00,Charles,146.0,10833,199.0,2052,,0,,,2052,10833,12885
2350,2350,2350,2350,2350,2350,2350,2350,2351,2021-02-06 15:00:00+00:00,Charles,128.0,10961,792.0,2844,,0,,,2844,10961,13805
2351,2351,2351,2351,2351,2351,2351,2351,2352,2021-02-07 15:00:00+00:00,Charles,72.0,11033,43.0,2887,,0,,,2887,11033,13920
2352,2352,2352,2352,2352,2352,2352,2352,2353,2021-02-08 15:00:00+00:00,Charles,138.0,11171,88.0,2975,,0,,,2975,11171,14146
2353,2353,2353,2353,2353,2353,2353,2353,2354,2021-02-09 15:00:00+00:00,Charles,743.0,11914,134.0,3109,,0,,,3109,11914,15023
2354,2354,2354,2354,2354,2354,2354,2354,2355,2021-02-10 15:00:00+00:00,Charles,238.0,12152,607.0,3716,,0,,,3716,12152,15868
2355,2355,2355,2355,2355,2355,2355,2355,2356,2021-02-11 15:00:00+00:00,Charles,1298.0,13450,140.0,3856,,0,,,3856,13450,17306
2356,2356,2356,2356,2356,2356,2356,2356,2357,2021-02-12 15:00:00+00:00,Charles,264.0,13714,480.0,4336,,0,,,4336,13714,18050
2357,2357,2357,2357,2357,2357,2357,2357,2358,2021-02-13 15:00:00+00:00,Charles,78.0,13792,13.0,4349,,0,,,4349,13792,18141
2358,2358,2358,2358,2358,2358,2358,2358,2359,2021-02-14 15:00:00+00:00,Charles,129.0,13921,13.0,4362,,0,,,4362,13921,18283
2359,2359,2359,2359,2359,2359,2359,2359,2360,2021-02-15 15:00:00+00:00,Charles,234.0,14155,60.0,4422,,0,,,4422,14155,18577
2360,2360,2360,2360,2360,2360,2360,2360,2361,2021-02-16 15:00:00+00:00,Charles,206.0,14361,173.0,4595,,0,,,4595,14361,18956
2361,2361,2361,2361,2361,2361,2361,2361,2362,2021-02-17 15:00:00+00:00,Charles,216.0,14577,1279.0,5874,,0,,,5874,14577,20451
2362,2362,2362,2362,2362,2362,2362,2362,2363,2021-02-18 15:00:00+00:00,Charles,100.0,14677,128.0,6002,,0,,,6002,14677,20679
2363,2363,2363,2363,2363,2363,2363,2363,2364,2021-02-19 15:00:00+00:00,Charles,137.0,14814,236.0,6238,,0,,,6238,14814,21052
2364,2364,2364,2364,2364,2364,2364,2364,2365,2021-02-17 15:00:00+00:00,Calvert,304.0,12737,433.0,5458,,0,,,5458,12737,18195
2365,2365,2365,2365,2365,2365,2365,2365,2366,2021-02-18 15:00:00+00:00,Calvert,28.0,12765,162.0,5620,,0,,,5620,12765,18385
2366,2366,2366,2366,2366,2366,2366,2366,2367,2021-02-19 15:00:00+00:00,Calvert,53.0,12818,336.0,5956,,0,,,5956,12818,18774
2367,2367,2367,2367,2367,2367,2367,2367,2368,2021-02-20 15:00:00+00:00,Calvert,603.0,13421,102.0,6058,,0,,,6058,13421,19479
2368,2368,2368,2368,2368,2368,2368,2368,2369,2021-02-21 15:00:00+00:00,Calvert,25.0,13446,21.0,6079,,0,,,6079,13446,19525
2369,2369,2369,2369,2369,2369,2369,2369,2370,2021-02-22 15:00:00+00:00,Calvert,64.0,13510,54.0,6133,,0,,,6133,13510,19643
2370,2370,2370,2370,2370,2370,2370,2370,2371,2021-02-23 15:00:00+00:00,Calvert,306.0,13816,188.0,6321,,0,,,6321,13816,20137
2371,2371,2371,2371,2371,2371,2371,2371,2372,2021-02-24 15:00:00+00:00,Calvert,279.0,14095,468.0,6789,,0,,,6789,14095,20884
2372,2372,2372,2372,2372,2372,2372,2372,2373,2021-02-25 15:00:00+00:00,Calvert,501.0,14596,500.0,7289,,0,,,7289,14596,21885
2373,2373,2373,2373,2373,2373,2373,2373,2374,2021-02-26 15:00:00+00:00,Calvert,236.0,14832,859.0,8148,,0,,,8148,14832,22980
2374,2374,2374,2374,2374,2374,2374,2374,2375,2021-02-27 15:00:00+00:00,Calvert,133.0,14965,441.0,8589,,0,,,8589,14965,23554
2375,2375,2375,2375,2375,2375,2375,2375,2376,2021-02-28 15:00:00+00:00,Calvert,160.0,15125,18.0,8607,,0,,,8607,15125,23732
2376,2376,2376,2376,2376,2376,2376,2376,2377,2021-03-01 15:00:00+00:00,Calvert,227.0,15352,340.0,8947,,0,,,8947,15352,24299
2377,2377,2377,2377,2377,2377,2377,2377,2378,2021-03-02 15:00:00+00:00,Calvert,329.0,15681,409.0,9356,,0,,,9356,15681,25037
2378,2378,2378,2378,2378,2378,2378,2378,2379,2021-03-03 15:00:00+00:00,Calvert,275.0,15956,428.0,9784,2.0,2,277.0,430.0,9786,15958,25740
2379,2379,2379,2379,2379,2379,2379,2379,2380,2021-03-04 15:00:00+00:00,Calvert,281.0,16237,506.0,10290,33.0,35,314.0,539.0,10325,16272,26527
2380,2380,2380,2380,2380,2380,2380,2380,2381,2021-03-05 15:00:00+00:00,Calvert,846.0,17083,455.0,10745,24.0,59,870.0,479.0,10804,17142,27828
2381,2381,2381,2381,2381,2381,2381,2381,2382,2021-03-06 15:00:00+00:00,Calvert,493.0,17576,37.0,10782,34.0,93,527.0,71.0,10875,17669,28358
2382,2382,2382,2382,2382,2382,2382,2382,2383,2021-03-07 15:00:00+00:00,Calvert,103.0,17679,31.0,10813,53.0,146,156.0,84.0,10959,17825,28492
2383,2383,2383,2383,2383,2383,2383,2383,2384,2021-03-08 15:00:00+00:00,Calvert,417.0,18096,55.0,10868,101.0,247,518.0,156.0,11115,18343,28964
2384,2384,2384,2384,2384,2384,2384,2384,2385,2021-03-09 15:00:00+00:00,Calvert,367.0,18463,258.0,11126,126.0,373,493.0,384.0,11499,18836,29589
2385,2385,2385,2385,2385,2385,2385,2385,2386,2021-03-10 15:00:00+00:00,Calvert,210.0,18673,88.0,11214,68.0,441,278.0,156.0,11655,19114,29887
2386,2386,2386,2386,2386,2386,2386,2386,2387,2021-03-11 15:00:00+00:00,Calvert,843.0,19516,173.0,11387,18.0,459,861.0,191.0,11846,19975,30903
2387,2387,2387,2387,2387,2387,2387,2387,2388,2021-03-12 15:00:00+00:00,Calvert,161.0,19677,217.0,11604,38.0,497,199.0,255.0,12101,20174,31281
2388,2388,2388,2388,2388,2388,2388,2388,2389,2021-03-13 15:00:00+00:00,Calvert,162.0,19839,81.0,11685,13.0,510,175.0,94.0,12195,20349,31524
2389,2389,2389,2389,2389,2389,2389,2389,2390,2021-03-14 15:00:00+00:00,Calvert,168.0,20007,67.0,11752,2.0,512,170.0,69.0,12264,20519,31759
2390,2390,2390,2390,2390,2390,2390,2390,2391,2021-03-15 15:00:00+00:00,Calvert,222.0,20229,168.0,11920,2.0,514,224.0,170.0,12434,20743,32149
2391,2391,2391,2391,2391,2391,2391,2391,2392,2021-03-16 15:00:00+00:00,Calvert,457.0,20686,116.0,12036,1.0,515,458.0,117.0,12551,21201,32722
2392,2392,2392,2392,2392,2392,2392,2392,2393,2021-02-20 15:00:00+00:00,Charles,96.0,14910,926.0,7164,,0,,,7164,14910,22074
2393,2393,2393,2393,2393,2393,2393,2393,2394,2021-02-21 15:00:00+00:00,Charles,75.0,14985,37.0,7201,,0,,,7201,14985,22186
2394,2394,2394,2394,2394,2394,2394,2394,2395,2021-02-22 15:00:00+00:00,Charles,152.0,15137,170.0,7371,,0,,,7371,15137,22508
2395,2395,2395,2395,2395,2395,2395,2395,2396,2021-02-23 15:00:00+00:00,Charles,803.0,15940,161.0,7532,,0,,,7532,15940,23472
2396,2396,2396,2396,2396,2396,2396,2396,2397,2021-02-24 15:00:00+00:00,Charles,240.0,16180,1176.0,8708,,0,,,8708,16180,24888
2397,2397,2397,2397,2397,2397,2397,2397,2398,2021-02-25 15:00:00+00:00,Charles,811.0,16991,132.0,8840,,0,,,8840,16991,25831
2398,2398,2398,2398,2398,2398,2398,2398,2399,2021-02-26 15:00:00+00:00,Charles,843.0,17834,137.0,8977,,0,,,8977,17834,26811
2399,2399,2399,2399,2399,2399,2399,2399,2400,2021-02-27 15:00:00+00:00,Charles,173.0,18007,64.0,9041,,0,,,9041,18007,27048
2400,2400,2400,2400,2400,2400,2400,2400,2401,2021-02-28 15:00:00+00:00,Charles,206.0,18213,74.0,9115,,0,,,9115,18213,27328
2401,2401,2401,2401,2401,2401,2401,2401,2402,2021-03-01 15:00:00+00:00,Charles,478.0,18691,101.0,9216,,0,,,9216,18691,27907
2402,2402,2402,2402,2402,2402,2402,2402,2403,2021-03-02 15:00:00+00:00,Charles,263.0,18954,116.0,9332,1.0,1,264.0,117.0,9333,18955,28286
2403,2403,2403,2403,2403,2403,2403,2403,2404,2021-03-03 15:00:00+00:00,Charles,538.0,19492,276.0,9608,2.0,3,540.0,278.0,9611,19495,29100
2404,2404,2404,2404,2404,2404,2404,2404,2405,2021-03-04 15:00:00+00:00,Charles,319.0,19811,970.0,10578,29.0,32,348.0,999.0,10610,19843,30389
2405,2405,2405,2405,2405,2405,2405,2405,2406,2021-03-05 15:00:00+00:00,Charles,1211.0,21022,179.0,10757,59.0,91,1270.0,238.0,10848,21113,31779
2406,2406,2406,2406,2406,2406,2406,2406,2407,2021-03-06 15:00:00+00:00,Charles,868.0,21890,49.0,10806,69.0,160,937.0,118.0,10966,22050,32696
2407,2407,2407,2407,2407,2407,2407,2407,2408,2021-03-07 15:00:00+00:00,Charles,136.0,22026,63.0,10869,112.0,272,248.0,175.0,11141,22298,32895
2408,2408,2408,2408,2408,2408,2408,2408,2409,2021-03-08 15:00:00+00:00,Charles,476.0,22502,136.0,11005,156.0,428,632.0,292.0,11433,22930,33507
2409,2409,2409,2409,2409,2409,2409,2409,2410,2021-03-09 15:00:00+00:00,Charles,255.0,22757,599.0,11604,177.0,605,432.0,776.0,12209,23362,34361
2410,2410,2410,2410,2410,2410,2410,2410,2411,2021-03-10 15:00:00+00:00,Charles,1180.0,23937,232.0,11836,194.0,799,1374.0,426.0,12635,24736,35773
2411,2411,2411,2411,2411,2411,2411,2411,2412,2021-03-11 15:00:00+00:00,Charles,401.0,24338,1243.0,13079,47.0,846,448.0,1290.0,13925,25184,37417
2412,2412,2412,2412,2412,2412,2412,2412,2413,2021-03-12 15:00:00+00:00,Charles,1019.0,25357,236.0,13315,105.0,951,1124.0,341.0,14266,26308,38672
2413,2413,2413,2413,2413,2413,2413,2413,2414,2021-03-13 15:00:00+00:00,Charles,530.0,25887,94.0,13409,18.0,969,548.0,112.0,14378,26856,39296
2414,2414,2414,2414,2414,2414,2414,2414,2415,2021-03-14 15:00:00+00:00,Charles,240.0,26127,91.0,13500,8.0,977,248.0,99.0,14477,27104,39627
2415,2415,2415,2415,2415,2415,2415,2415,2416,2021-03-15 15:00:00+00:00,Charles,705.0,26832,229.0,13729,18.0,995,723.0,247.0,14724,27827,40561
2416,2416,2416,2416,2416,2416,2416,2416,2417,2021-03-16 15:00:00+00:00,Charles,506.0,27338,145.0,13874,9.0,1004,515.0,154.0,14878,28342,41212
2417,2417,2417,2417,2417,2417,2417,2417,2418,2021-03-17 15:00:00+00:00,Charles,1575.0,28913,225.0,14099,16.0,1020,1591.0,241.0,15119,29933,43012
2418,2418,2418,2418,2418,2418,2418,2418,2419,2021-03-18 15:00:00+00:00,Charles,488.0,29401,196.0,14295,69.0,1089,557.0,265.0,15384,30490,43696
2419,2419,2419,2419,2419,2419,2419,2419,2420,2021-03-19 15:00:00+00:00,Charles,998.0,30399,121.0,14416,11.0,1100,1009.0,132.0,15516,31499,44815
2420,2420,2420,2420,2420,2420,2420,2420,2421,2021-03-17 15:00:00+00:00,Calvert,358.0,21044,304.0,12340,3.0,518,361.0,307.0,12858,21562,33384
2421,2421,2421,2421,2421,2421,2421,2421,2422,2021-03-18 15:00:00+00:00,Calvert,924.0,21968,124.0,12464,7.0,525,931.0,131.0,12989,22493,34432
2422,2422,2422,2422,2422,2422,2422,2422,2423,2021-03-19 15:00:00+00:00,Calvert,647.0,22615,77.0,12541,1.0,526,648.0,78.0,13067,23141,35156
2423,2423,2423,2423,2423,2423,2423,2423,2424,2021-03-20 15:00:00+00:00,Calvert,169.0,22784,624.0,13165,5.0,531,174.0,629.0,13696,23315,35949
2424,2424,2424,2424,2424,2424,2424,2424,2425,2021-03-21 15:00:00+00:00,Calvert,182.0,22966,40.0,13205,1.0,532,183.0,41.0,13737,23498,36171
2425,2425,2425,2425,2425,2425,2425,2425,2426,2021-03-22 15:00:00+00:00,Calvert,235.0,23201,47.0,13252,2.0,534,237.0,49.0,13786,23735,36453
2426,2426,2426,2426,2426,2426,2426,2426,2427,2021-03-23 15:00:00+00:00,Calvert,255.0,23456,256.0,13508,40.0,574,295.0,296.0,14082,24030,36964
2427,2427,2427,2427,2427,2427,2427,2427,2428,2021-03-24 15:00:00+00:00,Calvert,424.0,23880,357.0,13865,109.0,683,533.0,466.0,14548,24563,37745
2428,2428,2428,2428,2428,2428,2428,2428,2429,2021-03-25 15:00:00+00:00,Calvert,741.0,24621,457.0,14322,66.0,749,807.0,523.0,15071,25370,38943
2429,2429,2429,2429,2429,2429,2429,2429,2430,2021-03-26 15:00:00+00:00,Calvert,874.0,25495,231.0,14553,2.0,751,876.0,233.0,15304,26246,40048
2430,2430,2430,2430,2430,2430,2430,2430,2431,2021-03-27 15:00:00+00:00,Calvert,462.0,25957,437.0,14990,5.0,756,467.0,442.0,15746,26713,40947
2431,2431,2431,2431,2431,2431,2431,2431,2432,2021-03-28 15:00:00+00:00,Calvert,300.0,26257,120.0,15110,5.0,761,305.0,125.0,15871,27018,41367
2432,2432,2432,2432,2432,2432,2432,2432,2433,2021-03-29 15:00:00+00:00,Calvert,367.0,26624,217.0,15327,7.0,768,374.0,224.0,16095,27392,41951
2433,2433,2433,2433,2433,2433,2433,2433,2434,2021-03-30 15:00:00+00:00,Calvert,393.0,27017,301.0,15628,82.0,850,475.0,383.0,16478,27867,42645
2434,2434,2434,2434,2434,2434,2434,2434,2435,2021-03-31 15:00:00+00:00,Calvert,567.0,27584,458.0,16086,151.0,1001,718.0,609.0,17087,28585,43670
2435,2435,2435,2435,2435,2435,2435,2435,2436,2021-04-01 15:00:00+00:00,Calvert,817.0,28401,496.0,16582,103.0,1104,920.0,599.0,17686,29505,44983
2436,2436,2436,2436,2436,2436,2436,2436,2437,2021-04-02 15:00:00+00:00,Calvert,254.0,28655,249.0,16831,86.0,1190,340.0,335.0,18021,29845,45486
2437,2437,2437,2437,2437,2437,2437,2437,2438,2021-04-03 15:00:00+00:00,Calvert,158.0,28813,623.0,17454,54.0,1244,212.0,677.0,18698,30057,46267
2438,2438,2438,2438,2438,2438,2438,2438,2439,2021-04-04 15:00:00+00:00,Calvert,104.0,28917,148.0,17602,21.0,1265,125.0,169.0,18867,30182,46519
2439,2439,2439,2439,2439,2439,2439,2439,2440,2021-04-05 15:00:00+00:00,Calvert,294.0,29211,236.0,17838,74.0,1339,368.0,310.0,19177,30550,47049
2440,2440,2440,2440,2440,2440,2440,2440,2441,2021-04-06 15:00:00+00:00,Calvert,606.0,29817,388.0,18226,288.0,1627,894.0,676.0,19853,31444,48043
2441,2441,2441,2441,2441,2441,2441,2441,2442,2021-04-07 15:00:00+00:00,Calvert,253.0,30070,322.0,18548,126.0,1753,379.0,448.0,20301,31823,48618
2442,2442,2442,2442,2442,2442,2442,2442,2443,2021-04-08 15:00:00+00:00,Calvert,839.0,30909,420.0,18968,120.0,1873,959.0,540.0,20841,32782,49877
2443,2443,2443,2443,2443,2443,2443,2443,2444,2021-04-09 15:00:00+00:00,Calvert,325.0,31234,265.0,19233,160.0,2033,485.0,425.0,21266,33267,50467
2444,2444,2444,2444,2444,2444,2444,2444,2445,2021-04-10 15:00:00+00:00,Calvert,670.0,31904,559.0,19792,146.0,2179,816.0,705.0,21971,34083,51696
2445,2445,2445,2445,2445,2445,2445,2445,2446,2021-04-11 15:00:00+00:00,Calvert,223.0,32127,135.0,19927,81.0,2260,304.0,216.0,22187,34387,52054
2446,2446,2446,2446,2446,2446,2446,2446,2447,2021-04-12 15:00:00+00:00,Calvert,285.0,32412,257.0,20184,149.0,2409,434.0,406.0,22593,34821,52596
2447,2447,2447,2447,2447,2447,2447,2447,2448,2021-04-13 15:00:00+00:00,Calvert,660.0,33072,455.0,20639,9.0,2418,669.0,464.0,23057,35490,53711
2448,2448,2448,2448,2448,2448,2448,2448,2449,2021-08-22 15:00:00+00:00,Carroll,86.0,98185,71.0,91245,,9913,,,101158,108098,189430
2449,2449,2449,2449,2449,2449,2449,2449,2450,2021-08-23 15:00:00+00:00,Carroll,142.0,98327,157.0,91402,15.0,9928,157.0,172.0,101330,108255,189729
2450,2450,2450,2450,2450,2450,2450,2450,2451,2021-08-24 15:00:00+00:00,Carroll,161.0,98488,128.0,91530,26.0,9954,187.0,154.0,101484,108442,190018
2451,2451,2451,2451,2451,2451,2451,2451,2452,2021-08-25 15:00:00+00:00,Carroll,146.0,98634,129.0,91659,11.0,9965,157.0,140.0,101624,108599,190293
2452,2452,2452,2452,2452,2452,2452,2452,2453,2021-08-26 15:00:00+00:00,Carroll,134.0,98768,136.0,91795,13.0,9978,147.0,149.0,101773,108746,190563
2453,2453,2453,2453,2453,2453,2453,2453,2454,2021-08-27 15:00:00+00:00,Carroll,167.0,98935,179.0,91974,26.0,10004,193.0,205.0,101978,108939,190909
2454,2454,2454,2454,2454,2454,2454,2454,2455,2021-08-28 15:00:00+00:00,Carroll,131.0,99066,121.0,92095,8.0,10012,139.0,129.0,102107,109078,191161
2455,2455,2455,2455,2455,2455,2455,2455,2456,2021-08-29 15:00:00+00:00,Carroll,73.0,99139,72.0,92167,3.0,10015,76.0,75.0,102182,109154,191306
2456,2456,2456,2456,2456,2456,2456,2456,2457,2021-08-30 15:00:00+00:00,Carroll,128.0,99267,148.0,92315,23.0,10038,151.0,171.0,102353,109305,191582
2457,2457,2457,2457,2457,2457,2457,2457,2458,2021-08-31 15:00:00+00:00,Carroll,131.0,99398,146.0,92461,21.0,10059,152.0,167.0,102520,109457,191859
2458,2458,2458,2458,2458,2458,2458,2458,2459,2021-09-01 15:00:00+00:00,Carroll,118.0,99516,153.0,92614,18.0,10077,136.0,171.0,102691,109593,192130
2459,2459,2459,2459,2459,2459,2459,2459,2460,2021-09-02 15:00:00+00:00,Carroll,127.0,99643,129.0,92743,7.0,10084,134.0,136.0,102827,109727,192386
2460,2460,2460,2460,2460,2460,2460,2460,2461,2021-09-03 15:00:00+00:00,Carroll,131.0,99774,193.0,92936,13.0,10097,144.0,206.0,103033,109871,192710
2461,2461,2461,2461,2461,2461,2461,2461,2462,2021-09-04 15:00:00+00:00,Carroll,91.0,99865,118.0,93054,8.0,10105,99.0,126.0,103159,109970,192919
2462,2462,2462,2462,2462,2462,2462,2462,2463,2021-09-05 15:00:00+00:00,Carroll,44.0,99909,101.0,93155,3.0,10108,47.0,104.0,103263,110017,193064
2463,2463,2463,2463,2463,2463,2463,2463,2464,2021-09-06 15:00:00+00:00,Carroll,18.0,99927,38.0,93193,1.0,10109,19.0,39.0,103302,110036,193120
2464,2464,2464,2464,2464,2464,2464,2464,2465,2021-09-07 15:00:00+00:00,Carroll,112.0,100039,197.0,93390,13.0,10122,125.0,210.0,103512,110161,193429
2465,2465,2465,2465,2465,2465,2465,2465,2466,2021-09-08 15:00:00+00:00,Carroll,79.0,100118,112.0,93502,18.0,10140,97.0,130.0,103642,110258,193620
2466,2466,2466,2466,2466,2466,2466,2466,2467,2021-09-09 15:00:00+00:00,Carroll,90.0,100208,149.0,93651,14.0,10154,104.0,163.0,103805,110362,193859
2467,2467,2467,2467,2467,2467,2467,2467,2468,2021-09-10 15:00:00+00:00,Carroll,117.0,100325,174.0,93825,25.0,10179,142.0,199.0,104004,110504,194150
2468,2468,2468,2468,2468,2468,2468,2468,2469,2021-09-11 15:00:00+00:00,Carroll,76.0,100401,101.0,93926,10.0,10189,86.0,111.0,104115,110590,194327
2469,2469,2469,2469,2469,2469,2469,2469,2470,2021-09-12 15:00:00+00:00,Carroll,49.0,100450,77.0,94003,1.0,10190,50.0,78.0,104193,110640,194453
2470,2470,2470,2470,2470,2470,2470,2470,2471,2021-09-13 15:00:00+00:00,Carroll,91.0,100541,149.0,94152,8.0,10198,99.0,157.0,104350,110739,194693
2471,2471,2471,2471,2471,2471,2471,2471,2472,2021-09-14 15:00:00+00:00,Carroll,74.0,100615,152.0,94304,16.0,10214,90.0,168.0,104518,110829,194919
2472,2472,2472,2472,2472,2472,2472,2472,2473,2021-09-15 15:00:00+00:00,Carroll,100.0,100715,150.0,94454,7.0,10221,107.0,157.0,104675,110936,195169
2473,2473,2473,2473,2473,2473,2473,2473,2474,2021-09-16 15:00:00+00:00,Carroll,85.0,100800,131.0,94585,10.0,10231,95.0,141.0,104816,111031,195385
2474,2474,2474,2474,2474,2474,2474,2474,2475,2021-09-17 15:00:00+00:00,Carroll,66.0,100866,168.0,94753,16.0,10247,82.0,184.0,105000,111113,195619
2475,2475,2475,2475,2475,2475,2475,2475,2476,2021-09-18 15:00:00+00:00,Carroll,75.0,100941,105.0,94858,3.0,10250,78.0,108.0,105108,111191,195799
2476,2476,2476,2476,2476,2476,2476,2476,2477,2021-09-19 15:00:00+00:00,Carroll,39.0,100980,79.0,94937,1.0,10251,40.0,80.0,105188,111231,195917
2477,2477,2477,2477,2477,2477,2477,2477,2478,2021-09-20 15:00:00+00:00,Carroll,62.0,101042,82.0,95019,13.0,10264,75.0,95.0,105283,111306,196061
2478,2478,2478,2478,2478,2478,2478,2478,2479,2021-09-21 15:00:00+00:00,Carroll,70.0,101112,106.0,95125,15.0,10279,85.0,121.0,105404,111391,196237
2479,2479,2479,2479,2479,2479,2479,2479,2480,2021-09-22 15:00:00+00:00,Carroll,75.0,101187,102.0,95227,11.0,10290,86.0,113.0,105517,111477,196414
2480,2480,2480,2480,2480,2480,2480,2480,2481,2021-09-23 15:00:00+00:00,Carroll,78.0,101265,110.0,95337,8.0,10298,86.0,118.0,105635,111563,196602
2481,2481,2481,2481,2481,2481,2481,2481,2482,2021-09-24 15:00:00+00:00,Carroll,102.0,101367,154.0,95491,14.0,10312,116.0,168.0,105803,111679,196858
2482,2482,2482,2482,2482,2482,2482,2482,2483,2021-09-25 15:00:00+00:00,Carroll,50.0,101417,105.0,95596,3.0,10315,53.0,108.0,105911,111732,197013
2483,2483,2483,2483,2483,2483,2483,2483,2484,2021-09-26 15:00:00+00:00,Carroll,40.0,101457,51.0,95647,,10315,,,105962,111772,197104
2484,2484,2484,2484,2484,2484,2484,2484,2485,2021-09-27 15:00:00+00:00,Carroll,82.0,101539,68.0,95715,9.0,10324,91.0,77.0,106039,111863,197254
2485,2485,2485,2485,2485,2485,2485,2485,2486,2021-09-28 15:00:00+00:00,Carroll,71.0,101610,92.0,95807,11.0,10335,82.0,103.0,106142,111945,197417
2486,2486,2486,2486,2486,2486,2486,2486,2487,2021-09-29 15:00:00+00:00,Carroll,80.0,101690,72.0,95879,15.0,10350,95.0,87.0,106229,112040,197569
2487,2487,2487,2487,2487,2487,2487,2487,2488,2021-09-30 15:00:00+00:00,Carroll,81.0,101771,79.0,95958,7.0,10357,88.0,86.0,106315,112128,197729
2488,2488,2488,2488,2488,2488,2488,2488,2489,2021-10-01 15:00:00+00:00,Carroll,95.0,101866,96.0,96054,14.0,10371,109.0,110.0,106425,112237,197920
2489,2489,2489,2489,2489,2489,2489,2489,2490,2021-10-02 15:00:00+00:00,Carroll,34.0,101900,79.0,96133,3.0,10374,37.0,82.0,106507,112274,198033
2490,2490,2490,2490,2490,2490,2490,2490,2491,2021-10-03 15:00:00+00:00,Carroll,30.0,101930,53.0,96186,,10374,,,106560,112304,198116
2491,2491,2491,2491,2491,2491,2491,2491,2492,2021-10-04 15:00:00+00:00,Carroll,75.0,102005,81.0,96267,6.0,10380,81.0,87.0,106647,112385,198272
2492,2492,2492,2492,2492,2492,2492,2492,2493,2021-10-05 15:00:00+00:00,Carroll,86.0,102091,90.0,96357,4.0,10384,90.0,94.0,106741,112475,198448
2493,2493,2493,2493,2493,2493,2493,2493,2494,2021-10-06 15:00:00+00:00,Carroll,84.0,102175,71.0,96428,3.0,10387,87.0,74.0,106815,112562,198603
2494,2494,2494,2494,2494,2494,2494,2494,2495,2021-10-07 15:00:00+00:00,Carroll,90.0,102265,101.0,96529,8.0,10395,98.0,109.0,106924,112660,198794
2495,2495,2495,2495,2495,2495,2495,2495,2496,2021-10-08 15:00:00+00:00,Carroll,81.0,102346,78.0,96607,12.0,10407,93.0,90.0,107014,112753,198953
2496,2496,2496,2496,2496,2496,2496,2496,2497,2021-10-09 15:00:00+00:00,Carroll,32.0,102378,55.0,96662,6.0,10413,38.0,61.0,107075,112791,199040
2497,2497,2497,2497,2497,2497,2497,2497,2498,2021-10-10 15:00:00+00:00,Carroll,26.0,102404,50.0,96712,,10413,,,107125,112817,199116
2498,2498,2498,2498,2498,2498,2498,2498,2499,2021-10-11 15:00:00+00:00,Carroll,69.0,102473,67.0,96779,6.0,10419,75.0,73.0,107198,112892,199252
2499,2499,2499,2499,2499,2499,2499,2499,2500,2021-10-12 15:00:00+00:00,Carroll,64.0,102537,57.0,96836,5.0,10424,69.0,62.0,107260,112961,199373
2500,2500,2500,2500,2500,2500,2500,2500,2501,2021-10-13 15:00:00+00:00,Carroll,65.0,102602,59.0,96895,9.0,10433,74.0,68.0,107328,113035,199497
2501,2501,2501,2501,2501,2501,2501,2501,2502,2021-10-14 15:00:00+00:00,Carroll,68.0,102670,79.0,96974,13.0,10446,81.0,92.0,107420,113116,199644
2502,2502,2502,2502,2502,2502,2502,2502,2503,2021-10-15 15:00:00+00:00,Carroll,79.0,102749,101.0,97075,18.0,10464,97.0,119.0,107539,113213,199824
2503,2503,2503,2503,2503,2503,2503,2503,2504,2021-10-16 15:00:00+00:00,Carroll,40.0,102789,60.0,97135,3.0,10467,43.0,63.0,107602,113256,199924
2504,2504,2504,2504,2504,2504,2504,2504,2505,2021-10-17 15:00:00+00:00,Carroll,30.0,102819,25.0,97160,,10467,,,107627,113286,199979
2505,2505,2505,2505,2505,2505,2505,2505,2506,2021-10-18 15:00:00+00:00,Carroll,72.0,102891,79.0,97239,17.0,10484,89.0,96.0,107723,113375,200130
2506,2506,2506,2506,2506,2506,2506,2506,2507,2021-10-19 15:00:00+00:00,Carroll,58.0,102949,60.0,97299,8.0,10492,66.0,68.0,107791,113441,200248
2507,2507,2507,2507,2507,2507,2507,2507,2508,2021-10-20 15:00:00+00:00,Carroll,43.0,102992,66.0,97365,10.0,10502,53.0,76.0,107867,113494,200357
2508,2508,2508,2508,2508,2508,2508,2508,2509,2021-10-21 15:00:00+00:00,Carroll,62.0,103054,79.0,97444,13.0,10515,75.0,92.0,107959,113569,200498
2509,2509,2509,2509,2509,2509,2509,2509,2510,2021-10-22 15:00:00+00:00,Carroll,73.0,103127,162.0,97606,12.0,10527,85.0,174.0,108133,113654,200733
2510,2510,2510,2510,2510,2510,2510,2510,2511,2021-10-23 15:00:00+00:00,Carroll,46.0,103173,80.0,97686,3.0,10530,49.0,83.0,108216,113703,200859
2511,2511,2511,2511,2511,2511,2511,2511,2512,2021-10-24 15:00:00+00:00,Carroll,45.0,103218,74.0,97760,,10530,,,108290,113748,200978
2512,2512,2512,2512,2512,2512,2512,2512,2513,2021-10-25 15:00:00+00:00,Carroll,84.0,103302,164.0,97924,6.0,10536,90.0,170.0,108460,113838,201226
2513,2513,2513,2513,2513,2513,2513,2513,2514,2021-10-26 15:00:00+00:00,Carroll,85.0,103387,168.0,98092,12.0,10548,97.0,180.0,108640,113935,201479
2514,2514,2514,2514,2514,2514,2514,2514,2515,2021-10-27 15:00:00+00:00,Carroll,78.0,103465,172.0,98264,7.0,10555,85.0,179.0,108819,114020,201729
2515,2515,2515,2515,2515,2515,2515,2515,2516,2021-10-28 15:00:00+00:00,Carroll,85.0,103550,186.0,98450,4.0,10559,89.0,190.0,109009,114109,202000
2516,2516,2516,2516,2516,2516,2516,2516,2517,2021-10-29 15:00:00+00:00,Carroll,73.0,103623,154.0,98604,14.0,10573,87.0,168.0,109177,114196,202227
2517,2517,2517,2517,2517,2517,2517,2517,2518,2021-10-30 15:00:00+00:00,Carroll,43.0,103666,73.0,98677,1.0,10574,44.0,74.0,109251,114240,202343
2518,2518,2518,2518,2518,2518,2518,2518,2519,2021-10-31 15:00:00+00:00,Carroll,28.0,103694,50.0,98727,,10574,,,109301,114268,202421
2519,2519,2519,2519,2519,2519,2519,2519,2520,2021-11-01 15:00:00+00:00,Carroll,67.0,103761,163.0,98890,11.0,10585,78.0,174.0,109475,114346,202651
2520,2520,2520,2520,2520,2520,2520,2520,2521,2021-11-02 15:00:00+00:00,Carroll,73.0,103834,161.0,99051,7.0,10592,80.0,168.0,109643,114426,202885
2521,2521,2521,2521,2521,2521,2521,2521,2522,2021-11-03 15:00:00+00:00,Carroll,61.0,103895,161.0,99212,13.0,10605,74.0,174.0,109817,114500,203107
2522,2522,2522,2522,2522,2522,2522,2522,2523,2021-11-04 15:00:00+00:00,Carroll,73.0,103968,159.0,99371,7.0,10612,80.0,166.0,109983,114580,203339
2523,2523,2523,2523,2523,2523,2523,2523,2524,2021-11-05 15:00:00+00:00,Carroll,59.0,104027,160.0,99531,14.0,10626,73.0,174.0,110157,114653,203558
2524,2524,2524,2524,2524,2524,2524,2524,2525,2021-11-06 15:00:00+00:00,Carroll,20.0,104047,53.0,99584,3.0,10629,23.0,56.0,110213,114676,203631
2525,2525,2525,2525,2525,2525,2525,2525,2526,2020-12-15 15:00:00+00:00,Dorchester,2.0,2,,0,,0,,,0,2,2
2526,2526,2526,2526,2526,2526,2526,2526,2527,2020-12-16 15:00:00+00:00,Dorchester,4.0,6,,0,,0,,,0,6,6
2527,2527,2527,2527,2527,2527,2527,2527,2528,2020-12-17 15:00:00+00:00,Dorchester,16.0,22,,0,,0,,,0,22,22
2528,2528,2528,2528,2528,2528,2528,2528,2529,2020-12-18 15:00:00+00:00,Dorchester,11.0,33,,0,,0,,,0,33,33
2529,2529,2529,2529,2529,2529,2529,2529,2530,2020-12-19 15:00:00+00:00,Dorchester,2.0,35,,0,,0,,,0,35,35
2530,2530,2530,2530,2530,2530,2530,2530,2531,2020-12-20 15:00:00+00:00,Dorchester,1.0,36,,0,,0,,,0,36,36
2531,2531,2531,2531,2531,2531,2531,2531,2532,2020-12-21 15:00:00+00:00,Dorchester,9.0,45,,0,,0,,,0,45,45
2532,2532,2532,2532,2532,2532,2532,2532,2533,2020-12-22 15:00:00+00:00,Dorchester,18.0,63,,0,,0,,,0,63,63
2533,2533,2533,2533,2533,2533,2533,2533,2534,2020-12-23 15:00:00+00:00,Dorchester,37.0,100,2.0,2,,0,,,2,100,102
2534,2534,2534,2534,2534,2534,2534,2534,2535,2020-12-24 15:00:00+00:00,Dorchester,30.0,130,,2,,0,,,2,130,132
2535,2535,2535,2535,2535,2535,2535,2535,2536,2020-12-25 15:00:00+00:00,Dorchester,69.0,199,,2,,0,,,2,199,201
2536,2536,2536,2536,2536,2536,2536,2536,2537,2020-12-26 15:00:00+00:00,Dorchester,9.0,208,,2,,0,,,2,208,210
2537,2537,2537,2537,2537,2537,2537,2537,2538,2020-12-27 15:00:00+00:00,Dorchester,4.0,212,,2,,0,,,2,212,214
2538,2538,2538,2538,2538,2538,2538,2538,2539,2020-12-28 15:00:00+00:00,Dorchester,51.0,263,1.0,3,,0,,,3,263,266
2539,2539,2539,2539,2539,2539,2539,2539,2540,2020-12-29 15:00:00+00:00,Dorchester,51.0,314,,3,,0,,,3,314,317
2540,2540,2540,2540,2540,2540,2540,2540,2541,2020-12-30 15:00:00+00:00,Dorchester,139.0,453,3.0,6,,0,,,6,453,459
2541,2541,2541,2541,2541,2541,2541,2541,2542,2020-12-31 15:00:00+00:00,Dorchester,62.0,515,1.0,7,,0,,,7,515,522
2542,2542,2542,2542,2542,2542,2542,2542,2543,2021-01-01 15:00:00+00:00,Dorchester,18.0,533,,7,,0,,,7,533,540
2543,2543,2543,2543,2543,2543,2543,2543,2544,2021-01-02 15:00:00+00:00,Dorchester,32.0,565,,7,,0,,,7,565,572
2544,2544,2544,2544,2544,2544,2544,2544,2545,2021-01-03 15:00:00+00:00,Dorchester,28.0,593,5.0,12,,0,,,12,593,605
2545,2545,2545,2545,2545,2545,2545,2545,2546,2021-01-04 15:00:00+00:00,Dorchester,58.0,651,,12,,0,,,12,651,663
2546,2546,2546,2546,2546,2546,2546,2546,2547,2021-01-05 15:00:00+00:00,Dorchester,223.0,874,2.0,14,,0,,,14,874,888
2547,2547,2547,2547,2547,2547,2547,2547,2548,2021-01-06 15:00:00+00:00,Dorchester,60.0,934,7.0,21,,0,,,21,934,955
2548,2548,2548,2548,2548,2548,2548,2548,2549,2021-01-07 15:00:00+00:00,Dorchester,113.0,1047,18.0,39,,0,,,39,1047,1086
2549,2549,2549,2549,2549,2549,2549,2549,2550,2021-01-08 15:00:00+00:00,Dorchester,129.0,1176,12.0,51,,0,,,51,1176,1227
2550,2550,2550,2550,2550,2550,2550,2550,2551,2021-01-09 15:00:00+00:00,Dorchester,9.0,1185,2.0,53,,0,,,53,1185,1238
2551,2551,2551,2551,2551,2551,2551,2551,2552,2021-01-11 15:00:00+00:00,Dorchester,27.0,1212,8.0,61,,0,,,61,1212,1273
2552,2552,2552,2552,2552,2552,2552,2552,2553,2021-01-12 15:00:00+00:00,Dorchester,142.0,1354,13.0,74,,0,,,74,1354,1428
2553,2553,2553,2553,2553,2553,2553,2553,2554,2021-01-13 15:00:00+00:00,Dorchester,31.0,1385,11.0,85,,0,,,85,1385,1470
2554,2554,2554,2554,2554,2554,2554,2554,2555,2021-01-14 15:00:00+00:00,Dorchester,170.0,1555,4.0,89,,0,,,89,1555,1644
2555,2555,2555,2555,2555,2555,2555,2555,2556,2021-01-15 15:00:00+00:00,Dorchester,266.0,1821,43.0,132,,0,,,132,1821,1953
2556,2556,2556,2556,2556,2556,2556,2556,2557,2021-01-16 15:00:00+00:00,Dorchester,9.0,1830,2.0,134,,0,,,134,1830,1964
2557,2557,2557,2557,2557,2557,2557,2557,2558,2021-01-17 15:00:00+00:00,Dorchester,4.0,1834,5.0,139,,0,,,139,1834,1973
2558,2558,2558,2558,2558,2558,2558,2558,2559,2021-01-18 15:00:00+00:00,Dorchester,9.0,1843,17.0,156,,0,,,156,1843,1999
2559,2559,2559,2559,2559,2559,2559,2559,2560,2021-01-19 15:00:00+00:00,Dorchester,216.0,2059,6.0,162,,0,,,162,2059,2221
2560,2560,2560,2560,2560,2560,2560,2560,2561,2021-01-20 15:00:00+00:00,Dorchester,58.0,2117,77.0,239,,0,,,239,2117,2356
2561,2561,2561,2561,2561,2561,2561,2561,2562,2021-01-21 15:00:00+00:00,Dorchester,223.0,2340,26.0,265,,0,,,265,2340,2605
2562,2562,2562,2562,2562,2562,2562,2562,2563,2021-01-22 15:00:00+00:00,Dorchester,237.0,2577,21.0,286,,0,,,286,2577,2863
2563,2563,2563,2563,2563,2563,2563,2563,2564,2021-01-23 15:00:00+00:00,Dorchester,2.0,2579,24.0,310,,0,,,310,2579,2889
2564,2564,2564,2564,2564,2564,2564,2564,2565,2021-01-24 15:00:00+00:00,Dorchester,1.0,2580,2.0,312,,0,,,312,2580,2892
2565,2565,2565,2565,2565,2565,2565,2565,2566,2021-01-25 15:00:00+00:00,Dorchester,78.0,2658,38.0,350,,0,,,350,2658,3008
2566,2566,2566,2566,2566,2566,2566,2566,2567,2021-01-26 15:00:00+00:00,Dorchester,113.0,2771,136.0,486,,0,,,486,2771,3257
2567,2567,2567,2567,2567,2567,2567,2567,2568,2021-01-27 15:00:00+00:00,Dorchester,48.0,2819,50.0,536,,0,,,536,2819,3355
2568,2568,2568,2568,2568,2568,2568,2568,2569,2021-01-28 15:00:00+00:00,Dorchester,60.0,2879,75.0,611,,0,,,611,2879,3490
2569,2569,2569,2569,2569,2569,2569,2569,2570,2021-01-29 15:00:00+00:00,Dorchester,130.0,3009,48.0,659,,0,,,659,3009,3668
2570,2570,2570,2570,2570,2570,2570,2570,2571,2021-01-30 15:00:00+00:00,Dorchester,10.0,3019,4.0,663,,0,,,663,3019,3682
2571,2571,2571,2571,2571,2571,2571,2571,2572,2021-01-31 15:00:00+00:00,Dorchester,7.0,3026,,663,,0,,,663,3026,3689
2572,2572,2572,2572,2572,2572,2572,2572,2573,2021-02-01 15:00:00+00:00,Dorchester,89.0,3115,16.0,679,,0,,,679,3115,3794
2573,2573,2573,2573,2573,2573,2573,2573,2574,2021-02-02 15:00:00+00:00,Dorchester,119.0,3234,127.0,806,,0,,,806,3234,4040
2574,2574,2574,2574,2574,2574,2574,2574,2575,2021-02-03 15:00:00+00:00,Dorchester,62.0,3296,47.0,853,,0,,,853,3296,4149
2575,2575,2575,2575,2575,2575,2575,2575,2576,2021-02-04 15:00:00+00:00,Dorchester,133.0,3429,107.0,960,,0,,,960,3429,4389
2576,2576,2576,2576,2576,2576,2576,2576,2577,2021-02-05 15:00:00+00:00,Dorchester,58.0,3487,139.0,1099,,0,,,1099,3487,4586
2577,2577,2577,2577,2577,2577,2577,2577,2578,2021-02-06 15:00:00+00:00,Dorchester,3.0,3490,6.0,1105,,0,,,1105,3490,4595
2578,2578,2578,2578,2578,2578,2578,2578,2579,2021-02-07 15:00:00+00:00,Dorchester,2.0,3492,2.0,1107,,0,,,1107,3492,4599
2579,2579,2579,2579,2579,2579,2579,2579,2580,2021-02-08 15:00:00+00:00,Dorchester,85.0,3577,26.0,1133,,0,,,1133,3577,4710
2580,2580,2580,2580,2580,2580,2580,2580,2581,2021-02-09 15:00:00+00:00,Dorchester,116.0,3693,143.0,1276,,0,,,1276,3693,4969
2581,2581,2581,2581,2581,2581,2581,2581,2582,2021-02-10 15:00:00+00:00,Dorchester,86.0,3779,44.0,1320,,0,,,1320,3779,5099
2582,2582,2582,2582,2582,2582,2582,2582,2583,2021-02-11 15:00:00+00:00,Dorchester,109.0,3888,162.0,1482,,0,,,1482,3888,5370
2583,2583,2583,2583,2583,2583,2583,2583,2584,2021-02-12 15:00:00+00:00,Dorchester,75.0,3963,171.0,1653,,0,,,1653,3963,5616
2584,2584,2584,2584,2584,2584,2584,2584,2585,2021-02-13 15:00:00+00:00,Dorchester,22.0,3985,3.0,1656,,0,,,1656,3985,5641
2585,2585,2585,2585,2585,2585,2585,2585,2586,2021-02-14 15:00:00+00:00,Dorchester,2.0,3987,5.0,1661,,0,,,1661,3987,5648
2586,2586,2586,2586,2586,2586,2586,2586,2587,2021-02-15 15:00:00+00:00,Dorchester,8.0,3995,7.0,1668,,0,,,1668,3995,5663
2587,2587,2587,2587,2587,2587,2587,2587,2588,2021-02-16 15:00:00+00:00,Dorchester,51.0,4046,259.0,1927,,0,,,1927,4046,5973
2588,2588,2588,2588,2588,2588,2588,2588,2589,2021-02-17 15:00:00+00:00,Dorchester,222.0,4268,67.0,1994,,0,,,1994,4268,6262
2589,2589,2589,2589,2589,2589,2589,2589,2590,2021-02-18 15:00:00+00:00,Dorchester,23.0,4291,138.0,2132,,0,,,2132,4291,6423
2590,2590,2590,2590,2590,2590,2590,2590,2591,2021-02-19 15:00:00+00:00,Dorchester,41.0,4332,204.0,2336,,0,,,2336,4332,6668
2591,2591,2591,2591,2591,2591,2591,2591,2592,2021-02-20 15:00:00+00:00,Dorchester,9.0,4341,8.0,2344,,0,,,2344,4341,6685
2592,2592,2592,2592,2592,2592,2592,2592,2593,2021-02-21 15:00:00+00:00,Dorchester,6.0,4347,2.0,2346,,0,,,2346,4347,6693
2593,2593,2593,2593,2593,2593,2593,2593,2594,2021-02-22 15:00:00+00:00,Dorchester,17.0,4364,24.0,2370,,0,,,2370,4364,6734
2594,2594,2594,2594,2594,2594,2594,2594,2595,2021-02-23 15:00:00+00:00,Dorchester,14.0,4378,82.0,2452,,0,,,2452,4378,6830
2595,2595,2595,2595,2595,2595,2595,2595,2596,2021-02-24 15:00:00+00:00,Dorchester,74.0,4452,98.0,2550,,0,,,2550,4452,7002
2596,2596,2596,2596,2596,2596,2596,2596,2597,2021-02-25 15:00:00+00:00,Dorchester,79.0,4531,191.0,2741,,0,,,2741,4531,7272
2597,2597,2597,2597,2597,2597,2597,2597,2598,2021-02-26 15:00:00+00:00,Dorchester,85.0,4616,144.0,2885,,0,,,2885,4616,7501
2598,2598,2598,2598,2598,2598,2598,2598,2599,2021-02-27 15:00:00+00:00,Dorchester,18.0,4634,1.0,2886,,0,,,2886,4634,7520
2599,2599,2599,2599,2599,2599,2599,2599,2600,2021-02-28 15:00:00+00:00,Dorchester,12.0,4646,4.0,2890,,0,,,2890,4646,7536
2600,2600,2600,2600,2600,2600,2600,2600,2601,2021-03-01 15:00:00+00:00,Dorchester,101.0,4747,79.0,2969,,0,,,2969,4747,7716
2601,2601,2601,2601,2601,2601,2601,2601,2602,2021-03-02 15:00:00+00:00,Dorchester,195.0,4942,125.0,3094,1.0,1,196.0,126.0,3095,4943,8036
2602,2602,2602,2602,2602,2602,2602,2602,2603,2021-03-03 15:00:00+00:00,Dorchester,193.0,5135,54.0,3148,2.0,3,195.0,56.0,3151,5138,8283
2603,2603,2603,2603,2603,2603,2603,2603,2604,2021-03-04 15:00:00+00:00,Dorchester,271.0,5406,150.0,3298,4.0,7,275.0,154.0,3305,5413,8704
2604,2604,2604,2604,2604,2604,2604,2604,2605,2021-03-05 15:00:00+00:00,Dorchester,114.0,5520,37.0,3335,34.0,41,148.0,71.0,3376,5561,8855
2605,2605,2605,2605,2605,2605,2605,2605,2606,2021-03-06 15:00:00+00:00,Dorchester,25.0,5545,48.0,3383,66.0,107,91.0,114.0,3490,5652,8928
2606,2606,2606,2606,2606,2606,2606,2606,2607,2021-03-07 15:00:00+00:00,Dorchester,26.0,5571,6.0,3389,34.0,141,60.0,40.0,3530,5712,8960
2607,2607,2607,2607,2607,2607,2607,2607,2608,2021-03-08 15:00:00+00:00,Dorchester,155.0,5726,84.0,3473,7.0,148,162.0,91.0,3621,5874,9199
2608,2608,2608,2608,2608,2608,2608,2608,2609,2021-03-09 15:00:00+00:00,Dorchester,251.0,5977,102.0,3575,4.0,152,255.0,106.0,3727,6129,9552
2609,2609,2609,2609,2609,2609,2609,2609,2610,2021-03-10 15:00:00+00:00,Dorchester,320.0,6297,56.0,3631,2.0,154,322.0,58.0,3785,6451,9928
2610,2610,2610,2610,2610,2610,2610,2610,2611,2021-03-11 15:00:00+00:00,Dorchester,200.0,6497,171.0,3802,2.0,156,202.0,173.0,3958,6653,10299
2611,2611,2611,2611,2611,2611,2611,2611,2612,2021-03-12 15:00:00+00:00,Dorchester,45.0,6542,28.0,3830,72.0,228,117.0,100.0,4058,6770,10372
2612,2612,2612,2612,2612,2612,2612,2612,2613,2021-03-13 15:00:00+00:00,Dorchester,17.0,6559,9.0,3839,323.0,551,340.0,332.0,4390,7110,10398
2613,2613,2613,2613,2613,2613,2613,2613,2614,2021-03-14 15:00:00+00:00,Dorchester,9.0,6568,2.0,3841,163.0,714,172.0,165.0,4555,7282,10409
2614,2614,2614,2614,2614,2614,2614,2614,2615,2021-03-15 15:00:00+00:00,Dorchester,221.0,6789,30.0,3871,3.0,717,224.0,33.0,4588,7506,10660
2615,2615,2615,2615,2615,2615,2615,2615,2616,2021-03-16 15:00:00+00:00,Dorchester,124.0,6913,141.0,4012,,717,,,4729,7630,10925
2616,2616,2616,2616,2616,2616,2616,2616,2617,2021-04-14 15:00:00+00:00,Calvert,402.0,33474,437.0,21076,1.0,2419,403.0,438.0,23495,35893,54550
2617,2617,2617,2617,2617,2617,2617,2617,2618,2021-04-15 15:00:00+00:00,Calvert,674.0,34148,688.0,21764,,2419,,,24183,36567,55912
2618,2618,2618,2618,2618,2618,2618,2618,2619,2021-04-16 15:00:00+00:00,Calvert,342.0,34490,654.0,22418,,2419,,,24837,36909,56908
2619,2619,2619,2619,2619,2619,2619,2619,2620,2021-04-17 15:00:00+00:00,Calvert,242.0,34732,682.0,23100,,2419,,,25519,37151,57832
2620,2620,2620,2620,2620,2620,2620,2620,2621,2021-04-18 15:00:00+00:00,Calvert,219.0,34951,270.0,23370,,2419,,,25789,37370,58321
2621,2621,2621,2621,2621,2621,2621,2621,2622,2021-04-19 15:00:00+00:00,Calvert,308.0,35259,440.0,23810,,2419,,,26229,37678,59069
2622,2622,2622,2622,2622,2622,2622,2622,2623,2021-04-20 15:00:00+00:00,Calvert,578.0,35837,363.0,24173,,2419,,,26592,38256,60010
2623,2623,2623,2623,2623,2623,2623,2623,2624,2021-04-21 15:00:00+00:00,Calvert,456.0,36293,466.0,24639,,2419,,,27058,38712,60932
2624,2624,2624,2624,2624,2624,2624,2624,2625,2021-04-22 15:00:00+00:00,Calvert,438.0,36731,275.0,24914,,2419,,,27333,39150,61645
2625,2625,2625,2625,2625,2625,2625,2625,2626,2021-04-23 15:00:00+00:00,Calvert,476.0,37207,272.0,25186,,2419,,,27605,39626,62393
2626,2626,2626,2626,2626,2626,2626,2626,2627,2021-04-24 15:00:00+00:00,Calvert,316.0,37523,1045.0,26231,,2419,,,28650,39942,63754
2627,2627,2627,2627,2627,2627,2627,2627,2628,2021-04-25 15:00:00+00:00,Calvert,221.0,37744,54.0,26285,,2419,,,28704,40163,64029
2628,2628,2628,2628,2628,2628,2628,2628,2629,2021-04-26 15:00:00+00:00,Calvert,285.0,38029,287.0,26572,,2419,,,28991,40448,64601
2629,2629,2629,2629,2629,2629,2629,2629,2630,2021-04-27 15:00:00+00:00,Calvert,220.0,38249,243.0,26815,21.0,2440,241.0,264.0,29255,40689,65064
2630,2630,2630,2630,2630,2630,2630,2630,2631,2021-04-28 15:00:00+00:00,Calvert,262.0,38511,305.0,27120,25.0,2465,287.0,330.0,29585,40976,65631
2631,2631,2631,2631,2631,2631,2631,2631,2632,2021-04-29 15:00:00+00:00,Calvert,647.0,39158,278.0,27398,15.0,2480,662.0,293.0,29878,41638,66556
2632,2632,2632,2632,2632,2632,2632,2632,2633,2021-04-30 15:00:00+00:00,Calvert,572.0,39730,352.0,27750,21.0,2501,593.0,373.0,30251,42231,67480
2633,2633,2633,2633,2633,2633,2633,2633,2634,2021-05-01 15:00:00+00:00,Calvert,142.0,39872,842.0,28592,20.0,2521,162.0,862.0,31113,42393,68464
2634,2634,2634,2634,2634,2634,2634,2634,2635,2021-05-02 15:00:00+00:00,Calvert,106.0,39978,159.0,28751,17.0,2538,123.0,176.0,31289,42516,68729
2635,2635,2635,2635,2635,2635,2635,2635,2636,2021-05-03 15:00:00+00:00,Calvert,201.0,40179,408.0,29159,29.0,2567,230.0,437.0,31726,42746,69338
2636,2636,2636,2636,2636,2636,2636,2636,2637,2021-05-04 15:00:00+00:00,Calvert,237.0,40416,370.0,29529,22.0,2589,259.0,392.0,32118,43005,69945
2637,2637,2637,2637,2637,2637,2637,2637,2638,2021-05-05 15:00:00+00:00,Calvert,254.0,40670,282.0,29811,31.0,2620,285.0,313.0,32431,43290,70481
2638,2638,2638,2638,2638,2638,2638,2638,2639,2021-05-06 15:00:00+00:00,Calvert,489.0,41159,322.0,30133,18.0,2638,507.0,340.0,32771,43797,71292
2639,2639,2639,2639,2639,2639,2639,2639,2640,2021-05-07 15:00:00+00:00,Calvert,136.0,41295,876.0,31009,25.0,2663,161.0,901.0,33672,43958,72304
2640,2640,2640,2640,2640,2640,2640,2640,2641,2021-05-08 15:00:00+00:00,Calvert,68.0,41363,811.0,31820,17.0,2680,85.0,828.0,34500,44043,73183
2641,2641,2641,2641,2641,2641,2641,2641,2642,2021-05-09 15:00:00+00:00,Calvert,31.0,41394,78.0,31898,10.0,2690,41.0,88.0,34588,44084,73292
2642,2642,2642,2642,2642,2642,2642,2642,2643,2021-05-10 15:00:00+00:00,Calvert,58.0,41452,325.0,32223,20.0,2710,78.0,345.0,34933,44162,73675
2643,2643,2643,2643,2643,2643,2643,2643,2644,2021-05-11 15:00:00+00:00,Calvert,204.0,41656,299.0,32522,27.0,2737,231.0,326.0,35259,44393,74178
2644,2644,2644,2644,2644,2644,2644,2644,2645,2021-05-12 15:00:00+00:00,Calvert,127.0,41783,689.0,33211,30.0,2767,157.0,719.0,35978,44550,74994
2645,2645,2645,2645,2645,2645,2645,2645,2646,2021-05-13 15:00:00+00:00,Calvert,290.0,42073,407.0,33618,9.0,2776,299.0,416.0,36394,44849,75691
2646,2646,2646,2646,2646,2646,2646,2646,2647,2021-05-14 15:00:00+00:00,Calvert,613.0,42686,289.0,33907,33.0,2809,646.0,322.0,36716,45495,76593
2647,2647,2647,2647,2647,2647,2647,2647,2648,2021-05-15 15:00:00+00:00,Calvert,165.0,42851,502.0,34409,24.0,2833,189.0,526.0,37242,45684,77260
2648,2648,2648,2648,2648,2648,2648,2648,2649,2021-05-16 15:00:00+00:00,Calvert,93.0,42944,244.0,34653,15.0,2848,108.0,259.0,37501,45792,77597
2649,2649,2649,2649,2649,2649,2649,2649,2650,2021-05-17 15:00:00+00:00,Calvert,157.0,43101,359.0,35012,39.0,2887,196.0,398.0,37899,45988,78113
2650,2650,2650,2650,2650,2650,2650,2650,2651,2021-05-18 15:00:00+00:00,Calvert,542.0,43643,325.0,35337,35.0,2922,577.0,360.0,38259,46565,78980
2651,2651,2651,2651,2651,2651,2651,2651,2652,2021-05-19 15:00:00+00:00,Calvert,246.0,43889,685.0,36022,17.0,2939,263.0,702.0,38961,46828,79911
2652,2652,2652,2652,2652,2652,2652,2652,2653,2021-05-20 15:00:00+00:00,Calvert,224.0,44113,331.0,36353,20.0,2959,244.0,351.0,39312,47072,80466
2653,2653,2653,2653,2653,2653,2653,2653,2654,2021-05-21 15:00:00+00:00,Calvert,357.0,44470,369.0,36722,16.0,2975,373.0,385.0,39697,47445,81192
2654,2654,2654,2654,2654,2654,2654,2654,2655,2021-05-22 15:00:00+00:00,Calvert,189.0,44659,101.0,36823,17.0,2992,206.0,118.0,39815,47651,81482
2655,2655,2655,2655,2655,2655,2655,2655,2656,2021-05-23 15:00:00+00:00,Calvert,75.0,44734,153.0,36976,23.0,3015,98.0,176.0,39991,47749,81710
2656,2656,2656,2656,2656,2656,2656,2656,2657,2021-05-24 15:00:00+00:00,Calvert,112.0,44846,294.0,37270,23.0,3038,135.0,317.0,40308,47884,82116
2657,2657,2657,2657,2657,2657,2657,2657,2658,2021-05-25 15:00:00+00:00,Calvert,177.0,45023,298.0,37568,25.0,3063,202.0,323.0,40631,48086,82591
2658,2658,2658,2658,2658,2658,2658,2658,2659,2021-05-26 15:00:00+00:00,Calvert,127.0,45150,272.0,37840,10.0,3073,137.0,282.0,40913,48223,82990
2659,2659,2659,2659,2659,2659,2659,2659,2660,2021-05-27 15:00:00+00:00,Calvert,110.0,45260,277.0,38117,8.0,3081,118.0,285.0,41198,48341,83377
2660,2660,2660,2660,2660,2660,2660,2660,2661,2021-05-28 15:00:00+00:00,Calvert,104.0,45364,546.0,38663,18.0,3099,122.0,564.0,41762,48463,84027
2661,2661,2661,2661,2661,2661,2661,2661,2662,2021-05-29 15:00:00+00:00,Calvert,63.0,45427,101.0,38764,11.0,3110,74.0,112.0,41874,48537,84191
2662,2662,2662,2662,2662,2662,2662,2662,2663,2021-05-30 15:00:00+00:00,Calvert,26.0,45453,74.0,38838,9.0,3119,35.0,83.0,41957,48572,84291
2663,2663,2663,2663,2663,2663,2663,2663,2664,2021-05-31 15:00:00+00:00,Calvert,9.0,45462,15.0,38853,1.0,3120,10.0,16.0,41973,48582,84315
2664,2664,2664,2664,2664,2664,2664,2664,2665,2021-06-01 15:00:00+00:00,Calvert,164.0,45626,257.0,39110,15.0,3135,179.0,272.0,42245,48761,84736
2665,2665,2665,2665,2665,2665,2665,2665,2666,2021-06-02 15:00:00+00:00,Calvert,124.0,45750,506.0,39616,31.0,3166,155.0,537.0,42782,48916,85366
2666,2666,2666,2666,2666,2666,2666,2666,2667,2021-06-03 15:00:00+00:00,Calvert,149.0,45899,291.0,39907,9.0,3175,158.0,300.0,43082,49074,85806
2667,2667,2667,2667,2667,2667,2667,2667,2668,2021-06-04 15:00:00+00:00,Calvert,90.0,45989,379.0,40286,8.0,3183,98.0,387.0,43469,49172,86275
2668,2668,2668,2668,2668,2668,2668,2668,2669,2021-06-05 15:00:00+00:00,Calvert,93.0,46082,350.0,40636,7.0,3190,100.0,357.0,43826,49272,86718
2669,2669,2669,2669,2669,2669,2669,2669,2670,2021-06-06 15:00:00+00:00,Calvert,19.0,46101,82.0,40718,8.0,3198,27.0,90.0,43916,49299,86819
2670,2670,2670,2670,2670,2670,2670,2670,2671,2021-06-07 15:00:00+00:00,Calvert,66.0,46167,133.0,40851,6.0,3204,72.0,139.0,44055,49371,87018
2671,2671,2671,2671,2671,2671,2671,2671,2672,2021-06-08 15:00:00+00:00,Calvert,102.0,46269,498.0,41349,5.0,3209,107.0,503.0,44558,49478,87618
2672,2672,2672,2672,2672,2672,2672,2672,2673,2021-06-09 15:00:00+00:00,Calvert,78.0,46347,218.0,41567,19.0,3228,97.0,237.0,44795,49575,87914
2673,2673,2673,2673,2673,2673,2673,2673,2674,2021-06-10 15:00:00+00:00,Calvert,80.0,46427,223.0,41790,8.0,3236,88.0,231.0,45026,49663,88217
2674,2674,2674,2674,2674,2674,2674,2674,2675,2021-06-11 15:00:00+00:00,Calvert,76.0,46503,230.0,42020,6.0,3242,82.0,236.0,45262,49745,88523
2675,2675,2675,2675,2675,2675,2675,2675,2676,2021-06-12 15:00:00+00:00,Calvert,35.0,46538,137.0,42157,4.0,3246,39.0,141.0,45403,49784,88695
2676,2676,2676,2676,2676,2676,2676,2676,2677,2021-06-13 15:00:00+00:00,Calvert,16.0,46554,63.0,42220,5.0,3251,21.0,68.0,45471,49805,88774
2677,2677,2677,2677,2677,2677,2677,2677,2678,2021-06-14 15:00:00+00:00,Calvert,63.0,46617,131.0,42351,6.0,3257,69.0,137.0,45608,49874,88968
2678,2678,2678,2678,2678,2678,2678,2678,2679,2021-06-15 15:00:00+00:00,Calvert,90.0,46707,350.0,42701,8.0,3265,98.0,358.0,45966,49972,89408
2679,2679,2679,2679,2679,2679,2679,2679,2680,2021-06-16 15:00:00+00:00,Calvert,88.0,46795,187.0,42888,8.0,3273,96.0,195.0,46161,50068,89683
2680,2680,2680,2680,2680,2680,2680,2680,2681,2021-06-17 15:00:00+00:00,Calvert,82.0,46877,153.0,43041,6.0,3279,88.0,159.0,46320,50156,89918
2681,2681,2681,2681,2681,2681,2681,2681,2682,2021-06-18 15:00:00+00:00,Calvert,59.0,46936,133.0,43174,5.0,3284,64.0,138.0,46458,50220,90110
2682,2682,2682,2682,2682,2682,2682,2682,2683,2021-06-19 15:00:00+00:00,Calvert,32.0,46968,65.0,43239,6.0,3290,38.0,71.0,46529,50258,90207
2683,2683,2683,2683,2683,2683,2683,2683,2684,2021-06-20 15:00:00+00:00,Calvert,6.0,46974,21.0,43260,30.0,3320,36.0,51.0,46580,50294,90234
2684,2684,2684,2684,2684,2684,2684,2684,2685,2021-06-21 15:00:00+00:00,Calvert,55.0,47029,46.0,43306,3.0,3323,58.0,49.0,46629,50352,90335
2685,2685,2685,2685,2685,2685,2685,2685,2686,2021-06-22 15:00:00+00:00,Calvert,46.0,47075,95.0,43401,5.0,3328,51.0,100.0,46729,50403,90476
2686,2686,2686,2686,2686,2686,2686,2686,2687,2021-06-23 15:00:00+00:00,Calvert,35.0,47110,140.0,43541,10.0,3338,45.0,150.0,46879,50448,90651
2687,2687,2687,2687,2687,2687,2687,2687,2688,2021-06-24 15:00:00+00:00,Calvert,55.0,47165,89.0,43630,3.0,3341,58.0,92.0,46971,50506,90795
2688,2688,2688,2688,2688,2688,2688,2688,2689,2021-06-25 15:00:00+00:00,Calvert,60.0,47225,92.0,43722,6.0,3347,66.0,98.0,47069,50572,90947
2689,2689,2689,2689,2689,2689,2689,2689,2690,2021-06-26 15:00:00+00:00,Calvert,51.0,47276,123.0,43845,1.0,3348,52.0,124.0,47193,50624,91121
2690,2690,2690,2690,2690,2690,2690,2690,2691,2021-06-27 15:00:00+00:00,Calvert,18.0,47294,24.0,43869,1.0,3349,19.0,25.0,47218,50643,91163
2691,2691,2691,2691,2691,2691,2691,2691,2692,2021-06-28 15:00:00+00:00,Calvert,39.0,47333,61.0,43930,7.0,3356,46.0,68.0,47286,50689,91263
2692,2692,2692,2692,2692,2692,2692,2692,2693,2021-06-29 15:00:00+00:00,Calvert,54.0,47387,84.0,44014,3.0,3359,57.0,87.0,47373,50746,91401
2693,2693,2693,2693,2693,2693,2693,2693,2694,2021-06-30 15:00:00+00:00,Calvert,60.0,47447,67.0,44081,6.0,3365,66.0,73.0,47446,50812,91528
2694,2694,2694,2694,2694,2694,2694,2694,2695,2021-07-01 15:00:00+00:00,Calvert,84.0,47531,118.0,44199,6.0,3371,90.0,124.0,47570,50902,91730
2695,2695,2695,2695,2695,2695,2695,2695,2696,2021-07-02 15:00:00+00:00,Calvert,58.0,47589,64.0,44263,8.0,3379,66.0,72.0,47642,50968,91852
2696,2696,2696,2696,2696,2696,2696,2696,2697,2021-07-03 15:00:00+00:00,Calvert,31.0,47620,37.0,44300,3.0,3382,34.0,40.0,47682,51002,91920
2697,2697,2697,2697,2697,2697,2697,2697,2698,2021-07-04 15:00:00+00:00,Calvert,4.0,47624,7.0,44307,,3382,,,47689,51006,91931
2698,2698,2698,2698,2698,2698,2698,2698,2699,2021-07-05 15:00:00+00:00,Calvert,29.0,47653,46.0,44353,6.0,3388,35.0,52.0,47741,51041,92006
2699,2699,2699,2699,2699,2699,2699,2699,2700,2021-07-06 15:00:00+00:00,Calvert,47.0,47700,85.0,44438,2.0,3390,49.0,87.0,47828,51090,92138
2700,2700,2700,2700,2700,2700,2700,2700,2701,2021-07-07 15:00:00+00:00,Calvert,57.0,47757,89.0,44527,11.0,3401,68.0,100.0,47928,51158,92284
2701,2701,2701,2701,2701,2701,2701,2701,2702,2021-07-08 15:00:00+00:00,Calvert,57.0,47814,60.0,44587,5.0,3406,62.0,65.0,47993,51220,92401
2702,2702,2702,2702,2702,2702,2702,2702,2703,2021-07-09 15:00:00+00:00,Calvert,84.0,47898,77.0,44664,2.0,3408,86.0,79.0,48072,51306,92562
2703,2703,2703,2703,2703,2703,2703,2703,2704,2021-07-10 15:00:00+00:00,Calvert,35.0,47933,27.0,44691,,3408,,,48099,51341,92624
2704,2704,2704,2704,2704,2704,2704,2704,2705,2021-07-11 15:00:00+00:00,Calvert,21.0,47954,14.0,44705,2.0,3410,23.0,16.0,48115,51364,92659
2705,2705,2705,2705,2705,2705,2705,2705,2706,2021-07-12 15:00:00+00:00,Calvert,40.0,47994,47.0,44752,2.0,3412,42.0,49.0,48164,51406,92746
2706,2706,2706,2706,2706,2706,2706,2706,2707,2021-07-13 15:00:00+00:00,Calvert,66.0,48060,59.0,44811,5.0,3417,71.0,64.0,48228,51477,92871
2707,2707,2707,2707,2707,2707,2707,2707,2708,2021-07-14 15:00:00+00:00,Calvert,60.0,48120,38.0,44849,7.0,3424,67.0,45.0,48273,51544,92969
2708,2708,2708,2708,2708,2708,2708,2708,2709,2021-07-15 15:00:00+00:00,Calvert,62.0,48182,67.0,44916,2.0,3426,64.0,69.0,48342,51608,93098
2709,2709,2709,2709,2709,2709,2709,2709,2710,2021-07-16 15:00:00+00:00,Calvert,58.0,48240,40.0,44956,6.0,3432,64.0,46.0,48388,51672,93196
2710,2710,2710,2710,2710,2710,2710,2710,2711,2021-07-17 15:00:00+00:00,Calvert,30.0,48270,24.0,44980,31.0,3463,61.0,55.0,48443,51733,93250
2711,2711,2711,2711,2711,2711,2711,2711,2712,2021-07-18 15:00:00+00:00,Calvert,19.0,48289,15.0,44995,1.0,3464,20.0,16.0,48459,51753,93284
2712,2712,2712,2712,2712,2712,2712,2712,2713,2021-07-19 15:00:00+00:00,Calvert,52.0,48341,55.0,45050,9.0,3473,61.0,64.0,48523,51814,93391
2713,2713,2713,2713,2713,2713,2713,2713,2714,2021-07-20 15:00:00+00:00,Calvert,58.0,48399,62.0,45112,5.0,3478,63.0,67.0,48590,51877,93511
2714,2714,2714,2714,2714,2714,2714,2714,2715,2021-07-21 15:00:00+00:00,Calvert,111.0,48510,58.0,45170,8.0,3486,119.0,66.0,48656,51996,93680
2715,2715,2715,2715,2715,2715,2715,2715,2716,2021-07-22 15:00:00+00:00,Calvert,68.0,48578,58.0,45228,1.0,3487,69.0,59.0,48715,52065,93806
2716,2716,2716,2716,2716,2716,2716,2716,2717,2021-07-23 15:00:00+00:00,Calvert,87.0,48665,51.0,45279,4.0,3491,91.0,55.0,48770,52156,93944
2717,2717,2717,2717,2717,2717,2717,2717,2718,2021-07-24 15:00:00+00:00,Calvert,43.0,48708,34.0,45313,15.0,3506,58.0,49.0,48819,52214,94021
2718,2718,2718,2718,2718,2718,2718,2718,2719,2021-07-25 15:00:00+00:00,Calvert,24.0,48732,8.0,45321,1.0,3507,25.0,9.0,48828,52239,94053
2719,2719,2719,2719,2719,2719,2719,2719,2720,2021-07-26 15:00:00+00:00,Calvert,84.0,48816,35.0,45356,3.0,3510,87.0,38.0,48866,52326,94172
2720,2720,2720,2720,2720,2720,2720,2720,2721,2021-07-27 15:00:00+00:00,Calvert,81.0,48897,42.0,45398,19.0,3529,100.0,61.0,48927,52426,94295
2721,2721,2721,2721,2721,2721,2721,2721,2722,2021-07-28 15:00:00+00:00,Calvert,143.0,49040,53.0,45451,9.0,3538,152.0,62.0,48989,52578,94491
2722,2722,2722,2722,2722,2722,2722,2722,2723,2021-07-29 15:00:00+00:00,Calvert,154.0,49194,68.0,45519,3.0,3541,157.0,71.0,49060,52735,94713
2723,2723,2723,2723,2723,2723,2723,2723,2724,2021-07-30 15:00:00+00:00,Calvert,135.0,49329,56.0,45575,10.0,3551,145.0,66.0,49126,52880,94904
2724,2724,2724,2724,2724,2724,2724,2724,2725,2021-07-31 15:00:00+00:00,Calvert,79.0,49408,33.0,45608,1.0,3552,80.0,34.0,49160,52960,95016
2725,2725,2725,2725,2725,2725,2725,2725,2726,2021-08-01 15:00:00+00:00,Calvert,52.0,49460,17.0,45625,,3552,,,49177,53012,95085
2726,2726,2726,2726,2726,2726,2726,2726,2727,2021-08-02 15:00:00+00:00,Calvert,108.0,49568,39.0,45664,,3552,,,49216,53120,95232
2727,2727,2727,2727,2727,2727,2727,2727,2728,2021-08-03 15:00:00+00:00,Calvert,139.0,49707,55.0,45719,2.0,3554,141.0,57.0,49273,53261,95426
2728,2728,2728,2728,2728,2728,2728,2728,2729,2021-08-04 15:00:00+00:00,Calvert,114.0,49821,51.0,45770,12.0,3566,126.0,63.0,49336,53387,95591
2729,2729,2729,2729,2729,2729,2729,2729,2730,2021-08-05 15:00:00+00:00,Calvert,137.0,49958,62.0,45832,55.0,3621,192.0,117.0,49453,53579,95790
2730,2730,2730,2730,2730,2730,2730,2730,2731,2021-08-06 15:00:00+00:00,Calvert,88.0,50046,52.0,45884,2.0,3623,90.0,54.0,49507,53669,95930
2731,2731,2731,2731,2731,2731,2731,2731,2732,2021-08-07 15:00:00+00:00,Calvert,77.0,50123,22.0,45906,2.0,3625,79.0,24.0,49531,53748,96029
2732,2732,2732,2732,2732,2732,2732,2732,2733,2021-08-08 15:00:00+00:00,Calvert,53.0,50176,22.0,45928,1.0,3626,54.0,23.0,49554,53802,96104
2733,2733,2733,2733,2733,2733,2733,2733,2734,2021-08-09 15:00:00+00:00,Calvert,91.0,50267,43.0,45971,2.0,3628,93.0,45.0,49599,53895,96238
2734,2734,2734,2734,2734,2734,2734,2734,2735,2021-08-10 15:00:00+00:00,Calvert,81.0,50348,41.0,46012,3.0,3631,84.0,44.0,49643,53979,96360
2735,2735,2735,2735,2735,2735,2735,2735,2736,2021-08-11 15:00:00+00:00,Calvert,107.0,50455,70.0,46082,15.0,3646,122.0,85.0,49728,54101,96537
2736,2736,2736,2736,2736,2736,2736,2736,2737,2021-08-12 15:00:00+00:00,Calvert,120.0,50575,76.0,46158,1.0,3647,121.0,77.0,49805,54222,96733
2737,2737,2737,2737,2737,2737,2737,2737,2738,2021-08-13 15:00:00+00:00,Calvert,139.0,50714,101.0,46259,,3647,,,49906,54361,96973
2738,2738,2738,2738,2738,2738,2738,2738,2739,2021-08-14 15:00:00+00:00,Calvert,51.0,50765,39.0,46298,1.0,3648,52.0,40.0,49946,54413,97063
2739,2739,2739,2739,2739,2739,2739,2739,2740,2021-08-15 15:00:00+00:00,Calvert,47.0,50812,26.0,46324,,3648,,,49972,54460,97136
2740,2740,2740,2740,2740,2740,2740,2740,2741,2021-08-16 15:00:00+00:00,Calvert,73.0,50885,72.0,46396,1.0,3649,74.0,73.0,50045,54534,97281
2741,2741,2741,2741,2741,2741,2741,2741,2742,2021-08-17 15:00:00+00:00,Calvert,107.0,50992,59.0,46455,,3649,,,50104,54641,97447
2742,2742,2742,2742,2742,2742,2742,2742,2743,2021-08-18 15:00:00+00:00,Calvert,81.0,51073,92.0,46547,14.0,3663,95.0,106.0,50210,54736,97620
2743,2743,2743,2743,2743,2743,2743,2743,2744,2021-08-19 15:00:00+00:00,Calvert,73.0,51146,73.0,46620,,3663,,,50283,54809,97766
2744,2744,2744,2744,2744,2744,2744,2744,2745,2021-08-20 15:00:00+00:00,Calvert,94.0,51240,101.0,46721,7.0,3670,101.0,108.0,50391,54910,97961
2745,2745,2745,2745,2745,2745,2745,2745,2746,2021-08-21 15:00:00+00:00,Calvert,46.0,51286,51.0,46772,1.0,3671,47.0,52.0,50443,54957,98058
2746,2746,2746,2746,2746,2746,2746,2746,2747,2021-08-22 15:00:00+00:00,Calvert,39.0,51325,49.0,46821,,3671,,,50492,54996,98146
2747,2747,2747,2747,2747,2747,2747,2747,2748,2021-08-23 15:00:00+00:00,Calvert,90.0,51415,86.0,46907,2.0,3673,92.0,88.0,50580,55088,98322
2748,2748,2748,2748,2748,2748,2748,2748,2749,2021-08-24 15:00:00+00:00,Calvert,105.0,51520,90.0,46997,5.0,3678,110.0,95.0,50675,55198,98517
2749,2749,2749,2749,2749,2749,2749,2749,2750,2021-08-25 15:00:00+00:00,Calvert,108.0,51628,143.0,47140,12.0,3690,120.0,155.0,50830,55318,98768
2750,2750,2750,2750,2750,2750,2750,2750,2751,2021-08-26 15:00:00+00:00,Calvert,109.0,51737,120.0,47260,,3690,,,50950,55427,98997
2751,2751,2751,2751,2751,2751,2751,2751,2752,2021-08-27 15:00:00+00:00,Calvert,121.0,51858,94.0,47354,1.0,3691,122.0,95.0,51045,55549,99212
2752,2752,2752,2752,2752,2752,2752,2752,2753,2021-08-28 15:00:00+00:00,Calvert,64.0,51922,83.0,47437,1.0,3692,65.0,84.0,51129,55614,99359
2753,2753,2753,2753,2753,2753,2753,2753,2754,2021-08-29 15:00:00+00:00,Calvert,42.0,51964,57.0,47494,1.0,3693,43.0,58.0,51187,55657,99458
2754,2754,2754,2754,2754,2754,2754,2754,2755,2021-08-30 15:00:00+00:00,Calvert,86.0,52050,85.0,47579,1.0,3694,87.0,86.0,51273,55744,99629
2755,2755,2755,2755,2755,2755,2755,2755,2756,2021-08-31 15:00:00+00:00,Calvert,63.0,52113,60.0,47639,,3694,,,51333,55807,99752
2756,2756,2756,2756,2756,2756,2756,2756,2757,2021-03-20 15:00:00+00:00,Charles,221.0,30620,93.0,14509,16.0,1116,237.0,109.0,15625,31736,45129
2757,2757,2757,2757,2757,2757,2757,2757,2758,2021-03-21 15:00:00+00:00,Charles,280.0,30900,91.0,14600,5.0,1121,285.0,96.0,15721,32021,45500
2758,2758,2758,2758,2758,2758,2758,2758,2759,2021-03-22 15:00:00+00:00,Charles,1427.0,32327,191.0,14791,21.0,1142,1448.0,212.0,15933,33469,47118
2759,2759,2759,2759,2759,2759,2759,2759,2760,2021-03-23 15:00:00+00:00,Charles,502.0,32829,774.0,15565,19.0,1161,521.0,793.0,16726,33990,48394
2760,2760,2760,2760,2760,2760,2760,2760,2761,2021-03-24 15:00:00+00:00,Charles,1707.0,34536,230.0,15795,18.0,1179,1725.0,248.0,16974,35715,50331
2761,2761,2761,2761,2761,2761,2761,2761,2762,2021-03-25 15:00:00+00:00,Charles,616.0,35152,274.0,16069,15.0,1194,631.0,289.0,17263,36346,51221
2762,2762,2762,2762,2762,2762,2762,2762,2763,2021-03-26 15:00:00+00:00,Charles,876.0,36028,1384.0,17453,38.0,1232,914.0,1422.0,18685,37260,53481
2763,2763,2763,2763,2763,2763,2763,2763,2764,2021-03-27 15:00:00+00:00,Charles,983.0,37011,126.0,17579,13.0,1245,996.0,139.0,18824,38256,54590
2764,2764,2764,2764,2764,2764,2764,2764,2765,2021-03-28 15:00:00+00:00,Charles,901.0,37912,136.0,17715,12.0,1257,913.0,148.0,18972,39169,55627
2765,2765,2765,2765,2765,2765,2765,2765,2766,2021-03-29 15:00:00+00:00,Charles,986.0,38898,559.0,18274,25.0,1282,1011.0,584.0,19556,40180,57172
2766,2766,2766,2766,2766,2766,2766,2766,2767,2021-03-30 15:00:00+00:00,Charles,983.0,39881,291.0,18565,32.0,1314,1015.0,323.0,19879,41195,58446
2767,2767,2767,2767,2767,2767,2767,2767,2768,2021-03-31 15:00:00+00:00,Charles,1630.0,41511,588.0,19153,37.0,1351,1667.0,625.0,20504,42862,60664
2768,2768,2768,2768,2768,2768,2768,2768,2769,2021-04-01 15:00:00+00:00,Charles,1235.0,42746,467.0,19620,84.0,1435,1319.0,551.0,21055,44181,62366
2769,2769,2769,2769,2769,2769,2769,2769,2770,2021-04-02 15:00:00+00:00,Charles,399.0,43145,557.0,20177,97.0,1532,496.0,654.0,21709,44677,63322
2770,2770,2770,2770,2770,2770,2770,2770,2771,2021-04-03 15:00:00+00:00,Charles,146.0,43291,364.0,20541,60.0,1592,206.0,424.0,22133,44883,63832
2771,2771,2771,2771,2771,2771,2771,2771,2772,2021-04-04 15:00:00+00:00,Charles,116.0,43407,201.0,20742,22.0,1614,138.0,223.0,22356,45021,64149
2772,2772,2772,2772,2772,2772,2772,2772,2773,2021-04-05 15:00:00+00:00,Charles,278.0,43685,1349.0,22091,61.0,1675,339.0,1410.0,23766,45360,65776
2773,2773,2773,2773,2773,2773,2773,2773,2774,2021-04-06 15:00:00+00:00,Charles,290.0,43975,1109.0,23200,114.0,1789,404.0,1223.0,24989,45764,67175
2774,2774,2774,2774,2774,2774,2774,2774,2775,2021-04-07 15:00:00+00:00,Charles,1235.0,45210,755.0,23955,160.0,1949,1395.0,915.0,25904,47159,69165
2775,2775,2775,2775,2775,2775,2775,2775,2776,2021-04-08 15:00:00+00:00,Charles,428.0,45638,419.0,24374,297.0,2246,725.0,716.0,26620,47884,70012
2776,2776,2776,2776,2776,2776,2776,2776,2777,2021-04-09 15:00:00+00:00,Charles,462.0,46100,1258.0,25632,209.0,2455,671.0,1467.0,28087,48555,71732
2777,2777,2777,2777,2777,2777,2777,2777,2778,2021-04-10 15:00:00+00:00,Charles,376.0,46476,389.0,26021,270.0,2725,646.0,659.0,28746,49201,72497
2778,2778,2778,2778,2778,2778,2778,2778,2779,2021-04-11 15:00:00+00:00,Charles,322.0,46798,203.0,26224,224.0,2949,546.0,427.0,29173,49747,73022
2779,2779,2779,2779,2779,2779,2779,2779,2780,2021-04-12 15:00:00+00:00,Charles,365.0,47163,1042.0,27266,302.0,3251,667.0,1344.0,30517,50414,74429
2780,2780,2780,2780,2780,2780,2780,2780,2781,2021-04-13 15:00:00+00:00,Charles,1279.0,48442,438.0,27704,4.0,3255,1283.0,442.0,30959,51697,76146
2781,2781,2781,2781,2781,2781,2781,2781,2782,2021-04-14 15:00:00+00:00,Charles,475.0,48917,1816.0,29520,1.0,3256,476.0,1817.0,32776,52173,78437
2782,2782,2782,2782,2782,2782,2782,2782,2783,2021-04-15 15:00:00+00:00,Charles,902.0,49819,559.0,30079,,3256,,,33335,53075,79898
2783,2783,2783,2783,2783,2783,2783,2783,2784,2021-04-16 15:00:00+00:00,Charles,540.0,50359,1071.0,31150,1.0,3257,541.0,1072.0,34407,53616,81509
2784,2784,2784,2784,2784,2784,2784,2784,2785,2021-04-17 15:00:00+00:00,Charles,396.0,50755,554.0,31704,1.0,3258,397.0,555.0,34962,54013,82459
2785,2785,2785,2785,2785,2785,2785,2785,2786,2021-04-18 15:00:00+00:00,Charles,289.0,51044,874.0,32578,,3258,,,35836,54302,83622
2786,2786,2786,2786,2786,2786,2786,2786,2787,2021-04-19 15:00:00+00:00,Charles,424.0,51468,1994.0,34572,,3258,,,37830,54726,86040
2787,2787,2787,2787,2787,2787,2787,2787,2788,2021-04-20 15:00:00+00:00,Charles,1322.0,52790,962.0,35534,,3258,,,38792,56048,88324
2788,2788,2788,2788,2788,2788,2788,2788,2789,2021-04-21 15:00:00+00:00,Charles,355.0,53145,1714.0,37248,,3258,,,40506,56403,90393
2789,2789,2789,2789,2789,2789,2789,2789,2790,2021-04-22 15:00:00+00:00,Charles,1119.0,54264,426.0,37674,,3258,,,40932,57522,91938
2790,2790,2790,2790,2790,2790,2790,2790,2791,2021-04-23 15:00:00+00:00,Charles,1178.0,55442,563.0,38237,,3258,,,41495,58700,93679
2791,2791,2791,2791,2791,2791,2791,2791,2792,2021-04-24 15:00:00+00:00,Charles,1295.0,56737,511.0,38748,5.0,3263,1300.0,516.0,42011,60000,95485
2792,2792,2792,2792,2792,2792,2792,2792,2793,2021-04-25 15:00:00+00:00,Charles,1145.0,57882,110.0,38858,,3263,,,42121,61145,96740
2793,2793,2793,2793,2793,2793,2793,2793,2794,2021-04-26 15:00:00+00:00,Charles,631.0,58513,327.0,39185,3.0,3266,634.0,330.0,42451,61779,97698
2794,2794,2794,2794,2794,2794,2794,2794,2795,2021-04-27 15:00:00+00:00,Charles,733.0,59246,354.0,39539,16.0,3282,749.0,370.0,42821,62528,98785
2795,2795,2795,2795,2795,2795,2795,2795,2796,2021-04-28 15:00:00+00:00,Charles,566.0,59812,1205.0,40744,39.0,3321,605.0,1244.0,44065,63133,100556
2796,2796,2796,2796,2796,2796,2796,2796,2797,2021-04-29 15:00:00+00:00,Charles,453.0,60265,1130.0,41874,31.0,3352,484.0,1161.0,45226,63617,102139
2797,2797,2797,2797,2797,2797,2797,2797,2798,2021-04-30 15:00:00+00:00,Charles,716.0,60981,477.0,42351,34.0,3386,750.0,511.0,45737,64367,103332
2798,2798,2798,2798,2798,2798,2798,2798,2799,2021-05-01 15:00:00+00:00,Charles,372.0,61353,358.0,42709,38.0,3424,410.0,396.0,46133,64777,104062
2799,2799,2799,2799,2799,2799,2799,2799,2800,2021-05-02 15:00:00+00:00,Charles,308.0,61661,195.0,42904,16.0,3440,324.0,211.0,46344,65101,104565
2800,2800,2800,2800,2800,2800,2800,2800,2801,2021-05-03 15:00:00+00:00,Charles,254.0,61915,413.0,43317,28.0,3468,282.0,441.0,46785,65383,105232
2801,2801,2801,2801,2801,2801,2801,2801,2802,2021-05-04 15:00:00+00:00,Charles,320.0,62235,581.0,43898,37.0,3505,357.0,618.0,47403,65740,106133
2802,2802,2802,2802,2802,2802,2802,2802,2803,2021-05-05 15:00:00+00:00,Charles,373.0,62608,1231.0,45129,34.0,3539,407.0,1265.0,48668,66147,107737
2803,2803,2803,2803,2803,2803,2803,2803,2804,2021-05-06 15:00:00+00:00,Charles,394.0,63002,519.0,45648,68.0,3607,462.0,587.0,49255,66609,108650
2804,2804,2804,2804,2804,2804,2804,2804,2805,2021-05-07 15:00:00+00:00,Charles,214.0,63216,342.0,45990,19.0,3626,233.0,361.0,49616,66842,109206
2805,2805,2805,2805,2805,2805,2805,2805,2806,2021-05-08 15:00:00+00:00,Charles,120.0,63336,258.0,46248,22.0,3648,142.0,280.0,49896,66984,109584
2806,2806,2806,2806,2806,2806,2806,2806,2807,2021-05-09 15:00:00+00:00,Charles,267.0,63603,305.0,46553,19.0,3667,286.0,324.0,50220,67270,110156
2807,2807,2807,2807,2807,2807,2807,2807,2808,2021-05-10 15:00:00+00:00,Charles,235.0,63838,535.0,47088,29.0,3696,264.0,564.0,50784,67534,110926
2808,2808,2808,2808,2808,2808,2808,2808,2809,2021-05-11 15:00:00+00:00,Charles,309.0,64147,1109.0,48197,22.0,3718,331.0,1131.0,51915,67865,112344
2809,2809,2809,2809,2809,2809,2809,2809,2810,2021-05-12 15:00:00+00:00,Charles,319.0,64466,321.0,48518,38.0,3756,357.0,359.0,52274,68222,112984
2810,2810,2810,2810,2810,2810,2810,2810,2811,2021-05-13 15:00:00+00:00,Charles,509.0,64975,1422.0,49940,39.0,3795,548.0,1461.0,53735,68770,114915
2811,2811,2811,2811,2811,2811,2811,2811,2812,2021-05-14 15:00:00+00:00,Charles,290.0,65265,335.0,50275,38.0,3833,328.0,373.0,54108,69098,115540
2812,2812,2812,2812,2812,2812,2812,2812,2813,2021-05-15 15:00:00+00:00,Charles,191.0,65456,309.0,50584,32.0,3865,223.0,341.0,54449,69321,116040
2813,2813,2813,2813,2813,2813,2813,2813,2814,2021-05-16 15:00:00+00:00,Charles,287.0,65743,1296.0,51880,20.0,3885,307.0,1316.0,55765,69628,117623
2814,2814,2814,2814,2814,2814,2814,2814,2815,2021-05-17 15:00:00+00:00,Charles,494.0,66237,1045.0,52925,24.0,3909,518.0,1069.0,56834,70146,119162
2815,2815,2815,2815,2815,2815,2815,2815,2816,2021-05-18 15:00:00+00:00,Charles,672.0,66909,1626.0,54551,31.0,3940,703.0,1657.0,58491,70849,121460
2816,2816,2816,2816,2816,2816,2816,2816,2817,2021-05-19 15:00:00+00:00,Charles,913.0,67822,986.0,55537,26.0,3966,939.0,1012.0,59503,71788,123359
2817,2817,2817,2817,2817,2817,2817,2817,2818,2021-05-20 15:00:00+00:00,Charles,603.0,68425,800.0,56337,44.0,4010,647.0,844.0,60347,72435,124762
2818,2818,2818,2818,2818,2818,2818,2818,2819,2021-05-21 15:00:00+00:00,Charles,292.0,68717,324.0,56661,32.0,4042,324.0,356.0,60703,72759,125378
2819,2819,2819,2819,2819,2819,2819,2819,2820,2021-05-22 15:00:00+00:00,Charles,308.0,69025,211.0,56872,18.0,4060,326.0,229.0,60932,73085,125897
2820,2820,2820,2820,2820,2820,2820,2820,2821,2021-05-23 15:00:00+00:00,Charles,438.0,69463,722.0,57594,8.0,4068,446.0,730.0,61662,73531,127057
2821,2821,2821,2821,2821,2821,2821,2821,2822,2021-05-24 15:00:00+00:00,Charles,414.0,69877,399.0,57993,32.0,4100,446.0,431.0,62093,73977,127870
2822,2822,2822,2822,2822,2822,2822,2822,2823,2021-05-25 15:00:00+00:00,Charles,314.0,70191,549.0,58542,20.0,4120,334.0,569.0,62662,74311,128733
2823,2823,2823,2823,2823,2823,2823,2823,2824,2021-05-26 15:00:00+00:00,Charles,549.0,70740,350.0,58892,12.0,4132,561.0,362.0,63024,74872,129632
2824,2824,2824,2824,2824,2824,2824,2824,2825,2021-05-27 15:00:00+00:00,Charles,343.0,71083,324.0,59216,23.0,4155,366.0,347.0,63371,75238,130299
2825,2825,2825,2825,2825,2825,2825,2825,2826,2021-05-28 15:00:00+00:00,Charles,220.0,71303,473.0,59689,40.0,4195,260.0,513.0,63884,75498,130992
2826,2826,2826,2826,2826,2826,2826,2826,2827,2021-05-29 15:00:00+00:00,Charles,116.0,71419,132.0,59821,12.0,4207,128.0,144.0,64028,75626,131240
2827,2827,2827,2827,2827,2827,2827,2827,2828,2021-05-30 15:00:00+00:00,Charles,149.0,71568,286.0,60107,13.0,4220,162.0,299.0,64327,75788,131675
2828,2828,2828,2828,2828,2828,2828,2828,2829,2021-05-31 15:00:00+00:00,Charles,22.0,71590,37.0,60144,3.0,4223,25.0,40.0,64367,75813,131734
2829,2829,2829,2829,2829,2829,2829,2829,2830,2021-06-01 15:00:00+00:00,Charles,187.0,71777,435.0,60579,31.0,4254,218.0,466.0,64833,76031,132356
2830,2830,2830,2830,2830,2830,2830,2830,2831,2021-06-02 15:00:00+00:00,Charles,287.0,72064,487.0,61066,26.0,4280,313.0,513.0,65346,76344,133130
2831,2831,2831,2831,2831,2831,2831,2831,2832,2021-06-03 15:00:00+00:00,Charles,177.0,72241,482.0,61548,32.0,4312,209.0,514.0,65860,76553,133789
2832,2832,2832,2832,2832,2832,2832,2832,2833,2021-06-04 15:00:00+00:00,Charles,178.0,72419,277.0,61825,7.0,4319,185.0,284.0,66144,76738,134244
2833,2833,2833,2833,2833,2833,2833,2833,2834,2021-06-05 15:00:00+00:00,Charles,142.0,72561,155.0,61980,5.0,4324,147.0,160.0,66304,76885,134541
2834,2834,2834,2834,2834,2834,2834,2834,2835,2021-06-06 15:00:00+00:00,Charles,77.0,72638,240.0,62220,22.0,4346,99.0,262.0,66566,76984,134858
2835,2835,2835,2835,2835,2835,2835,2835,2836,2021-06-07 15:00:00+00:00,Charles,170.0,72808,428.0,62648,17.0,4363,187.0,445.0,67011,77171,135456
2836,2836,2836,2836,2836,2836,2836,2836,2837,2021-06-08 15:00:00+00:00,Charles,257.0,73065,623.0,63271,43.0,4406,300.0,666.0,67677,77471,136336
2837,2837,2837,2837,2837,2837,2837,2837,2838,2021-06-09 15:00:00+00:00,Charles,216.0,73281,721.0,63992,46.0,4452,262.0,767.0,68444,77733,137273
2838,2838,2838,2838,2838,2838,2838,2838,2839,2021-06-10 15:00:00+00:00,Charles,195.0,73476,578.0,64570,26.0,4478,221.0,604.0,69048,77954,138046
2839,2839,2839,2839,2839,2839,2839,2839,2840,2021-06-11 15:00:00+00:00,Charles,170.0,73646,259.0,64829,37.0,4515,207.0,296.0,69344,78161,138475
2840,2840,2840,2840,2840,2840,2840,2840,2841,2021-06-12 15:00:00+00:00,Charles,140.0,73786,212.0,65041,15.0,4530,155.0,227.0,69571,78316,138827
2841,2841,2841,2841,2841,2841,2841,2841,2842,2021-06-13 15:00:00+00:00,Charles,42.0,73828,460.0,65501,21.0,4551,63.0,481.0,70052,78379,139329
2842,2842,2842,2842,2842,2842,2842,2842,2843,2021-06-14 15:00:00+00:00,Charles,151.0,73979,441.0,65942,15.0,4566,166.0,456.0,70508,78545,139921
2843,2843,2843,2843,2843,2843,2843,2843,2844,2021-06-15 15:00:00+00:00,Charles,143.0,74122,320.0,66262,27.0,4593,170.0,347.0,70855,78715,140384
2844,2844,2844,2844,2844,2844,2844,2844,2845,2021-06-16 15:00:00+00:00,Charles,190.0,74312,505.0,66767,25.0,4618,215.0,530.0,71385,78930,141079
2845,2845,2845,2845,2845,2845,2845,2845,2846,2021-06-17 15:00:00+00:00,Charles,190.0,74502,362.0,67129,17.0,4635,207.0,379.0,71764,79137,141631
2846,2846,2846,2846,2846,2846,2846,2846,2847,2021-06-18 15:00:00+00:00,Charles,144.0,74646,239.0,67368,20.0,4655,164.0,259.0,72023,79301,142014
2847,2847,2847,2847,2847,2847,2847,2847,2848,2021-06-19 15:00:00+00:00,Charles,111.0,74757,188.0,67556,3.0,4658,114.0,191.0,72214,79415,142313
2848,2848,2848,2848,2848,2848,2848,2848,2849,2021-06-20 15:00:00+00:00,Charles,64.0,74821,140.0,67696,9.0,4667,73.0,149.0,72363,79488,142517
2849,2849,2849,2849,2849,2849,2849,2849,2850,2021-06-21 15:00:00+00:00,Charles,112.0,74933,137.0,67833,8.0,4675,120.0,145.0,72508,79608,142766
2850,2850,2850,2850,2850,2850,2850,2850,2851,2021-06-22 15:00:00+00:00,Charles,127.0,75060,172.0,68005,7.0,4682,134.0,179.0,72687,79742,143065
2851,2851,2851,2851,2851,2851,2851,2851,2852,2021-06-23 15:00:00+00:00,Charles,150.0,75210,264.0,68269,3.0,4685,153.0,267.0,72954,79895,143479
2852,2852,2852,2852,2852,2852,2852,2852,2853,2021-06-24 15:00:00+00:00,Charles,140.0,75350,214.0,68483,4.0,4689,144.0,218.0,73172,80039,143833
2853,2853,2853,2853,2853,2853,2853,2853,2854,2021-06-25 15:00:00+00:00,Charles,156.0,75506,173.0,68656,7.0,4696,163.0,180.0,73352,80202,144162
2854,2854,2854,2854,2854,2854,2854,2854,2855,2021-06-26 15:00:00+00:00,Charles,89.0,75595,141.0,68797,3.0,4699,92.0,144.0,73496,80294,144392
2855,2855,2855,2855,2855,2855,2855,2855,2856,2021-06-27 15:00:00+00:00,Charles,63.0,75658,77.0,68874,1.0,4700,64.0,78.0,73574,80358,144532
2856,2856,2856,2856,2856,2856,2856,2856,2857,2021-06-28 15:00:00+00:00,Charles,132.0,75790,145.0,69019,8.0,4708,140.0,153.0,73727,80498,144809
2857,2857,2857,2857,2857,2857,2857,2857,2858,2021-06-29 15:00:00+00:00,Charles,129.0,75919,161.0,69180,13.0,4721,142.0,174.0,73901,80640,145099
2858,2858,2858,2858,2858,2858,2858,2858,2859,2021-06-30 15:00:00+00:00,Charles,176.0,76095,248.0,69428,3.0,4724,179.0,251.0,74152,80819,145523
2859,2859,2859,2859,2859,2859,2859,2859,2860,2021-07-01 15:00:00+00:00,Charles,140.0,76235,169.0,69597,11.0,4735,151.0,180.0,74332,80970,145832
2860,2860,2860,2860,2860,2860,2860,2860,2861,2021-07-02 15:00:00+00:00,Charles,157.0,76392,139.0,69736,3.0,4738,160.0,142.0,74474,81130,146128
2861,2861,2861,2861,2861,2861,2861,2861,2862,2021-07-03 15:00:00+00:00,Charles,92.0,76484,98.0,69834,6.0,4744,98.0,104.0,74578,81228,146318
2862,2862,2862,2862,2862,2862,2862,2862,2863,2021-07-04 15:00:00+00:00,Charles,2.0,76486,13.0,69847,,4744,,,74591,81230,146333
2863,2863,2863,2863,2863,2863,2863,2863,2864,2021-07-05 15:00:00+00:00,Charles,92.0,76578,123.0,69970,3.0,4747,95.0,126.0,74717,81325,146548
2864,2864,2864,2864,2864,2864,2864,2864,2865,2021-07-06 15:00:00+00:00,Charles,150.0,76728,176.0,70146,12.0,4759,162.0,188.0,74905,81487,146874
2865,2865,2865,2865,2865,2865,2865,2865,2866,2021-07-07 15:00:00+00:00,Charles,128.0,76856,169.0,70315,6.0,4765,134.0,175.0,75080,81621,147171
2866,2866,2866,2866,2866,2866,2866,2866,2867,2021-07-08 15:00:00+00:00,Charles,140.0,76996,159.0,70474,9.0,4774,149.0,168.0,75248,81770,147470
2867,2867,2867,2867,2867,2867,2867,2867,2868,2021-07-09 15:00:00+00:00,Charles,150.0,77146,162.0,70636,4.0,4778,154.0,166.0,75414,81924,147782
2868,2868,2868,2868,2868,2868,2868,2868,2869,2021-07-10 15:00:00+00:00,Charles,87.0,77233,123.0,70759,4.0,4782,91.0,127.0,75541,82015,147992
2869,2869,2869,2869,2869,2869,2869,2869,2870,2021-07-11 15:00:00+00:00,Charles,67.0,77300,73.0,70832,6.0,4788,73.0,79.0,75620,82088,148132
2870,2870,2870,2870,2870,2870,2870,2870,2871,2021-07-12 15:00:00+00:00,Charles,118.0,77418,113.0,70945,3.0,4791,121.0,116.0,75736,82209,148363
2871,2871,2871,2871,2871,2871,2871,2871,2872,2021-07-13 15:00:00+00:00,Charles,125.0,77543,122.0,71067,11.0,4802,136.0,133.0,75869,82345,148610
2872,2872,2872,2872,2872,2872,2872,2872,2873,2021-07-14 15:00:00+00:00,Charles,160.0,77703,156.0,71223,5.0,4807,165.0,161.0,76030,82510,148926
2873,2873,2873,2873,2873,2873,2873,2873,2874,2021-07-15 15:00:00+00:00,Charles,142.0,77845,148.0,71371,4.0,4811,146.0,152.0,76182,82656,149216
2874,2874,2874,2874,2874,2874,2874,2874,2875,2021-07-16 15:00:00+00:00,Charles,141.0,77986,134.0,71505,4.0,4815,145.0,138.0,76320,82801,149491
2875,2875,2875,2875,2875,2875,2875,2875,2876,2021-07-17 15:00:00+00:00,Charles,95.0,78081,101.0,71606,10.0,4825,105.0,111.0,76431,82906,149687
2876,2876,2876,2876,2876,2876,2876,2876,2877,2021-07-18 15:00:00+00:00,Charles,67.0,78148,62.0,71668,4.0,4829,71.0,66.0,76497,82977,149816
2877,2877,2877,2877,2877,2877,2877,2877,2878,2021-07-19 15:00:00+00:00,Charles,165.0,78313,115.0,71783,5.0,4834,170.0,120.0,76617,83147,150096
2878,2878,2878,2878,2878,2878,2878,2878,2879,2021-07-20 15:00:00+00:00,Charles,152.0,78465,107.0,71890,4.0,4838,156.0,111.0,76728,83303,150355
2879,2879,2879,2879,2879,2879,2879,2879,2880,2021-07-21 15:00:00+00:00,Charles,177.0,78642,136.0,72026,3.0,4841,180.0,139.0,76867,83483,150668
2880,2880,2880,2880,2880,2880,2880,2880,2881,2021-07-22 15:00:00+00:00,Charles,159.0,78801,125.0,72151,5.0,4846,164.0,130.0,76997,83647,150952
2881,2881,2881,2881,2881,2881,2881,2881,2882,2021-07-23 15:00:00+00:00,Charles,206.0,79007,141.0,72292,5.0,4851,211.0,146.0,77143,83858,151299
2882,2882,2882,2882,2882,2882,2882,2882,2883,2021-07-24 15:00:00+00:00,Charles,122.0,79129,82.0,72374,13.0,4864,135.0,95.0,77238,83993,151503
2883,2883,2883,2883,2883,2883,2883,2883,2884,2021-07-25 15:00:00+00:00,Charles,124.0,79253,36.0,72410,,4864,,,77274,84117,151663
2884,2884,2884,2884,2884,2884,2884,2884,2885,2021-07-26 15:00:00+00:00,Charles,200.0,79453,126.0,72536,5.0,4869,205.0,131.0,77405,84322,151989
2885,2885,2885,2885,2885,2885,2885,2885,2886,2021-07-27 15:00:00+00:00,Charles,190.0,79643,134.0,72670,3.0,4872,193.0,137.0,77542,84515,152313
2886,2886,2886,2886,2886,2886,2886,2886,2887,2021-07-28 15:00:00+00:00,Charles,249.0,79892,143.0,72813,7.0,4879,256.0,150.0,77692,84771,152705
2887,2887,2887,2887,2887,2887,2887,2887,2888,2021-07-29 15:00:00+00:00,Charles,210.0,80102,146.0,72959,4.0,4883,214.0,150.0,77842,84985,153061
2888,2888,2888,2888,2888,2888,2888,2888,2889,2021-07-30 15:00:00+00:00,Charles,239.0,80341,141.0,73100,10.0,4893,249.0,151.0,77993,85234,153441
2889,2889,2889,2889,2889,2889,2889,2889,2890,2021-07-31 15:00:00+00:00,Charles,173.0,80514,87.0,73187,7.0,4900,180.0,94.0,78087,85414,153701
2890,2890,2890,2890,2890,2890,2890,2890,2891,2021-08-01 15:00:00+00:00,Charles,105.0,80619,47.0,73234,4.0,4904,109.0,51.0,78138,85523,153853
2891,2891,2891,2891,2891,2891,2891,2891,2892,2021-08-02 15:00:00+00:00,Charles,190.0,80809,91.0,73325,9.0,4913,199.0,100.0,78238,85722,154134
2892,2892,2892,2892,2892,2892,2892,2892,2893,2021-08-03 15:00:00+00:00,Charles,211.0,81020,105.0,73430,5.0,4918,216.0,110.0,78348,85938,154450
2893,2893,2893,2893,2893,2893,2893,2893,2894,2021-08-04 15:00:00+00:00,Charles,264.0,81284,123.0,73553,7.0,4925,271.0,130.0,78478,86209,154837
2894,2894,2894,2894,2894,2894,2894,2894,2895,2021-08-05 15:00:00+00:00,Charles,224.0,81508,121.0,73674,8.0,4933,232.0,129.0,78607,86441,155182
2895,2895,2895,2895,2895,2895,2895,2895,2896,2021-08-06 15:00:00+00:00,Charles,246.0,81754,166.0,73840,8.0,4941,254.0,174.0,78781,86695,155594
2896,2896,2896,2896,2896,2896,2896,2896,2897,2021-08-07 15:00:00+00:00,Charles,129.0,81883,89.0,73929,10.0,4951,139.0,99.0,78880,86834,155812
2897,2897,2897,2897,2897,2897,2897,2897,2898,2021-08-08 15:00:00+00:00,Charles,91.0,81974,70.0,73999,1.0,4952,92.0,71.0,78951,86926,155973
2898,2898,2898,2898,2898,2898,2898,2898,2899,2021-08-09 15:00:00+00:00,Charles,231.0,82205,148.0,74147,,4952,,,79099,87157,156352
2899,2899,2899,2899,2899,2899,2899,2899,2900,2021-08-10 15:00:00+00:00,Charles,235.0,82440,135.0,74282,4.0,4956,239.0,139.0,79238,87396,156722
2900,2900,2900,2900,2900,2900,2900,2900,2901,2021-08-11 15:00:00+00:00,Charles,261.0,82701,152.0,74434,14.0,4970,275.0,166.0,79404,87671,157135
2901,2901,2901,2901,2901,2901,2901,2901,2902,2021-08-12 15:00:00+00:00,Charles,235.0,82936,128.0,74562,3.0,4973,238.0,131.0,79535,87909,157498
2902,2902,2902,2902,2902,2902,2902,2902,2903,2021-08-13 15:00:00+00:00,Charles,227.0,83163,146.0,74708,2.0,4975,229.0,148.0,79683,88138,157871
2903,2903,2903,2903,2903,2903,2903,2903,2904,2021-08-14 15:00:00+00:00,Charles,170.0,83333,89.0,74797,8.0,4983,178.0,97.0,79780,88316,158130
2904,2904,2904,2904,2904,2904,2904,2904,2905,2021-08-15 15:00:00+00:00,Charles,84.0,83417,101.0,74898,2.0,4985,86.0,103.0,79883,88402,158315
2905,2905,2905,2905,2905,2905,2905,2905,2906,2021-08-16 15:00:00+00:00,Charles,124.0,83541,143.0,75041,2.0,4987,126.0,145.0,80028,88528,158582
2906,2906,2906,2906,2906,2906,2906,2906,2907,2021-08-17 15:00:00+00:00,Charles,176.0,83717,148.0,75189,2.0,4989,178.0,150.0,80178,88706,158906
2907,2907,2907,2907,2907,2907,2907,2907,2908,2021-08-18 15:00:00+00:00,Charles,196.0,83913,163.0,75352,15.0,5004,211.0,178.0,80356,88917,159265
2908,2908,2908,2908,2908,2908,2908,2908,2909,2021-08-19 15:00:00+00:00,Charles,194.0,84107,158.0,75510,4.0,5008,198.0,162.0,80518,89115,159617
2909,2909,2909,2909,2909,2909,2909,2909,2910,2021-08-20 15:00:00+00:00,Charles,218.0,84325,219.0,75729,9.0,5017,227.0,228.0,80746,89342,160054
2910,2910,2910,2910,2910,2910,2910,2910,2911,2021-08-21 15:00:00+00:00,Charles,114.0,84439,107.0,75836,4.0,5021,118.0,111.0,80857,89460,160275
2911,2911,2911,2911,2911,2911,2911,2911,2912,2021-08-22 15:00:00+00:00,Charles,65.0,84504,93.0,75929,,5021,,,80950,89525,160433
2912,2912,2912,2912,2912,2912,2912,2912,2913,2021-08-23 15:00:00+00:00,Charles,184.0,84688,171.0,76100,4.0,5025,188.0,175.0,81125,89713,160788
2913,2913,2913,2913,2913,2913,2913,2913,2914,2021-08-24 15:00:00+00:00,Charles,176.0,84864,183.0,76283,7.0,5032,183.0,190.0,81315,89896,161147
2914,2914,2914,2914,2914,2914,2914,2914,2915,2021-08-25 15:00:00+00:00,Charles,192.0,85056,215.0,76498,5.0,5037,197.0,220.0,81535,90093,161554
2915,2915,2915,2915,2915,2915,2915,2915,2916,2021-08-26 15:00:00+00:00,Charles,235.0,85291,229.0,76727,11.0,5048,246.0,240.0,81775,90339,162018
2916,2916,2916,2916,2916,2916,2916,2916,2917,2021-08-27 15:00:00+00:00,Charles,171.0,85462,209.0,76936,3.0,5051,174.0,212.0,81987,90513,162398
2917,2917,2917,2917,2917,2917,2917,2917,2918,2021-08-28 15:00:00+00:00,Charles,139.0,85601,142.0,77078,22.0,5073,161.0,164.0,82151,90674,162679
2918,2918,2918,2918,2918,2918,2918,2918,2919,2021-08-29 15:00:00+00:00,Charles,111.0,85712,96.0,77174,1.0,5074,112.0,97.0,82248,90786,162886
2919,2919,2919,2919,2919,2919,2919,2919,2920,2021-08-30 15:00:00+00:00,Charles,162.0,85874,166.0,77340,5.0,5079,167.0,171.0,82419,90953,163214
2920,2920,2920,2920,2920,2920,2920,2920,2921,2021-08-31 15:00:00+00:00,Charles,133.0,86007,170.0,77510,1.0,5080,134.0,171.0,82590,91087,163517
2921,2921,2921,2921,2921,2921,2921,2921,2922,2021-09-01 15:00:00+00:00,Charles,175.0,86182,204.0,77714,10.0,5090,185.0,214.0,82804,91272,163896
2922,2922,2922,2922,2922,2922,2922,2922,2923,2021-09-02 15:00:00+00:00,Charles,138.0,86320,198.0,77912,3.0,5093,141.0,201.0,83005,91413,164232
2923,2923,2923,2923,2923,2923,2923,2923,2924,2021-09-03 15:00:00+00:00,Charles,156.0,86476,205.0,78117,5.0,5098,161.0,210.0,83215,91574,164593
2924,2924,2924,2924,2924,2924,2924,2924,2925,2021-09-04 15:00:00+00:00,Charles,96.0,86572,140.0,78257,3.0,5101,99.0,143.0,83358,91673,164829
2925,2925,2925,2925,2925,2925,2925,2925,2926,2021-09-05 15:00:00+00:00,Charles,99.0,86671,91.0,78348,2.0,5103,101.0,93.0,83451,91774,165019
2926,2926,2926,2926,2926,2926,2926,2926,2927,2021-09-06 15:00:00+00:00,Charles,15.0,86686,18.0,78366,1.0,5104,16.0,19.0,83470,91790,165052
2927,2927,2927,2927,2927,2927,2927,2927,2928,2021-09-07 15:00:00+00:00,Charles,147.0,86833,185.0,78551,2.0,5106,149.0,187.0,83657,91939,165384
2928,2928,2928,2928,2928,2928,2928,2928,2929,2021-09-08 15:00:00+00:00,Charles,141.0,86974,189.0,78740,5.0,5111,146.0,194.0,83851,92085,165714
2929,2929,2929,2929,2929,2929,2929,2929,2930,2021-09-09 15:00:00+00:00,Charles,181.0,87155,192.0,78932,3.0,5114,184.0,195.0,84046,92269,166087
2930,2930,2930,2930,2930,2930,2930,2930,2931,2021-09-10 15:00:00+00:00,Charles,150.0,87305,190.0,79122,10.0,5124,160.0,200.0,84246,92429,166427
2931,2931,2931,2931,2931,2931,2931,2931,2932,2021-09-11 15:00:00+00:00,Charles,120.0,87425,141.0,79263,7.0,5131,127.0,148.0,84394,92556,166688
2932,2932,2932,2932,2932,2932,2932,2932,2933,2021-09-12 15:00:00+00:00,Charles,84.0,87509,70.0,79333,1.0,5132,85.0,71.0,84465,92641,166842
2933,2933,2933,2933,2933,2933,2933,2933,2934,2021-09-13 15:00:00+00:00,Charles,144.0,87653,128.0,79461,1.0,5133,145.0,129.0,84594,92786,167114
2934,2934,2934,2934,2934,2934,2934,2934,2935,2021-09-14 15:00:00+00:00,Charles,134.0,87787,141.0,79602,11.0,5144,145.0,152.0,84746,92931,167389
2935,2935,2935,2935,2935,2935,2935,2935,2936,2021-09-15 15:00:00+00:00,Charles,118.0,87905,120.0,79722,2.0,5146,120.0,122.0,84868,93051,167627
2936,2936,2936,2936,2936,2936,2936,2936,2937,2021-09-16 15:00:00+00:00,Charles,113.0,88018,178.0,79900,6.0,5152,119.0,184.0,85052,93170,167918
2937,2937,2937,2937,2937,2937,2937,2937,2938,2021-09-17 15:00:00+00:00,Charles,132.0,88150,177.0,80077,12.0,5164,144.0,189.0,85241,93314,168227
2938,2938,2938,2938,2938,2938,2938,2938,2939,2021-09-18 15:00:00+00:00,Charles,105.0,88255,142.0,80219,5.0,5169,110.0,147.0,85388,93424,168474
2939,2939,2939,2939,2939,2939,2939,2939,2940,2021-09-19 15:00:00+00:00,Charles,59.0,88314,89.0,80308,1.0,5170,60.0,90.0,85478,93484,168622
2940,2940,2940,2940,2940,2940,2940,2940,2941,2021-09-20 15:00:00+00:00,Charles,133.0,88447,138.0,80446,5.0,5175,138.0,143.0,85621,93622,168893
2941,2941,2941,2941,2941,2941,2941,2941,2942,2021-09-21 15:00:00+00:00,Charles,90.0,88537,144.0,80590,10.0,5185,100.0,154.0,85775,93722,169127
2942,2942,2942,2942,2942,2942,2942,2942,2943,2021-09-22 15:00:00+00:00,Charles,110.0,88647,130.0,80720,2.0,5187,112.0,132.0,85907,93834,169367
2943,2943,2943,2943,2943,2943,2943,2943,2944,2021-09-23 15:00:00+00:00,Charles,122.0,88769,142.0,80862,1.0,5188,123.0,143.0,86050,93957,169631
2944,2944,2944,2944,2944,2944,2944,2944,2945,2021-09-24 15:00:00+00:00,Charles,142.0,88911,149.0,81011,2.0,5190,144.0,151.0,86201,94101,169922
2945,2945,2945,2945,2945,2945,2945,2945,2946,2021-09-25 15:00:00+00:00,Charles,61.0,88972,90.0,81101,2.0,5192,63.0,92.0,86293,94164,170073
2946,2946,2946,2946,2946,2946,2946,2946,2947,2021-09-26 15:00:00+00:00,Charles,56.0,89028,80.0,81181,,5192,,,86373,94220,170209
2947,2947,2947,2947,2947,2947,2947,2947,2948,2021-09-27 15:00:00+00:00,Charles,106.0,89134,67.0,81248,10.0,5202,116.0,77.0,86450,94336,170382
2948,2948,2948,2948,2948,2948,2948,2948,2949,2021-09-28 15:00:00+00:00,Charles,122.0,89256,138.0,81386,6.0,5208,128.0,144.0,86594,94464,170642
2949,2949,2949,2949,2949,2949,2949,2949,2950,2021-09-29 15:00:00+00:00,Charles,104.0,89360,137.0,81523,3.0,5211,107.0,140.0,86734,94571,170883
2950,2950,2950,2950,2950,2950,2950,2950,2951,2021-09-30 15:00:00+00:00,Charles,129.0,89489,135.0,81658,,5211,,,86869,94700,171147
2951,2951,2951,2951,2951,2951,2951,2951,2952,2021-10-01 15:00:00+00:00,Charles,157.0,89646,144.0,81802,21.0,5232,178.0,165.0,87034,94878,171448
2952,2952,2952,2952,2952,2952,2952,2952,2953,2021-10-02 15:00:00+00:00,Charles,77.0,89723,104.0,81906,2.0,5234,79.0,106.0,87140,94957,171629
2953,2953,2953,2953,2953,2953,2953,2953,2954,2021-10-03 15:00:00+00:00,Charles,58.0,89781,71.0,81977,,5234,,,87211,95015,171758
2954,2954,2954,2954,2954,2954,2954,2954,2955,2021-10-04 15:00:00+00:00,Charles,126.0,89907,101.0,82078,6.0,5240,132.0,107.0,87318,95147,171985
2955,2955,2955,2955,2955,2955,2955,2955,2956,2021-10-05 15:00:00+00:00,Charles,120.0,90027,108.0,82186,1.0,5241,121.0,109.0,87427,95268,172213
2956,2956,2956,2956,2956,2956,2956,2956,2957,2021-10-06 15:00:00+00:00,Charles,140.0,90167,101.0,82287,10.0,5251,150.0,111.0,87538,95418,172454
2957,2957,2957,2957,2957,2957,2957,2957,2958,2021-10-07 15:00:00+00:00,Charles,120.0,90287,110.0,82397,3.0,5254,123.0,113.0,87651,95541,172684
2958,2958,2958,2958,2958,2958,2958,2958,2959,2021-10-08 15:00:00+00:00,Charles,145.0,90432,116.0,82513,6.0,5260,151.0,122.0,87773,95692,172945
2959,2959,2959,2959,2959,2959,2959,2959,2960,2021-10-09 15:00:00+00:00,Charles,83.0,90515,79.0,82592,3.0,5263,86.0,82.0,87855,95778,173107
2960,2960,2960,2960,2960,2960,2960,2960,2961,2021-10-10 15:00:00+00:00,Charles,59.0,90574,64.0,82656,,5263,,,87919,95837,173230
2961,2961,2961,2961,2961,2961,2961,2961,2962,2021-10-11 15:00:00+00:00,Charles,130.0,90704,115.0,82771,5.0,5268,135.0,120.0,88039,95972,173475
2962,2962,2962,2962,2962,2962,2962,2962,2963,2021-10-12 15:00:00+00:00,Charles,104.0,90808,113.0,82884,6.0,5274,110.0,119.0,88158,96082,173692
2963,2963,2963,2963,2963,2963,2963,2963,2964,2021-10-13 15:00:00+00:00,Charles,113.0,90921,95.0,82979,9.0,5283,122.0,104.0,88262,96204,173900
2964,2964,2964,2964,2964,2964,2964,2964,2965,2021-10-14 15:00:00+00:00,Charles,132.0,91053,96.0,83075,6.0,5289,138.0,102.0,88364,96342,174128
2965,2965,2965,2965,2965,2965,2965,2965,2966,2021-10-15 15:00:00+00:00,Charles,150.0,91203,142.0,83217,10.0,5299,160.0,152.0,88516,96502,174420
2966,2966,2966,2966,2966,2966,2966,2966,2967,2021-10-16 15:00:00+00:00,Charles,68.0,91271,59.0,83276,3.0,5302,71.0,62.0,88578,96573,174547
2967,2967,2967,2967,2967,2967,2967,2967,2968,2021-10-17 15:00:00+00:00,Charles,46.0,91317,61.0,83337,1.0,5303,47.0,62.0,88640,96620,174654
2968,2968,2968,2968,2968,2968,2968,2968,2969,2021-10-18 15:00:00+00:00,Charles,185.0,91502,126.0,83463,10.0,5313,195.0,136.0,88776,96815,174965
2969,2969,2969,2969,2969,2969,2969,2969,2970,2021-10-19 15:00:00+00:00,Charles,123.0,91625,85.0,83548,3.0,5316,126.0,88.0,88864,96941,175173
2970,2970,2970,2970,2970,2970,2970,2970,2971,2021-10-20 15:00:00+00:00,Charles,89.0,91714,81.0,83629,8.0,5324,97.0,89.0,88953,97038,175343
2971,2971,2971,2971,2971,2971,2971,2971,2972,2021-10-21 15:00:00+00:00,Charles,85.0,91799,126.0,83755,10.0,5334,95.0,136.0,89089,97133,175554
2972,2972,2972,2972,2972,2972,2972,2972,2973,2021-10-22 15:00:00+00:00,Charles,137.0,91936,127.0,83882,9.0,5343,146.0,136.0,89225,97279,175818
2973,2973,2973,2973,2973,2973,2973,2973,2974,2021-10-23 15:00:00+00:00,Charles,75.0,92011,72.0,83954,3.0,5346,78.0,75.0,89300,97357,175965
2974,2974,2974,2974,2974,2974,2974,2974,2975,2021-10-24 15:00:00+00:00,Charles,37.0,92048,61.0,84015,1.0,5347,38.0,62.0,89362,97395,176063
2975,2975,2975,2975,2975,2975,2975,2975,2976,2021-10-25 15:00:00+00:00,Charles,137.0,92185,131.0,84146,9.0,5356,146.0,140.0,89502,97541,176331
2976,2976,2976,2976,2976,2976,2976,2976,2977,2021-10-26 15:00:00+00:00,Charles,92.0,92277,125.0,84271,6.0,5362,98.0,131.0,89633,97639,176548
2977,2977,2977,2977,2977,2977,2977,2977,2978,2021-10-27 15:00:00+00:00,Charles,82.0,92359,133.0,84404,5.0,5367,87.0,138.0,89771,97726,176763
2978,2978,2978,2978,2978,2978,2978,2978,2979,2021-10-28 15:00:00+00:00,Charles,107.0,92466,157.0,84561,6.0,5373,113.0,163.0,89934,97839,177027
2979,2979,2979,2979,2979,2979,2979,2979,2980,2021-10-29 15:00:00+00:00,Charles,130.0,92596,128.0,84689,6.0,5379,136.0,134.0,90068,97975,177285
2980,2980,2980,2980,2980,2980,2980,2980,2981,2021-10-30 15:00:00+00:00,Charles,52.0,92648,72.0,84761,2.0,5381,54.0,74.0,90142,98029,177409
2981,2981,2981,2981,2981,2981,2981,2981,2982,2021-10-31 15:00:00+00:00,Charles,37.0,92685,57.0,84818,3.0,5384,40.0,60.0,90202,98069,177503
2982,2982,2982,2982,2982,2982,2982,2982,2983,2021-11-01 15:00:00+00:00,Charles,128.0,92813,158.0,84976,11.0,5395,139.0,169.0,90371,98208,177789
2983,2983,2983,2983,2983,2983,2983,2983,2984,2021-11-02 15:00:00+00:00,Charles,102.0,92915,148.0,85124,11.0,5406,113.0,159.0,90530,98321,178039
2984,2984,2984,2984,2984,2984,2984,2984,2985,2021-11-03 15:00:00+00:00,Charles,103.0,93018,125.0,85249,12.0,5418,115.0,137.0,90667,98436,178267
2985,2985,2985,2985,2985,2985,2985,2985,2986,2021-11-04 15:00:00+00:00,Charles,99.0,93117,136.0,85385,7.0,5425,106.0,143.0,90810,98542,178502
2986,2986,2986,2986,2986,2986,2986,2986,2987,2021-11-05 15:00:00+00:00,Charles,109.0,93226,145.0,85530,12.0,5437,121.0,157.0,90967,98663,178756
2987,2987,2987,2987,2987,2987,2987,2987,2988,2021-11-06 15:00:00+00:00,Charles,31.0,93257,28.0,85558,3.0,5440,34.0,31.0,90998,98697,178815
2988,2988,2988,2988,2988,2988,2988,2988,2989,2020-12-16 15:00:00+00:00,Harford,50.0,50,,0,,0,,,0,50,50
2989,2989,2989,2989,2989,2989,2989,2989,2990,2020-12-17 15:00:00+00:00,Harford,64.0,114,,0,,0,,,0,114,114
2990,2990,2990,2990,2990,2990,2990,2990,2991,2020-12-18 15:00:00+00:00,Harford,127.0,241,,0,,0,,,0,241,241
2991,2991,2991,2991,2991,2991,2991,2991,2992,2020-12-19 15:00:00+00:00,Harford,44.0,285,,0,,0,,,0,285,285
2992,2992,2992,2992,2992,2992,2992,2992,2993,2020-12-20 15:00:00+00:00,Harford,23.0,308,,0,,0,,,0,308,308
2993,2993,2993,2993,2993,2993,2993,2993,2994,2020-12-21 15:00:00+00:00,Harford,286.0,594,,0,,0,,,0,594,594
2994,2994,2994,2994,2994,2994,2994,2994,2995,2020-12-22 15:00:00+00:00,Harford,271.0,865,,0,,0,,,0,865,865
2995,2995,2995,2995,2995,2995,2995,2995,2996,2020-12-23 15:00:00+00:00,Harford,216.0,1081,1.0,1,,0,,,1,1081,1082
2996,2996,2996,2996,2996,2996,2996,2996,2997,2020-12-24 15:00:00+00:00,Harford,105.0,1186,,1,,0,,,1,1186,1187
2997,2997,2997,2997,2997,2997,2997,2997,2998,2020-12-25 15:00:00+00:00,Harford,156.0,1342,,1,,0,,,1,1342,1343
2998,2998,2998,2998,2998,2998,2998,2998,2999,2020-12-26 15:00:00+00:00,Harford,128.0,1470,1.0,2,,0,,,2,1470,1472
2999,2999,2999,2999,2999,2999,2999,2999,3000,2020-12-27 15:00:00+00:00,Harford,56.0,1526,,2,,0,,,2,1526,1528
3000,3000,3000,3000,3000,3000,3000,3000,3001,2020-12-28 15:00:00+00:00,Harford,608.0,2134,2.0,4,,0,,,4,2134,2138
3001,3001,3001,3001,3001,3001,3001,3001,3002,2020-12-29 15:00:00+00:00,Harford,530.0,2664,1.0,5,,0,,,5,2664,2669
3002,3002,3002,3002,3002,3002,3002,3002,3003,2020-12-30 15:00:00+00:00,Harford,611.0,3275,,5,,0,,,5,3275,3280
3003,3003,3003,3003,3003,3003,3003,3003,3004,2020-12-31 15:00:00+00:00,Harford,202.0,3477,2.0,7,,0,,,7,3477,3484
3004,3004,3004,3004,3004,3004,3004,3004,3005,2021-01-01 15:00:00+00:00,Harford,276.0,3753,9.0,16,,0,,,16,3753,3769
3005,3005,3005,3005,3005,3005,3005,3005,3006,2021-01-02 15:00:00+00:00,Harford,128.0,3881,1.0,17,,0,,,17,3881,3898
3006,3006,3006,3006,3006,3006,3006,3006,3007,2021-01-03 15:00:00+00:00,Harford,105.0,3986,2.0,19,,0,,,19,3986,4005
3007,3007,3007,3007,3007,3007,3007,3007,3008,2021-01-04 15:00:00+00:00,Harford,771.0,4757,12.0,31,,0,,,31,4757,4788
3008,3008,3008,3008,3008,3008,3008,3008,3009,2021-01-05 15:00:00+00:00,Harford,731.0,5488,33.0,64,,0,,,64,5488,5552
3009,3009,3009,3009,3009,3009,3009,3009,3010,2021-01-06 15:00:00+00:00,Harford,856.0,6344,73.0,137,,0,,,137,6344,6481
3010,3010,3010,3010,3010,3010,3010,3010,3011,2021-01-07 15:00:00+00:00,Harford,926.0,7270,86.0,223,,0,,,223,7270,7493
3011,3011,3011,3011,3011,3011,3011,3011,3012,2021-01-08 15:00:00+00:00,Harford,740.0,8010,110.0,333,,0,,,333,8010,8343
3012,3012,3012,3012,3012,3012,3012,3012,3013,2021-01-09 15:00:00+00:00,Harford,88.0,8098,29.0,362,,0,,,362,8098,8460
3013,3013,3013,3013,3013,3013,3013,3013,3014,2021-01-10 15:00:00+00:00,Harford,48.0,8146,14.0,376,,0,,,376,8146,8522
3014,3014,3014,3014,3014,3014,3014,3014,3015,2021-01-11 15:00:00+00:00,Harford,687.0,8833,207.0,583,,0,,,583,8833,9416
3015,3015,3015,3015,3015,3015,3015,3015,3016,2021-01-12 15:00:00+00:00,Harford,694.0,9527,221.0,804,,0,,,804,9527,10331
3016,3016,3016,3016,3016,3016,3016,3016,3017,2021-01-13 15:00:00+00:00,Harford,826.0,10353,186.0,990,,0,,,990,10353,11343
3017,3017,3017,3017,3017,3017,3017,3017,3018,2021-01-14 15:00:00+00:00,Harford,835.0,11188,107.0,1097,,0,,,1097,11188,12285
3018,3018,3018,3018,3018,3018,3018,3018,3019,2021-01-15 15:00:00+00:00,Harford,634.0,11822,197.0,1294,,0,,,1294,11822,13116
3019,3019,3019,3019,3019,3019,3019,3019,3020,2021-01-16 15:00:00+00:00,Harford,119.0,11941,25.0,1319,,0,,,1319,11941,13260
3020,3020,3020,3020,3020,3020,3020,3020,3021,2021-01-17 15:00:00+00:00,Harford,41.0,11982,45.0,1364,,0,,,1364,11982,13346
3021,3021,3021,3021,3021,3021,3021,3021,3022,2021-01-18 15:00:00+00:00,Harford,315.0,12297,123.0,1487,,0,,,1487,12297,13784
3022,3022,3022,3022,3022,3022,3022,3022,3023,2021-01-19 15:00:00+00:00,Harford,866.0,13163,210.0,1697,,0,,,1697,13163,14860
3023,3023,3023,3023,3023,3023,3023,3023,3024,2021-01-20 15:00:00+00:00,Harford,897.0,14060,180.0,1877,,0,,,1877,14060,15937
3024,3024,3024,3024,3024,3024,3024,3024,3025,2021-01-21 15:00:00+00:00,Harford,1003.0,15063,177.0,2054,,0,,,2054,15063,17117
3025,3025,3025,3025,3025,3025,3025,3025,3026,2021-01-22 15:00:00+00:00,Harford,1438.0,16501,177.0,2231,,0,,,2231,16501,18732
3026,3026,3026,3026,3026,3026,3026,3026,3027,2021-01-23 15:00:00+00:00,Harford,312.0,16813,53.0,2284,,0,,,2284,16813,19097
3027,3027,3027,3027,3027,3027,3027,3027,3028,2021-01-24 15:00:00+00:00,Harford,321.0,17134,53.0,2337,,0,,,2337,17134,19471
3028,3028,3028,3028,3028,3028,3028,3028,3029,2021-01-25 15:00:00+00:00,Harford,913.0,18047,396.0,2733,,0,,,2733,18047,20780
3029,3029,3029,3029,3029,3029,3029,3029,3030,2021-01-26 15:00:00+00:00,Harford,841.0,18888,457.0,3190,,0,,,3190,18888,22078
3030,3030,3030,3030,3030,3030,3030,3030,3031,2021-01-27 15:00:00+00:00,Harford,1340.0,20228,717.0,3907,,0,,,3907,20228,24135
3031,3031,3031,3031,3031,3031,3031,3031,3032,2021-01-28 15:00:00+00:00,Harford,1104.0,21332,364.0,4271,,0,,,4271,21332,25603
3032,3032,3032,3032,3032,3032,3032,3032,3033,2021-01-29 15:00:00+00:00,Harford,1288.0,22620,309.0,4580,,0,,,4580,22620,27200
3033,3033,3033,3033,3033,3033,3033,3033,3034,2021-01-30 15:00:00+00:00,Harford,564.0,23184,101.0,4681,,0,,,4681,23184,27865
3034,3034,3034,3034,3034,3034,3034,3034,3035,2021-01-31 15:00:00+00:00,Harford,126.0,23310,20.0,4701,,0,,,4701,23310,28011
3035,3035,3035,3035,3035,3035,3035,3035,3036,2021-02-01 15:00:00+00:00,Harford,204.0,23514,252.0,4953,,0,,,4953,23514,28467
3036,3036,3036,3036,3036,3036,3036,3036,3037,2021-02-02 15:00:00+00:00,Harford,301.0,23815,575.0,5528,,0,,,5528,23815,29343
3037,3037,3037,3037,3037,3037,3037,3037,3038,2021-02-03 15:00:00+00:00,Harford,661.0,24476,1038.0,6566,,0,,,6566,24476,31042
3038,3038,3038,3038,3038,3038,3038,3038,3039,2021-02-04 15:00:00+00:00,Harford,611.0,25087,869.0,7435,,0,,,7435,25087,32522
3039,3039,3039,3039,3039,3039,3039,3039,3040,2021-02-05 15:00:00+00:00,Harford,601.0,25688,769.0,8204,,0,,,8204,25688,33892
3040,3040,3040,3040,3040,3040,3040,3040,3041,2021-02-06 15:00:00+00:00,Harford,526.0,26214,93.0,8297,,0,,,8297,26214,34511
3041,3041,3041,3041,3041,3041,3041,3041,3042,2021-02-07 15:00:00+00:00,Harford,88.0,26302,137.0,8434,,0,,,8434,26302,34736
3042,3042,3042,3042,3042,3042,3042,3042,3043,2021-02-08 15:00:00+00:00,Harford,277.0,26579,770.0,9204,,0,,,9204,26579,35783
3043,3043,3043,3043,3043,3043,3043,3043,3044,2021-02-09 15:00:00+00:00,Harford,410.0,26989,696.0,9900,,0,,,9900,26989,36889
3044,3044,3044,3044,3044,3044,3044,3044,3045,2021-02-10 15:00:00+00:00,Harford,794.0,27783,1337.0,11237,,0,,,11237,27783,39020
3045,3045,3045,3045,3045,3045,3045,3045,3046,2021-02-11 15:00:00+00:00,Harford,843.0,28626,496.0,11733,,0,,,11733,28626,40359
3046,3046,3046,3046,3046,3046,3046,3046,3047,2021-02-12 15:00:00+00:00,Harford,677.0,29303,588.0,12321,,0,,,12321,29303,41624
3047,3047,3047,3047,3047,3047,3047,3047,3048,2021-02-13 15:00:00+00:00,Harford,215.0,29518,79.0,12400,,0,,,12400,29518,41918
3048,3048,3048,3048,3048,3048,3048,3048,3049,2021-02-14 15:00:00+00:00,Harford,173.0,29691,25.0,12425,,0,,,12425,29691,42116
3049,3049,3049,3049,3049,3049,3049,3049,3050,2021-02-15 15:00:00+00:00,Harford,453.0,30144,887.0,13312,,0,,,13312,30144,43456
3050,3050,3050,3050,3050,3050,3050,3050,3051,2021-02-16 15:00:00+00:00,Harford,375.0,30519,1045.0,14357,,0,,,14357,30519,44876
3051,3051,3051,3051,3051,3051,3051,3051,3052,2021-02-17 15:00:00+00:00,Harford,742.0,31261,1550.0,15907,,0,,,15907,31261,47168
3052,3052,3052,3052,3052,3052,3052,3052,3053,2021-02-18 15:00:00+00:00,Harford,69.0,31330,171.0,16078,,0,,,16078,31330,47408
3053,3053,3053,3053,3053,3053,3053,3053,3054,2021-02-19 15:00:00+00:00,Harford,580.0,31910,1135.0,17213,,0,,,17213,31910,49123
3054,3054,3054,3054,3054,3054,3054,3054,3055,2021-02-20 15:00:00+00:00,Harford,230.0,32140,524.0,17737,,0,,,17737,32140,49877
3055,3055,3055,3055,3055,3055,3055,3055,3056,2021-02-21 15:00:00+00:00,Harford,89.0,32229,165.0,17902,,0,,,17902,32229,50131
3056,3056,3056,3056,3056,3056,3056,3056,3057,2021-02-22 15:00:00+00:00,Harford,187.0,32416,859.0,18761,,0,,,18761,32416,51177
3057,3057,3057,3057,3057,3057,3057,3057,3058,2021-02-23 15:00:00+00:00,Harford,455.0,32871,641.0,19402,,0,,,19402,32871,52273
3058,3058,3058,3058,3058,3058,3058,3058,3059,2021-02-24 15:00:00+00:00,Harford,1147.0,34018,1007.0,20409,,0,,,20409,34018,54427
3059,3059,3059,3059,3059,3059,3059,3059,3060,2021-02-25 15:00:00+00:00,Harford,902.0,34920,1034.0,21443,,0,,,21443,34920,56363
3060,3060,3060,3060,3060,3060,3060,3060,3061,2021-02-26 15:00:00+00:00,Harford,1645.0,36565,1327.0,22770,,0,,,22770,36565,59335
3061,3061,3061,3061,3061,3061,3061,3061,3062,2021-02-27 15:00:00+00:00,Harford,622.0,37187,297.0,23067,,0,,,23067,37187,60254
3062,3062,3062,3062,3062,3062,3062,3062,3063,2021-02-28 15:00:00+00:00,Harford,565.0,37752,64.0,23131,,0,,,23131,37752,60883
3063,3063,3063,3063,3063,3063,3063,3063,3064,2021-03-01 15:00:00+00:00,Harford,907.0,38659,297.0,23428,,0,,,23428,38659,62087
3064,3064,3064,3064,3064,3064,3064,3064,3065,2021-03-02 15:00:00+00:00,Harford,1337.0,39996,549.0,23977,1.0,1,1338.0,550.0,23978,39997,63973
3065,3065,3065,3065,3065,3065,3065,3065,3066,2021-03-03 15:00:00+00:00,Harford,1898.0,41894,648.0,24625,3.0,4,1901.0,651.0,24629,41898,66519
3066,3066,3066,3066,3066,3066,3066,3066,3067,2021-03-04 15:00:00+00:00,Harford,1159.0,43053,505.0,25130,96.0,100,1255.0,601.0,25230,43153,68183
3067,3067,3067,3067,3067,3067,3067,3067,3068,2021-03-05 15:00:00+00:00,Harford,863.0,43916,666.0,25796,102.0,202,965.0,768.0,25998,44118,69712
3068,3068,3068,3068,3068,3068,3068,3068,3069,2021-03-06 15:00:00+00:00,Harford,665.0,44581,203.0,25999,161.0,363,826.0,364.0,26362,44944,70580
3069,3069,3069,3069,3069,3069,3069,3069,3070,2021-03-07 15:00:00+00:00,Harford,527.0,45108,136.0,26135,249.0,612,776.0,385.0,26747,45720,71243
3070,3070,3070,3070,3070,3070,3070,3070,3071,2021-03-08 15:00:00+00:00,Harford,1040.0,46148,214.0,26349,197.0,809,1237.0,411.0,27158,46957,72497
3071,3071,3071,3071,3071,3071,3071,3071,3072,2021-03-09 15:00:00+00:00,Harford,1531.0,47679,509.0,26858,197.0,1006,1728.0,706.0,27864,48685,74537
3072,3072,3072,3072,3072,3072,3072,3072,3073,2021-03-10 15:00:00+00:00,Harford,1454.0,49133,485.0,27343,261.0,1267,1715.0,746.0,28610,50400,76476
3073,3073,3073,3073,3073,3073,3073,3073,3074,2021-03-11 15:00:00+00:00,Harford,1613.0,50746,534.0,27877,99.0,1366,1712.0,633.0,29243,52112,78623
3074,3074,3074,3074,3074,3074,3074,3074,3075,2021-03-12 15:00:00+00:00,Harford,1539.0,52285,917.0,28794,41.0,1407,1580.0,958.0,30201,53692,81079
3075,3075,3075,3075,3075,3075,3075,3075,3076,2021-03-13 15:00:00+00:00,Harford,864.0,53149,271.0,29065,13.0,1420,877.0,284.0,30485,54569,82214
3076,3076,3076,3076,3076,3076,3076,3076,3077,2021-03-14 15:00:00+00:00,Harford,586.0,53735,229.0,29294,8.0,1428,594.0,237.0,30722,55163,83029
3077,3077,3077,3077,3077,3077,3077,3077,3078,2021-03-15 15:00:00+00:00,Harford,1027.0,54762,406.0,29700,8.0,1436,1035.0,414.0,31136,56198,84462
3078,3078,3078,3078,3078,3078,3078,3078,3079,2021-03-16 15:00:00+00:00,Harford,1387.0,56149,407.0,30107,15.0,1451,1402.0,422.0,31558,57600,86256
3079,3079,3079,3079,3079,3079,3079,3079,3080,2021-03-17 15:00:00+00:00,Harford,1372.0,57521,833.0,30940,24.0,1475,1396.0,857.0,32415,58996,88461
3080,3080,3080,3080,3080,3080,3080,3080,3081,2021-03-18 15:00:00+00:00,Harford,1264.0,58785,373.0,31313,74.0,1549,1338.0,447.0,32862,60334,90098
3081,3081,3081,3081,3081,3081,3081,3081,3082,2021-03-19 15:00:00+00:00,Harford,1519.0,60304,790.0,32103,11.0,1560,1530.0,801.0,33663,61864,92407
3082,3082,3082,3082,3082,3082,3082,3082,3083,2021-03-20 15:00:00+00:00,Harford,887.0,61191,196.0,32299,12.0,1572,899.0,208.0,33871,62763,93490
3083,3083,3083,3083,3083,3083,3083,3083,3084,2021-03-21 15:00:00+00:00,Harford,643.0,61834,139.0,32438,11.0,1583,654.0,150.0,34021,63417,94272
3084,3084,3084,3084,3084,3084,3084,3084,3085,2021-03-22 15:00:00+00:00,Harford,1195.0,63029,252.0,32690,7.0,1590,1202.0,259.0,34280,64619,95719
3085,3085,3085,3085,3085,3085,3085,3085,3086,2021-03-23 15:00:00+00:00,Harford,2088.0,65117,584.0,33274,65.0,1655,2153.0,649.0,34929,66772,98391
3086,3086,3086,3086,3086,3086,3086,3086,3087,2021-03-24 15:00:00+00:00,Harford,1365.0,66482,1286.0,34560,26.0,1681,1391.0,1312.0,36241,68163,101042
3087,3087,3087,3087,3087,3087,3087,3087,3088,2021-03-25 15:00:00+00:00,Harford,1100.0,67582,910.0,35470,76.0,1757,1176.0,986.0,37227,69339,103052
3088,3088,3088,3088,3088,3088,3088,3088,3089,2021-03-26 15:00:00+00:00,Harford,1306.0,68888,1833.0,37303,33.0,1790,1339.0,1866.0,39093,70678,106191
3089,3089,3089,3089,3089,3089,3089,3089,3090,2021-03-27 15:00:00+00:00,Harford,995.0,69883,395.0,37698,36.0,1826,1031.0,431.0,39524,71709,107581
3090,3090,3090,3090,3090,3090,3090,3090,3091,2021-03-28 15:00:00+00:00,Harford,604.0,70487,445.0,38143,6.0,1832,610.0,451.0,39975,72319,108630
3091,3091,3091,3091,3091,3091,3091,3091,3092,2021-03-29 15:00:00+00:00,Harford,805.0,71292,1068.0,39211,30.0,1862,835.0,1098.0,41073,73154,110503
3092,3092,3092,3092,3092,3092,3092,3092,3093,2021-03-30 15:00:00+00:00,Harford,1320.0,72612,1696.0,40907,82.0,1944,1402.0,1778.0,42851,74556,113519
3093,3093,3093,3093,3093,3093,3093,3093,3094,2021-03-31 15:00:00+00:00,Harford,1548.0,74160,2083.0,42990,84.0,2028,1632.0,2167.0,45018,76188,117150
3094,3094,3094,3094,3094,3094,3094,3094,3095,2021-04-01 15:00:00+00:00,Harford,1103.0,75263,1413.0,44403,240.0,2268,1343.0,1653.0,46671,77531,119666
3095,3095,3095,3095,3095,3095,3095,3095,3096,2021-04-02 15:00:00+00:00,Harford,951.0,76214,1103.0,45506,340.0,2608,1291.0,1443.0,48114,78822,121720
3096,3096,3096,3096,3096,3096,3096,3096,3097,2021-04-03 15:00:00+00:00,Harford,639.0,76853,532.0,46038,254.0,2862,893.0,786.0,48900,79715,122891
3097,3097,3097,3097,3097,3097,3097,3097,3098,2021-04-04 15:00:00+00:00,Harford,416.0,77269,416.0,46454,381.0,3243,797.0,797.0,49697,80512,123723
3098,3098,3098,3098,3098,3098,3098,3098,3099,2021-04-05 15:00:00+00:00,Harford,992.0,78261,1210.0,47664,544.0,3787,1536.0,1754.0,51451,82048,125925
3099,3099,3099,3099,3099,3099,3099,3099,3100,2021-04-06 15:00:00+00:00,Harford,1571.0,79832,1632.0,49296,871.0,4658,2442.0,2503.0,53954,84490,129128
3100,3100,3100,3100,3100,3100,3100,3100,3101,2021-04-07 15:00:00+00:00,Harford,1115.0,80947,1693.0,50989,914.0,5572,2029.0,2607.0,56561,86519,131936
3101,3101,3101,3101,3101,3101,3101,3101,3102,2021-04-08 15:00:00+00:00,Harford,1983.0,82930,1066.0,52055,843.0,6415,2826.0,1909.0,58470,89345,134985
3102,3102,3102,3102,3102,3102,3102,3102,3103,2021-04-09 15:00:00+00:00,Harford,1543.0,84473,1524.0,53579,814.0,7229,2357.0,2338.0,60808,91702,138052
3103,3103,3103,3103,3103,3103,3103,3103,3104,2021-04-10 15:00:00+00:00,Harford,434.0,84907,541.0,54120,620.0,7849,1054.0,1161.0,61969,92756,139027
3104,3104,3104,3104,3104,3104,3104,3104,3105,2021-04-11 15:00:00+00:00,Harford,423.0,85330,421.0,54541,619.0,8468,1042.0,1040.0,63009,93798,139871
3105,3105,3105,3105,3105,3105,3105,3105,3106,2021-04-12 15:00:00+00:00,Harford,684.0,86014,1080.0,55621,348.0,8816,1032.0,1428.0,64437,94830,141635
3106,3106,3106,3106,3106,3106,3106,3106,3107,2021-04-13 15:00:00+00:00,Harford,1614.0,87628,1401.0,57022,30.0,8846,1644.0,1431.0,65868,96474,144650
3107,3107,3107,3107,3107,3107,3107,3107,3108,2021-04-14 15:00:00+00:00,Harford,1767.0,89395,1315.0,58337,1.0,8847,1768.0,1316.0,67184,98242,147732
3108,3108,3108,3108,3108,3108,3108,3108,3109,2021-04-15 15:00:00+00:00,Harford,2081.0,91476,1096.0,59433,1.0,8848,2082.0,1097.0,68281,100324,150909
3109,3109,3109,3109,3109,3109,3109,3109,3110,2021-04-16 15:00:00+00:00,Harford,1807.0,93283,1485.0,60918,2.0,8850,1809.0,1487.0,69768,102133,154201
3110,3110,3110,3110,3110,3110,3110,3110,3111,2021-04-17 15:00:00+00:00,Harford,802.0,94085,600.0,61518,,8850,,,70368,102935,155603
3111,3111,3111,3111,3111,3111,3111,3111,3112,2021-04-18 15:00:00+00:00,Harford,385.0,94470,519.0,62037,,8850,,,70887,103320,156507
3112,3112,3112,3112,3112,3112,3112,3112,3113,2021-04-19 15:00:00+00:00,Harford,1004.0,95474,1004.0,63041,,8850,,,71891,104324,158515
3113,3113,3113,3113,3113,3113,3113,3113,3114,2021-04-20 15:00:00+00:00,Harford,1196.0,96670,1935.0,64976,,8850,,,73826,105520,161646
3114,3114,3114,3114,3114,3114,3114,3114,3115,2021-04-21 15:00:00+00:00,Harford,1579.0,98249,1434.0,66410,,8850,,,75260,107099,164659
3115,3115,3115,3115,3115,3115,3115,3115,3116,2021-04-22 15:00:00+00:00,Harford,1808.0,100057,1212.0,67622,,8850,,,76472,108907,167679
3116,3116,3116,3116,3116,3116,3116,3116,3117,2021-04-23 15:00:00+00:00,Harford,1497.0,101554,1253.0,68875,1.0,8851,1498.0,1254.0,77726,110405,170429
3117,3117,3117,3117,3117,3117,3117,3117,3118,2021-04-24 15:00:00+00:00,Harford,1084.0,102638,1014.0,69889,,8851,,,78740,111489,172527
3118,3118,3118,3118,3118,3118,3118,3118,3119,2021-04-25 15:00:00+00:00,Harford,362.0,103000,268.0,70157,,8851,,,79008,111851,173157
3119,3119,3119,3119,3119,3119,3119,3119,3120,2021-04-26 15:00:00+00:00,Harford,771.0,103771,724.0,70881,5.0,8856,776.0,729.0,79737,112627,174652
3120,3120,3120,3120,3120,3120,3120,3120,3121,2021-04-27 15:00:00+00:00,Harford,1329.0,105100,1299.0,72180,55.0,8911,1384.0,1354.0,81091,114011,177280
3121,3121,3121,3121,3121,3121,3121,3121,3122,2021-04-28 15:00:00+00:00,Harford,1287.0,106387,1534.0,73714,58.0,8969,1345.0,1592.0,82683,115356,180101
3122,3122,3122,3122,3122,3122,3122,3122,3123,2021-04-29 15:00:00+00:00,Harford,952.0,107339,893.0,74607,59.0,9028,1011.0,952.0,83635,116367,181946
3123,3123,3123,3123,3123,3123,3123,3123,3124,2021-04-30 15:00:00+00:00,Harford,1057.0,108396,750.0,75357,52.0,9080,1109.0,802.0,84437,117476,183753
3124,3124,3124,3124,3124,3124,3124,3124,3125,2021-05-01 15:00:00+00:00,Harford,490.0,108886,548.0,75905,38.0,9118,528.0,586.0,85023,118004,184791
3125,3125,3125,3125,3125,3125,3125,3125,3126,2021-05-02 15:00:00+00:00,Harford,172.0,109058,391.0,76296,34.0,9152,206.0,425.0,85448,118210,185354
3126,3126,3126,3126,3126,3126,3126,3126,3127,2021-05-03 15:00:00+00:00,Harford,357.0,109415,719.0,77015,67.0,9219,424.0,786.0,86234,118634,186430
3127,3127,3127,3127,3127,3127,3127,3127,3128,2021-05-04 15:00:00+00:00,Harford,703.0,110118,1810.0,78825,51.0,9270,754.0,1861.0,88095,119388,188943
3128,3128,3128,3128,3128,3128,3128,3128,3129,2021-05-05 15:00:00+00:00,Harford,698.0,110816,1141.0,79966,73.0,9343,771.0,1214.0,89309,120159,190782
3129,3129,3129,3129,3129,3129,3129,3129,3130,2021-05-06 15:00:00+00:00,Harford,569.0,111385,1824.0,81790,82.0,9425,651.0,1906.0,91215,120810,193175
3130,3130,3130,3130,3130,3130,3130,3130,3131,2021-05-07 15:00:00+00:00,Harford,530.0,111915,1742.0,83532,85.0,9510,615.0,1827.0,93042,121425,195447
3131,3131,3131,3131,3131,3131,3131,3131,3132,2021-05-08 15:00:00+00:00,Harford,301.0,112216,681.0,84213,58.0,9568,359.0,739.0,93781,121784,196429
3132,3132,3132,3132,3132,3132,3132,3132,3133,2021-05-09 15:00:00+00:00,Harford,63.0,112279,300.0,84513,26.0,9594,89.0,326.0,94107,121873,196792
3133,3133,3133,3133,3133,3133,3133,3133,3134,2021-05-10 15:00:00+00:00,Harford,324.0,112603,824.0,85337,74.0,9668,398.0,898.0,95005,122271,197940
3134,3134,3134,3134,3134,3134,3134,3134,3135,2021-05-11 15:00:00+00:00,Harford,473.0,113076,1574.0,86911,52.0,9720,525.0,1626.0,96631,122796,199987
3135,3135,3135,3135,3135,3135,3135,3135,3136,2021-05-12 15:00:00+00:00,Harford,477.0,113553,1971.0,88882,43.0,9763,520.0,2014.0,98645,123316,202435
3136,3136,3136,3136,3136,3136,3136,3136,3137,2021-05-13 15:00:00+00:00,Harford,651.0,114204,2448.0,91330,59.0,9822,710.0,2507.0,101152,124026,205534
3137,3137,3137,3137,3137,3137,3137,3137,3138,2021-05-14 15:00:00+00:00,Harford,970.0,115174,1938.0,93268,66.0,9888,1036.0,2004.0,103156,125062,208442
3138,3138,3138,3138,3138,3138,3138,3138,3139,2021-05-15 15:00:00+00:00,Harford,508.0,115682,1198.0,94466,56.0,9944,564.0,1254.0,104410,125626,210148
3139,3139,3139,3139,3139,3139,3139,3139,3140,2021-05-16 15:00:00+00:00,Harford,233.0,115915,423.0,94889,48.0,9992,281.0,471.0,104881,125907,210804
3140,3140,3140,3140,3140,3140,3140,3140,3141,2021-05-17 15:00:00+00:00,Harford,532.0,116447,1058.0,95947,68.0,10060,600.0,1126.0,106007,126507,212394
3141,3141,3141,3141,3141,3141,3141,3141,3142,2021-05-18 15:00:00+00:00,Harford,956.0,117403,1700.0,97647,82.0,10142,1038.0,1782.0,107789,127545,215050
3142,3142,3142,3142,3142,3142,3142,3142,3143,2021-05-19 15:00:00+00:00,Harford,587.0,117990,1471.0,99118,55.0,10197,642.0,1526.0,109315,128187,217108
3143,3143,3143,3143,3143,3143,3143,3143,3144,2021-05-20 15:00:00+00:00,Harford,710.0,118700,1625.0,100743,61.0,10258,771.0,1686.0,111001,128958,219443
3144,3144,3144,3144,3144,3144,3144,3144,3145,2021-05-21 15:00:00+00:00,Harford,836.0,119536,1151.0,101894,70.0,10328,906.0,1221.0,112222,129864,221430
3145,3145,3145,3145,3145,3145,3145,3145,3146,2021-05-22 15:00:00+00:00,Harford,446.0,119982,574.0,102468,50.0,10378,496.0,624.0,112846,130360,222450
3146,3146,3146,3146,3146,3146,3146,3146,3147,2021-05-23 15:00:00+00:00,Harford,191.0,120173,215.0,102683,61.0,10439,252.0,276.0,113122,130612,222856
3147,3147,3147,3147,3147,3147,3147,3147,3148,2021-05-24 15:00:00+00:00,Harford,1374.0,121547,611.0,103294,85.0,10524,1459.0,696.0,113818,132071,224841
3148,3148,3148,3148,3148,3148,3148,3148,3149,2021-05-25 15:00:00+00:00,Harford,466.0,122013,881.0,104175,47.0,10571,513.0,928.0,114746,132584,226188
3149,3149,3149,3149,3149,3149,3149,3149,3150,2021-05-26 15:00:00+00:00,Harford,464.0,122477,667.0,104842,90.0,10661,554.0,757.0,115503,133138,227319
3150,3150,3150,3150,3150,3150,3150,3150,3151,2021-05-27 15:00:00+00:00,Harford,403.0,122880,630.0,105472,64.0,10725,467.0,694.0,116197,133605,228352
3151,3151,3151,3151,3151,3151,3151,3151,3152,2021-05-28 15:00:00+00:00,Harford,420.0,123300,616.0,106088,76.0,10801,496.0,692.0,116889,134101,229388
3152,3152,3152,3152,3152,3152,3152,3152,3153,2021-05-29 15:00:00+00:00,Harford,338.0,123638,304.0,106392,40.0,10841,378.0,344.0,117233,134479,230030
3153,3153,3153,3153,3153,3153,3153,3153,3154,2021-05-30 15:00:00+00:00,Harford,128.0,123766,138.0,106530,17.0,10858,145.0,155.0,117388,134624,230296
3154,3154,3154,3154,3154,3154,3154,3154,3155,2021-05-31 15:00:00+00:00,Harford,63.0,123829,109.0,106639,12.0,10870,75.0,121.0,117509,134699,230468
3155,3155,3155,3155,3155,3155,3155,3155,3156,2021-06-01 15:00:00+00:00,Harford,315.0,124144,699.0,107338,44.0,10914,359.0,743.0,118252,135058,231482
3156,3156,3156,3156,3156,3156,3156,3156,3157,2021-06-02 15:00:00+00:00,Harford,242.0,124386,548.0,107886,63.0,10977,305.0,611.0,118863,135363,232272
3157,3157,3157,3157,3157,3157,3157,3157,3158,2021-06-03 15:00:00+00:00,Harford,227.0,124613,721.0,108607,44.0,11021,271.0,765.0,119628,135634,233220
3158,3158,3158,3158,3158,3158,3158,3158,3159,2021-06-04 15:00:00+00:00,Harford,212.0,124825,880.0,109487,34.0,11055,246.0,914.0,120542,135880,234312
3159,3159,3159,3159,3159,3159,3159,3159,3160,2021-06-05 15:00:00+00:00,Harford,175.0,125000,491.0,109978,49.0,11104,224.0,540.0,121082,136104,234978
3160,3160,3160,3160,3160,3160,3160,3160,3161,2021-06-06 15:00:00+00:00,Harford,101.0,125101,114.0,110092,26.0,11130,127.0,140.0,121222,136231,235193
3161,3161,3161,3161,3161,3161,3161,3161,3162,2021-06-07 15:00:00+00:00,Harford,175.0,125276,516.0,110608,36.0,11166,211.0,552.0,121774,136442,235884
3162,3162,3162,3162,3162,3162,3162,3162,3163,2021-06-08 15:00:00+00:00,Harford,177.0,125453,799.0,111407,36.0,11202,213.0,835.0,122609,136655,236860
3163,3163,3163,3163,3163,3163,3163,3163,3164,2021-06-09 15:00:00+00:00,Harford,205.0,125658,539.0,111946,39.0,11241,244.0,578.0,123187,136899,237604
3164,3164,3164,3164,3164,3164,3164,3164,3165,2021-06-10 15:00:00+00:00,Harford,211.0,125869,1663.0,113609,55.0,11296,266.0,1718.0,124905,137165,239478
3165,3165,3165,3165,3165,3165,3165,3165,3166,2021-06-11 15:00:00+00:00,Harford,202.0,126071,780.0,114389,59.0,11355,261.0,839.0,125744,137426,240460
3166,3166,3166,3166,3166,3166,3166,3166,3167,2021-06-12 15:00:00+00:00,Harford,124.0,126195,391.0,114780,39.0,11394,163.0,430.0,126174,137589,240975
3167,3167,3167,3167,3167,3167,3167,3167,3168,2021-06-13 15:00:00+00:00,Harford,74.0,126269,229.0,115009,11.0,11405,85.0,240.0,126414,137674,241278
3168,3168,3168,3168,3168,3168,3168,3168,3169,2021-06-14 15:00:00+00:00,Harford,158.0,126427,348.0,115357,24.0,11429,182.0,372.0,126786,137856,241784
3169,3169,3169,3169,3169,3169,3169,3169,3170,2021-06-15 15:00:00+00:00,Harford,197.0,126624,541.0,115898,58.0,11487,255.0,599.0,127385,138111,242522
3170,3170,3170,3170,3170,3170,3170,3170,3171,2021-06-16 15:00:00+00:00,Harford,204.0,126828,483.0,116381,32.0,11519,236.0,515.0,127900,138347,243209
3171,3171,3171,3171,3171,3171,3171,3171,3172,2021-06-17 15:00:00+00:00,Harford,178.0,127006,431.0,116812,31.0,11550,209.0,462.0,128362,138556,243818
3172,3172,3172,3172,3172,3172,3172,3172,3173,2021-06-18 15:00:00+00:00,Harford,226.0,127232,435.0,117247,50.0,11600,276.0,485.0,128847,138832,244479
3173,3173,3173,3173,3173,3173,3173,3173,3174,2021-06-19 15:00:00+00:00,Harford,102.0,127334,371.0,117618,28.0,11628,130.0,399.0,129246,138962,244952
3174,3174,3174,3174,3174,3174,3174,3174,3175,2021-06-20 15:00:00+00:00,Harford,53.0,127387,123.0,117741,14.0,11642,67.0,137.0,129383,139029,245128
3175,3175,3175,3175,3175,3175,3175,3175,3176,2021-06-21 15:00:00+00:00,Harford,159.0,127546,187.0,117928,23.0,11665,182.0,210.0,129593,139211,245474
3176,3176,3176,3176,3176,3176,3176,3176,3177,2021-09-01 15:00:00+00:00,Calvert,71.0,52184,98.0,47737,13.0,3707,84.0,111.0,51444,55891,99921
3177,3177,3177,3177,3177,3177,3177,3177,3178,2021-09-02 15:00:00+00:00,Calvert,102.0,52286,95.0,47832,8.0,3715,110.0,103.0,51547,56001,100118
3178,3178,3178,3178,3178,3178,3178,3178,3179,2021-09-03 15:00:00+00:00,Calvert,103.0,52389,133.0,47965,3.0,3718,106.0,136.0,51683,56107,100354
3179,3179,3179,3179,3179,3179,3179,3179,3180,2021-09-04 15:00:00+00:00,Calvert,41.0,52430,71.0,48036,1.0,3719,42.0,72.0,51755,56149,100466
3180,3180,3180,3180,3180,3180,3180,3180,3181,2021-09-05 15:00:00+00:00,Calvert,49.0,52479,42.0,48078,3.0,3722,52.0,45.0,51800,56201,100557
3181,3181,3181,3181,3181,3181,3181,3181,3182,2021-09-06 15:00:00+00:00,Calvert,11.0,52490,15.0,48093,,3722,,,51815,56212,100583
3182,3182,3182,3182,3182,3182,3182,3182,3183,2021-09-07 15:00:00+00:00,Calvert,83.0,52573,78.0,48171,1.0,3723,84.0,79.0,51894,56296,100744
3183,3183,3183,3183,3183,3183,3183,3183,3184,2021-09-08 15:00:00+00:00,Calvert,75.0,52648,98.0,48269,3.0,3726,78.0,101.0,51995,56374,100917
3184,3184,3184,3184,3184,3184,3184,3184,3185,2021-09-09 15:00:00+00:00,Calvert,97.0,52745,94.0,48363,1.0,3727,98.0,95.0,52090,56472,101108
3185,3185,3185,3185,3185,3185,3185,3185,3186,2021-09-10 15:00:00+00:00,Calvert,107.0,52852,88.0,48451,4.0,3731,111.0,92.0,52182,56583,101303
3186,3186,3186,3186,3186,3186,3186,3186,3187,2021-09-11 15:00:00+00:00,Calvert,57.0,52909,41.0,48492,5.0,3736,62.0,46.0,52228,56645,101401
3187,3187,3187,3187,3187,3187,3187,3187,3188,2021-09-12 15:00:00+00:00,Calvert,35.0,52944,43.0,48535,1.0,3737,36.0,44.0,52272,56681,101479
3188,3188,3188,3188,3188,3188,3188,3188,3189,2021-09-13 15:00:00+00:00,Calvert,86.0,53030,83.0,48618,3.0,3740,89.0,86.0,52358,56770,101648
3189,3189,3189,3189,3189,3189,3189,3189,3190,2021-09-14 15:00:00+00:00,Calvert,76.0,53106,87.0,48705,4.0,3744,80.0,91.0,52449,56850,101811
3190,3190,3190,3190,3190,3190,3190,3190,3191,2021-09-15 15:00:00+00:00,Calvert,87.0,53193,99.0,48804,6.0,3750,93.0,105.0,52554,56943,101997
3191,3191,3191,3191,3191,3191,3191,3191,3192,2021-09-16 15:00:00+00:00,Calvert,92.0,53285,82.0,48886,3.0,3753,95.0,85.0,52639,57038,102171
3192,3192,3192,3192,3192,3192,3192,3192,3193,2021-09-17 15:00:00+00:00,Calvert,93.0,53378,117.0,49003,6.0,3759,99.0,123.0,52762,57137,102381
3193,3193,3193,3193,3193,3193,3193,3193,3194,2021-09-18 15:00:00+00:00,Calvert,25.0,53403,57.0,49060,6.0,3765,31.0,63.0,52825,57168,102463
3194,3194,3194,3194,3194,3194,3194,3194,3195,2021-09-19 15:00:00+00:00,Calvert,22.0,53425,39.0,49099,,3765,,,52864,57190,102524
3195,3195,3195,3195,3195,3195,3195,3195,3196,2021-09-20 15:00:00+00:00,Calvert,72.0,53497,60.0,49159,6.0,3771,78.0,66.0,52930,57268,102656
3196,3196,3196,3196,3196,3196,3196,3196,3197,2021-09-21 15:00:00+00:00,Calvert,76.0,53573,63.0,49222,6.0,3777,82.0,69.0,52999,57350,102795
3197,3197,3197,3197,3197,3197,3197,3197,3198,2021-09-22 15:00:00+00:00,Calvert,60.0,53633,66.0,49288,4.0,3781,64.0,70.0,53069,57414,102921
3198,3198,3198,3198,3198,3198,3198,3198,3199,2021-09-23 15:00:00+00:00,Calvert,92.0,53725,70.0,49358,1.0,3782,93.0,71.0,53140,57507,103083
3199,3199,3199,3199,3199,3199,3199,3199,3200,2021-09-24 15:00:00+00:00,Calvert,80.0,53805,94.0,49452,3.0,3785,83.0,97.0,53237,57590,103257
3200,3200,3200,3200,3200,3200,3200,3200,3201,2021-09-25 15:00:00+00:00,Calvert,29.0,53834,47.0,49499,,3785,,,53284,57619,103333
3201,3201,3201,3201,3201,3201,3201,3201,3202,2021-09-26 15:00:00+00:00,Calvert,23.0,53857,35.0,49534,,3785,,,53319,57642,103391
3202,3202,3202,3202,3202,3202,3202,3202,3203,2021-09-27 15:00:00+00:00,Calvert,63.0,53920,39.0,49573,1.0,3786,64.0,40.0,53359,57706,103493
3203,3203,3203,3203,3203,3203,3203,3203,3204,2021-09-28 15:00:00+00:00,Calvert,73.0,53993,74.0,49647,2.0,3788,75.0,76.0,53435,57781,103640
3204,3204,3204,3204,3204,3204,3204,3204,3205,2021-09-29 15:00:00+00:00,Calvert,79.0,54072,80.0,49727,4.0,3792,83.0,84.0,53519,57864,103799
3205,3205,3205,3205,3205,3205,3205,3205,3206,2021-09-30 15:00:00+00:00,Calvert,54.0,54126,73.0,49800,2.0,3794,56.0,75.0,53594,57920,103926
3206,3206,3206,3206,3206,3206,3206,3206,3207,2021-10-01 15:00:00+00:00,Calvert,75.0,54201,95.0,49895,7.0,3801,82.0,102.0,53696,58002,104096
3207,3207,3207,3207,3207,3207,3207,3207,3208,2021-10-02 15:00:00+00:00,Calvert,55.0,54256,48.0,49943,1.0,3802,56.0,49.0,53745,58058,104199
3208,3208,3208,3208,3208,3208,3208,3208,3209,2021-10-03 15:00:00+00:00,Calvert,27.0,54283,35.0,49978,1.0,3803,28.0,36.0,53781,58086,104261
3209,3209,3209,3209,3209,3209,3209,3209,3210,2021-10-04 15:00:00+00:00,Calvert,62.0,54345,56.0,50034,3.0,3806,65.0,59.0,53840,58151,104379
3210,3210,3210,3210,3210,3210,3210,3210,3211,2021-10-05 15:00:00+00:00,Calvert,78.0,54423,43.0,50077,4.0,3810,82.0,47.0,53887,58233,104500
3211,3211,3211,3211,3211,3211,3211,3211,3212,2021-10-06 15:00:00+00:00,Calvert,67.0,54490,56.0,50133,3.0,3813,70.0,59.0,53946,58303,104623
3212,3212,3212,3212,3212,3212,3212,3212,3213,2021-10-07 15:00:00+00:00,Calvert,66.0,54556,68.0,50201,10.0,3823,76.0,78.0,54024,58379,104757
3213,3213,3213,3213,3213,3213,3213,3213,3214,2021-10-08 15:00:00+00:00,Calvert,82.0,54638,81.0,50282,3.0,3826,85.0,84.0,54108,58464,104920
3214,3214,3214,3214,3214,3214,3214,3214,3215,2021-10-09 15:00:00+00:00,Calvert,27.0,54665,27.0,50309,1.0,3827,28.0,28.0,54136,58492,104974
3215,3215,3215,3215,3215,3215,3215,3215,3216,2021-10-10 15:00:00+00:00,Calvert,14.0,54679,24.0,50333,,3827,,,54160,58506,105012
3216,3216,3216,3216,3216,3216,3216,3216,3217,2021-10-11 15:00:00+00:00,Calvert,69.0,54748,26.0,50359,5.0,3832,74.0,31.0,54191,58580,105107
3217,3217,3217,3217,3217,3217,3217,3217,3218,2021-10-12 15:00:00+00:00,Calvert,60.0,54808,56.0,50415,7.0,3839,67.0,63.0,54254,58647,105223
3218,3218,3218,3218,3218,3218,3218,3218,3219,2021-10-13 15:00:00+00:00,Calvert,71.0,54879,47.0,50462,6.0,3845,77.0,53.0,54307,58724,105341
3219,3219,3219,3219,3219,3219,3219,3219,3220,2021-10-14 15:00:00+00:00,Calvert,60.0,54939,71.0,50533,13.0,3858,73.0,84.0,54391,58797,105472
3220,3220,3220,3220,3220,3220,3220,3220,3221,2021-10-15 15:00:00+00:00,Calvert,62.0,55001,52.0,50585,11.0,3869,73.0,63.0,54454,58870,105586
3221,3221,3221,3221,3221,3221,3221,3221,3222,2021-10-16 15:00:00+00:00,Calvert,28.0,55029,31.0,50616,2.0,3871,30.0,33.0,54487,58900,105645
3222,3222,3222,3222,3222,3222,3222,3222,3223,2021-10-17 15:00:00+00:00,Calvert,15.0,55044,22.0,50638,1.0,3872,16.0,23.0,54510,58916,105682
3223,3223,3223,3223,3223,3223,3223,3223,3224,2021-10-18 15:00:00+00:00,Calvert,63.0,55107,59.0,50697,6.0,3878,69.0,65.0,54575,58985,105804
3224,3224,3224,3224,3224,3224,3224,3224,3225,2021-10-19 15:00:00+00:00,Calvert,47.0,55154,53.0,50750,6.0,3884,53.0,59.0,54634,59038,105904
3225,3225,3225,3225,3225,3225,3225,3225,3226,2021-10-20 15:00:00+00:00,Calvert,35.0,55189,68.0,50818,2.0,3886,37.0,70.0,54704,59075,106007
3226,3226,3226,3226,3226,3226,3226,3226,3227,2021-10-21 15:00:00+00:00,Calvert,63.0,55252,56.0,50874,7.0,3893,70.0,63.0,54767,59145,106126
3227,3227,3227,3227,3227,3227,3227,3227,3228,2021-10-22 15:00:00+00:00,Calvert,64.0,55316,78.0,50952,8.0,3901,72.0,86.0,54853,59217,106268
3228,3228,3228,3228,3228,3228,3228,3228,3229,2021-10-23 15:00:00+00:00,Calvert,19.0,55335,32.0,50984,1.0,3902,20.0,33.0,54886,59237,106319
3229,3229,3229,3229,3229,3229,3229,3229,3230,2021-10-24 15:00:00+00:00,Calvert,19.0,55354,32.0,51016,,3902,,,54918,59256,106370
3230,3230,3230,3230,3230,3230,3230,3230,3231,2021-10-25 15:00:00+00:00,Calvert,69.0,55423,116.0,51132,9.0,3911,78.0,125.0,55043,59334,106555
3231,3231,3231,3231,3231,3231,3231,3231,3232,2021-10-26 15:00:00+00:00,Calvert,61.0,55484,86.0,51218,9.0,3920,70.0,95.0,55138,59404,106702
3232,3232,3232,3232,3232,3232,3232,3232,3233,2021-10-27 15:00:00+00:00,Calvert,64.0,55548,80.0,51298,4.0,3924,68.0,84.0,55222,59472,106846
3233,3233,3233,3233,3233,3233,3233,3233,3234,2021-10-28 15:00:00+00:00,Calvert,49.0,55597,77.0,51375,5.0,3929,54.0,82.0,55304,59526,106972
3234,3234,3234,3234,3234,3234,3234,3234,3235,2021-10-29 15:00:00+00:00,Calvert,48.0,55645,93.0,51468,6.0,3935,54.0,99.0,55403,59580,107113
3235,3235,3235,3235,3235,3235,3235,3235,3236,2021-10-30 15:00:00+00:00,Calvert,23.0,55668,29.0,51497,2.0,3937,25.0,31.0,55434,59605,107165
3236,3236,3236,3236,3236,3236,3236,3236,3237,2021-10-31 15:00:00+00:00,Calvert,16.0,55684,17.0,51514,1.0,3938,17.0,18.0,55452,59622,107198
3237,3237,3237,3237,3237,3237,3237,3237,3238,2021-11-01 15:00:00+00:00,Calvert,60.0,55744,85.0,51599,13.0,3951,73.0,98.0,55550,59695,107343
3238,3238,3238,3238,3238,3238,3238,3238,3239,2021-11-02 15:00:00+00:00,Calvert,58.0,55802,68.0,51667,6.0,3957,64.0,74.0,55624,59759,107469
3239,3239,3239,3239,3239,3239,3239,3239,3240,2021-11-03 15:00:00+00:00,Calvert,54.0,55856,88.0,51755,7.0,3964,61.0,95.0,55719,59820,107611
3240,3240,3240,3240,3240,3240,3240,3240,3241,2021-11-04 15:00:00+00:00,Calvert,42.0,55898,74.0,51829,8.0,3972,50.0,82.0,55801,59870,107727
3241,3241,3241,3241,3241,3241,3241,3241,3242,2021-11-05 15:00:00+00:00,Calvert,46.0,55944,75.0,51904,9.0,3981,55.0,84.0,55885,59925,107848
3242,3242,3242,3242,3242,3242,3242,3242,3243,2021-11-06 15:00:00+00:00,Calvert,12.0,55956,16.0,51920,3.0,3984,15.0,19.0,55904,59940,107876
3243,3243,3243,3243,3243,3243,3243,3243,3244,2020-12-14 15:00:00+00:00,Frederick,1.0,1,,0,,0,,,0,1,1
3244,3244,3244,3244,3244,3244,3244,3244,3245,2020-12-15 15:00:00+00:00,Frederick,4.0,5,,0,,0,,,0,5,5
3245,3245,3245,3245,3245,3245,3245,3245,3246,2020-12-16 15:00:00+00:00,Frederick,1.0,6,,0,,0,,,0,6,6
3246,3246,3246,3246,3246,3246,3246,3246,3247,2020-12-17 15:00:00+00:00,Frederick,25.0,31,,0,,0,,,0,31,31
3247,3247,3247,3247,3247,3247,3247,3247,3248,2020-12-18 15:00:00+00:00,Frederick,130.0,161,1.0,1,,0,,,1,161,162
3248,3248,3248,3248,3248,3248,3248,3248,3249,2020-12-19 15:00:00+00:00,Frederick,13.0,174,1.0,2,,0,,,2,174,176
3249,3249,3249,3249,3249,3249,3249,3249,3250,2020-12-20 15:00:00+00:00,Frederick,13.0,187,,2,,0,,,2,187,189
3250,3250,3250,3250,3250,3250,3250,3250,3251,2020-12-21 15:00:00+00:00,Frederick,210.0,397,1.0,3,,0,,,3,397,400
3251,3251,3251,3251,3251,3251,3251,3251,3252,2020-12-22 15:00:00+00:00,Frederick,338.0,735,1.0,4,,0,,,4,735,739
3252,3252,3252,3252,3252,3252,3252,3252,3253,2020-12-23 15:00:00+00:00,Frederick,241.0,976,2.0,6,,0,,,6,976,982
3253,3253,3253,3253,3253,3253,3253,3253,3254,2020-12-24 15:00:00+00:00,Frederick,24.0,1000,,6,,0,,,6,1000,1006
3254,3254,3254,3254,3254,3254,3254,3254,3255,2020-12-25 15:00:00+00:00,Frederick,11.0,1011,,6,,0,,,6,1011,1017
3255,3255,3255,3255,3255,3255,3255,3255,3256,2020-12-26 15:00:00+00:00,Frederick,18.0,1029,,6,,0,,,6,1029,1035
3256,3256,3256,3256,3256,3256,3256,3256,3257,2020-12-27 15:00:00+00:00,Frederick,157.0,1186,2.0,8,,0,,,8,1186,1194
3257,3257,3257,3257,3257,3257,3257,3257,3258,2020-12-28 15:00:00+00:00,Frederick,298.0,1484,2.0,10,,0,,,10,1484,1494
3258,3258,3258,3258,3258,3258,3258,3258,3259,2020-12-29 15:00:00+00:00,Frederick,504.0,1988,,10,,0,,,10,1988,1998
3259,3259,3259,3259,3259,3259,3259,3259,3260,2020-12-30 15:00:00+00:00,Frederick,465.0,2453,11.0,21,,0,,,21,2453,2474
3260,3260,3260,3260,3260,3260,3260,3260,3261,2020-12-31 15:00:00+00:00,Frederick,208.0,2661,3.0,24,,0,,,24,2661,2685
3261,3261,3261,3261,3261,3261,3261,3261,3262,2021-01-01 15:00:00+00:00,Frederick,116.0,2777,13.0,37,,0,,,37,2777,2814
3262,3262,3262,3262,3262,3262,3262,3262,3263,2021-01-02 15:00:00+00:00,Frederick,41.0,2818,1.0,38,,0,,,38,2818,2856
3263,3263,3263,3263,3263,3263,3263,3263,3264,2021-01-03 15:00:00+00:00,Frederick,87.0,2905,3.0,41,,0,,,41,2905,2946
3264,3264,3264,3264,3264,3264,3264,3264,3265,2021-01-04 15:00:00+00:00,Frederick,610.0,3515,17.0,58,,0,,,58,3515,3573
3265,3265,3265,3265,3265,3265,3265,3265,3266,2021-01-05 15:00:00+00:00,Frederick,770.0,4285,20.0,78,,0,,,78,4285,4363
3266,3266,3266,3266,3266,3266,3266,3266,3267,2021-01-06 15:00:00+00:00,Frederick,762.0,5047,15.0,93,,0,,,93,5047,5140
3267,3267,3267,3267,3267,3267,3267,3267,3268,2021-01-07 15:00:00+00:00,Frederick,536.0,5583,46.0,139,,0,,,139,5583,5722
3268,3268,3268,3268,3268,3268,3268,3268,3269,2021-01-08 15:00:00+00:00,Frederick,422.0,6005,118.0,257,,0,,,257,6005,6262
3269,3269,3269,3269,3269,3269,3269,3269,3270,2021-01-09 15:00:00+00:00,Frederick,341.0,6346,15.0,272,,0,,,272,6346,6618
3270,3270,3270,3270,3270,3270,3270,3270,3271,2021-01-10 15:00:00+00:00,Frederick,104.0,6450,23.0,295,,0,,,295,6450,6745
3271,3271,3271,3271,3271,3271,3271,3271,3272,2021-01-11 15:00:00+00:00,Frederick,606.0,7056,213.0,508,,0,,,508,7056,7564
3272,3272,3272,3272,3272,3272,3272,3272,3273,2021-01-12 15:00:00+00:00,Frederick,1120.0,8176,288.0,796,,0,,,796,8176,8972
3273,3273,3273,3273,3273,3273,3273,3273,3274,2021-01-13 15:00:00+00:00,Frederick,792.0,8968,213.0,1009,,0,,,1009,8968,9977
3274,3274,3274,3274,3274,3274,3274,3274,3275,2021-01-14 15:00:00+00:00,Frederick,1116.0,10084,32.0,1041,,0,,,1041,10084,11125
3275,3275,3275,3275,3275,3275,3275,3275,3276,2021-01-15 15:00:00+00:00,Frederick,1082.0,11166,42.0,1083,,0,,,1083,11166,12249
3276,3276,3276,3276,3276,3276,3276,3276,3277,2021-01-16 15:00:00+00:00,Frederick,429.0,11595,42.0,1125,,0,,,1125,11595,12720
3277,3277,3277,3277,3277,3277,3277,3277,3278,2021-01-17 15:00:00+00:00,Frederick,70.0,11665,100.0,1225,,0,,,1225,11665,12890
3278,3278,3278,3278,3278,3278,3278,3278,3279,2021-01-18 15:00:00+00:00,Frederick,209.0,11874,203.0,1428,,0,,,1428,11874,13302
3279,3279,3279,3279,3279,3279,3279,3279,3280,2021-01-19 15:00:00+00:00,Frederick,627.0,12501,202.0,1630,,0,,,1630,12501,14131
3280,3280,3280,3280,3280,3280,3280,3280,3281,2021-01-20 15:00:00+00:00,Frederick,1211.0,13712,400.0,2030,,0,,,2030,13712,15742
3281,3281,3281,3281,3281,3281,3281,3281,3282,2021-01-21 15:00:00+00:00,Frederick,1239.0,14951,220.0,2250,,0,,,2250,14951,17201
3282,3282,3282,3282,3282,3282,3282,3282,3283,2021-01-22 15:00:00+00:00,Frederick,1674.0,16625,61.0,2311,,0,,,2311,16625,18936
3283,3283,3283,3283,3283,3283,3283,3283,3284,2021-01-23 15:00:00+00:00,Frederick,478.0,17103,16.0,2327,,0,,,2327,17103,19430
3284,3284,3284,3284,3284,3284,3284,3284,3285,2021-01-24 15:00:00+00:00,Frederick,80.0,17183,107.0,2434,,0,,,2434,17183,19617
3285,3285,3285,3285,3285,3285,3285,3285,3286,2021-01-25 15:00:00+00:00,Frederick,590.0,17773,351.0,2785,,0,,,2785,17773,20558
3286,3286,3286,3286,3286,3286,3286,3286,3287,2021-01-26 15:00:00+00:00,Frederick,566.0,18339,365.0,3150,,0,,,3150,18339,21489
3287,3287,3287,3287,3287,3287,3287,3287,3288,2021-01-27 15:00:00+00:00,Frederick,1523.0,19862,557.0,3707,,0,,,3707,19862,23569
3288,3288,3288,3288,3288,3288,3288,3288,3289,2021-06-22 15:00:00+00:00,Harford,156.0,127702,303.0,118231,45.0,11710,201.0,348.0,129941,139412,245933
3289,3289,3289,3289,3289,3289,3289,3289,3290,2021-06-23 15:00:00+00:00,Harford,154.0,127856,294.0,118525,28.0,11738,182.0,322.0,130263,139594,246381
3290,3290,3290,3290,3290,3290,3290,3290,3291,2021-06-24 15:00:00+00:00,Harford,149.0,128005,226.0,118751,25.0,11763,174.0,251.0,130514,139768,246756
3291,3291,3291,3291,3291,3291,3291,3291,3292,2021-06-25 15:00:00+00:00,Harford,179.0,128184,273.0,119024,21.0,11784,200.0,294.0,130808,139968,247208
3292,3292,3292,3292,3292,3292,3292,3292,3293,2021-06-26 15:00:00+00:00,Harford,86.0,128270,168.0,119192,6.0,11790,92.0,174.0,130982,140060,247462
3293,3293,3293,3293,3293,3293,3293,3293,3294,2021-06-27 15:00:00+00:00,Harford,71.0,128341,114.0,119306,3.0,11793,74.0,117.0,131099,140134,247647
3294,3294,3294,3294,3294,3294,3294,3294,3295,2021-06-28 15:00:00+00:00,Harford,161.0,128502,157.0,119463,24.0,11817,185.0,181.0,131280,140319,247965
3295,3295,3295,3295,3295,3295,3295,3295,3296,2021-06-29 15:00:00+00:00,Harford,138.0,128640,198.0,119661,21.0,11838,159.0,219.0,131499,140478,248301
3296,3296,3296,3296,3296,3296,3296,3296,3297,2021-06-30 15:00:00+00:00,Harford,136.0,128776,194.0,119855,28.0,11866,164.0,222.0,131721,140642,248631
3297,3297,3297,3297,3297,3297,3297,3297,3298,2021-07-01 15:00:00+00:00,Harford,142.0,128918,174.0,120029,20.0,11886,162.0,194.0,131915,140804,248947
3298,3298,3298,3298,3298,3298,3298,3298,3299,2021-07-02 15:00:00+00:00,Harford,130.0,129048,190.0,120219,14.0,11900,144.0,204.0,132119,140948,249267
3299,3299,3299,3299,3299,3299,3299,3299,3300,2021-07-03 15:00:00+00:00,Harford,83.0,129131,112.0,120331,10.0,11910,93.0,122.0,132241,141041,249462
3300,3300,3300,3300,3300,3300,3300,3300,3301,2021-07-04 15:00:00+00:00,Harford,28.0,129159,19.0,120350,2.0,11912,30.0,21.0,132262,141071,249509
3301,3301,3301,3301,3301,3301,3301,3301,3302,2021-07-05 15:00:00+00:00,Harford,145.0,129304,139.0,120489,25.0,11937,170.0,164.0,132426,141241,249793
3302,3302,3302,3302,3302,3302,3302,3302,3303,2021-07-06 15:00:00+00:00,Harford,129.0,129433,175.0,120664,21.0,11958,150.0,196.0,132622,141391,250097
3303,3303,3303,3303,3303,3303,3303,3303,3304,2021-07-07 15:00:00+00:00,Harford,126.0,129559,195.0,120859,15.0,11973,141.0,210.0,132832,141532,250418
3304,3304,3304,3304,3304,3304,3304,3304,3305,2021-07-08 15:00:00+00:00,Harford,167.0,129726,186.0,121045,21.0,11994,188.0,207.0,133039,141720,250771
3305,3305,3305,3305,3305,3305,3305,3305,3306,2021-07-09 15:00:00+00:00,Harford,152.0,129878,245.0,121290,16.0,12010,168.0,261.0,133300,141888,251168
3306,3306,3306,3306,3306,3306,3306,3306,3307,2021-07-10 15:00:00+00:00,Harford,78.0,129956,96.0,121386,7.0,12017,85.0,103.0,133403,141973,251342
3307,3307,3307,3307,3307,3307,3307,3307,3308,2021-07-11 15:00:00+00:00,Harford,92.0,130048,62.0,121448,10.0,12027,102.0,72.0,133475,142075,251496
3308,3308,3308,3308,3308,3308,3308,3308,3309,2021-07-12 15:00:00+00:00,Harford,140.0,130188,151.0,121599,21.0,12048,161.0,172.0,133647,142236,251787
3309,3309,3309,3309,3309,3309,3309,3309,3310,2021-07-13 15:00:00+00:00,Harford,117.0,130305,132.0,121731,18.0,12066,135.0,150.0,133797,142371,252036
3310,3310,3310,3310,3310,3310,3310,3310,3311,2021-07-14 15:00:00+00:00,Harford,130.0,130435,155.0,121886,13.0,12079,143.0,168.0,133965,142514,252321
3311,3311,3311,3311,3311,3311,3311,3311,3312,2021-07-15 15:00:00+00:00,Harford,152.0,130587,158.0,122044,15.0,12094,167.0,173.0,134138,142681,252631
3312,3312,3312,3312,3312,3312,3312,3312,3313,2021-07-16 15:00:00+00:00,Harford,168.0,130755,185.0,122229,14.0,12108,182.0,199.0,134337,142863,252984
3313,3313,3313,3313,3313,3313,3313,3313,3314,2021-07-17 15:00:00+00:00,Harford,92.0,130847,75.0,122304,4.0,12112,96.0,79.0,134416,142959,253151
3314,3314,3314,3314,3314,3314,3314,3314,3315,2021-07-18 15:00:00+00:00,Harford,76.0,130923,69.0,122373,4.0,12116,80.0,73.0,134489,143039,253296
3315,3315,3315,3315,3315,3315,3315,3315,3316,2021-07-19 15:00:00+00:00,Harford,164.0,131087,178.0,122551,23.0,12139,187.0,201.0,134690,143226,253638
3316,3316,3316,3316,3316,3316,3316,3316,3317,2021-07-20 15:00:00+00:00,Harford,174.0,131261,123.0,122674,27.0,12166,201.0,150.0,134840,143427,253935
3317,3317,3317,3317,3317,3317,3317,3317,3318,2021-07-21 15:00:00+00:00,Harford,211.0,131472,132.0,122806,14.0,12180,225.0,146.0,134986,143652,254278
3318,3318,3318,3318,3318,3318,3318,3318,3319,2021-07-22 15:00:00+00:00,Harford,173.0,131645,126.0,122932,14.0,12194,187.0,140.0,135126,143839,254577
3319,3319,3319,3319,3319,3319,3319,3319,3320,2021-07-23 15:00:00+00:00,Harford,211.0,131856,148.0,123080,45.0,12239,256.0,193.0,135319,144095,254936
3320,3320,3320,3320,3320,3320,3320,3320,3321,2021-07-24 15:00:00+00:00,Harford,134.0,131990,97.0,123177,10.0,12249,144.0,107.0,135426,144239,255167
3321,3321,3321,3321,3321,3321,3321,3321,3322,2021-07-25 15:00:00+00:00,Harford,108.0,132098,26.0,123203,8.0,12257,116.0,34.0,135460,144355,255301
3322,3322,3322,3322,3322,3322,3322,3322,3323,2021-07-26 15:00:00+00:00,Harford,202.0,132300,134.0,123337,31.0,12288,233.0,165.0,135625,144588,255637
3323,3323,3323,3323,3323,3323,3323,3323,3324,2021-07-27 15:00:00+00:00,Harford,239.0,132539,142.0,123479,30.0,12318,269.0,172.0,135797,144857,256018
3324,3324,3324,3324,3324,3324,3324,3324,3325,2021-07-28 15:00:00+00:00,Harford,219.0,132758,118.0,123597,20.0,12338,239.0,138.0,135935,145096,256355
3325,3325,3325,3325,3325,3325,3325,3325,3326,2021-07-29 15:00:00+00:00,Harford,258.0,133016,147.0,123744,8.0,12346,266.0,155.0,136090,145362,256760
3326,3326,3326,3326,3326,3326,3326,3326,3327,2021-07-30 15:00:00+00:00,Harford,249.0,133265,144.0,123888,20.0,12366,269.0,164.0,136254,145631,257153
3327,3327,3327,3327,3327,3327,3327,3327,3328,2021-07-31 15:00:00+00:00,Harford,142.0,133407,87.0,123975,19.0,12385,161.0,106.0,136360,145792,257382
3328,3328,3328,3328,3328,3328,3328,3328,3329,2021-08-01 15:00:00+00:00,Harford,140.0,133547,78.0,124053,9.0,12394,149.0,87.0,136447,145941,257600
3329,3329,3329,3329,3329,3329,3329,3329,3330,2021-08-02 15:00:00+00:00,Harford,232.0,133779,123.0,124176,18.0,12412,250.0,141.0,136588,146191,257955
3330,3330,3330,3330,3330,3330,3330,3330,3331,2021-08-03 15:00:00+00:00,Harford,205.0,133984,112.0,124288,27.0,12439,232.0,139.0,136727,146423,258272
3331,3331,3331,3331,3331,3331,3331,3331,3332,2021-08-04 15:00:00+00:00,Harford,227.0,134211,123.0,124411,26.0,12465,253.0,149.0,136876,146676,258622
3332,3332,3332,3332,3332,3332,3332,3332,3333,2021-08-05 15:00:00+00:00,Harford,252.0,134463,136.0,124547,28.0,12493,280.0,164.0,137040,146956,259010
3333,3333,3333,3333,3333,3333,3333,3333,3334,2021-08-06 15:00:00+00:00,Harford,327.0,134790,134.0,124681,23.0,12516,350.0,157.0,137197,147306,259471
3334,3334,3334,3334,3334,3334,3334,3334,3335,2021-08-07 15:00:00+00:00,Harford,204.0,134994,91.0,124772,9.0,12525,213.0,100.0,137297,147519,259766
3335,3335,3335,3335,3335,3335,3335,3335,3336,2021-08-08 15:00:00+00:00,Harford,150.0,135144,78.0,124850,11.0,12536,161.0,89.0,137386,147680,259994
3336,3336,3336,3336,3336,3336,3336,3336,3337,2021-08-09 15:00:00+00:00,Harford,261.0,135405,167.0,125017,26.0,12562,287.0,193.0,137579,147967,260422
3337,3337,3337,3337,3337,3337,3337,3337,3338,2021-08-10 15:00:00+00:00,Harford,280.0,135685,134.0,125151,13.0,12575,293.0,147.0,137726,148260,260836
3338,3338,3338,3338,3338,3338,3338,3338,3339,2021-08-11 15:00:00+00:00,Harford,259.0,135944,159.0,125310,24.0,12599,283.0,183.0,137909,148543,261254
3339,3339,3339,3339,3339,3339,3339,3339,3340,2021-08-12 15:00:00+00:00,Harford,204.0,136148,128.0,125438,25.0,12624,229.0,153.0,138062,148772,261586
3340,3340,3340,3340,3340,3340,3340,3340,3341,2021-08-13 15:00:00+00:00,Harford,290.0,136438,168.0,125606,22.0,12646,312.0,190.0,138252,149084,262044
3341,3341,3341,3341,3341,3341,3341,3341,3342,2021-08-14 15:00:00+00:00,Harford,173.0,136611,131.0,125737,11.0,12657,184.0,142.0,138394,149268,262348
3342,3342,3342,3342,3342,3342,3342,3342,3343,2021-08-15 15:00:00+00:00,Harford,124.0,136735,98.0,125835,7.0,12664,131.0,105.0,138499,149399,262570
3343,3343,3343,3343,3343,3343,3343,3343,3344,2021-08-16 15:00:00+00:00,Harford,194.0,136929,158.0,125993,23.0,12687,217.0,181.0,138680,149616,262922
3344,3344,3344,3344,3344,3344,3344,3344,3345,2021-08-17 15:00:00+00:00,Harford,222.0,137151,177.0,126170,18.0,12705,240.0,195.0,138875,149856,263321
3345,3345,3345,3345,3345,3345,3345,3345,3346,2021-08-18 15:00:00+00:00,Harford,198.0,137349,185.0,126355,17.0,12722,215.0,202.0,139077,150071,263704
3346,3346,3346,3346,3346,3346,3346,3346,3347,2021-08-19 15:00:00+00:00,Harford,203.0,137552,194.0,126549,19.0,12741,222.0,213.0,139290,150293,264101
3347,3347,3347,3347,3347,3347,3347,3347,3348,2021-08-20 15:00:00+00:00,Harford,235.0,137787,180.0,126729,20.0,12761,255.0,200.0,139490,150548,264516
3348,3348,3348,3348,3348,3348,3348,3348,3349,2021-08-21 15:00:00+00:00,Harford,147.0,137934,116.0,126845,11.0,12772,158.0,127.0,139617,150706,264779
3349,3349,3349,3349,3349,3349,3349,3349,3350,2021-08-22 15:00:00+00:00,Harford,114.0,138048,103.0,126948,13.0,12785,127.0,116.0,139733,150833,264996
3350,3350,3350,3350,3350,3350,3350,3350,3351,2021-08-23 15:00:00+00:00,Harford,204.0,138252,198.0,127146,15.0,12800,219.0,213.0,139946,151052,265398
3351,3351,3351,3351,3351,3351,3351,3351,3352,2021-08-24 15:00:00+00:00,Harford,212.0,138464,175.0,127321,29.0,12829,241.0,204.0,140150,151293,265785
3352,3352,3352,3352,3352,3352,3352,3352,3353,2021-08-25 15:00:00+00:00,Harford,198.0,138662,186.0,127507,30.0,12859,228.0,216.0,140366,151521,266169
3353,3353,3353,3353,3353,3353,3353,3353,3354,2021-08-26 15:00:00+00:00,Harford,208.0,138870,202.0,127709,22.0,12881,230.0,224.0,140590,151751,266579
3354,3354,3354,3354,3354,3354,3354,3354,3355,2021-08-27 15:00:00+00:00,Harford,216.0,139086,258.0,127967,24.0,12905,240.0,282.0,140872,151991,267053
3355,3355,3355,3355,3355,3355,3355,3355,3356,2021-08-28 15:00:00+00:00,Harford,150.0,139236,168.0,128135,5.0,12910,155.0,173.0,141045,152146,267371
3356,3356,3356,3356,3356,3356,3356,3356,3357,2021-08-29 15:00:00+00:00,Harford,148.0,139384,162.0,128297,9.0,12919,157.0,171.0,141216,152303,267681
3357,3357,3357,3357,3357,3357,3357,3357,3358,2021-08-30 15:00:00+00:00,Harford,179.0,139563,238.0,128535,9.0,12928,188.0,247.0,141463,152491,268098
3358,3358,3358,3358,3358,3358,3358,3358,3359,2021-08-31 15:00:00+00:00,Harford,173.0,139736,250.0,128785,17.0,12945,190.0,267.0,141730,152681,268521
3359,3359,3359,3359,3359,3359,3359,3359,3360,2021-09-01 15:00:00+00:00,Harford,203.0,139939,217.0,129002,19.0,12964,222.0,236.0,141966,152903,268941
3360,3360,3360,3360,3360,3360,3360,3360,3361,2021-09-02 15:00:00+00:00,Harford,179.0,140118,180.0,129182,11.0,12975,190.0,191.0,142157,153093,269300
3361,3361,3361,3361,3361,3361,3361,3361,3362,2021-09-03 15:00:00+00:00,Harford,163.0,140281,272.0,129454,13.0,12988,176.0,285.0,142442,153269,269735
3362,3362,3362,3362,3362,3362,3362,3362,3363,2021-09-04 15:00:00+00:00,Harford,154.0,140435,160.0,129614,9.0,12997,163.0,169.0,142611,153432,270049
3363,3363,3363,3363,3363,3363,3363,3363,3364,2021-09-05 15:00:00+00:00,Harford,123.0,140558,134.0,129748,16.0,13013,139.0,150.0,142761,153571,270306
3364,3364,3364,3364,3364,3364,3364,3364,3365,2021-09-06 15:00:00+00:00,Harford,51.0,140609,63.0,129811,3.0,13016,54.0,66.0,142827,153625,270420
3365,3365,3365,3365,3365,3365,3365,3365,3366,2021-09-07 15:00:00+00:00,Harford,166.0,140775,258.0,130069,11.0,13027,177.0,269.0,143096,153802,270844
3366,3366,3366,3366,3366,3366,3366,3366,3367,2021-09-08 15:00:00+00:00,Harford,178.0,140953,189.0,130258,23.0,13050,201.0,212.0,143308,154003,271211
3367,3367,3367,3367,3367,3367,3367,3367,3368,2021-09-09 15:00:00+00:00,Harford,188.0,141141,189.0,130447,12.0,13062,200.0,201.0,143509,154203,271588
3368,3368,3368,3368,3368,3368,3368,3368,3369,2021-09-10 15:00:00+00:00,Harford,218.0,141359,230.0,130677,8.0,13070,226.0,238.0,143747,154429,272036
3369,3369,3369,3369,3369,3369,3369,3369,3370,2021-09-11 15:00:00+00:00,Harford,124.0,141483,165.0,130842,14.0,13084,138.0,179.0,143926,154567,272325
3370,3370,3370,3370,3370,3370,3370,3370,3371,2021-09-12 15:00:00+00:00,Harford,89.0,141572,118.0,130960,10.0,13094,99.0,128.0,144054,154666,272532
3371,3371,3371,3371,3371,3371,3371,3371,3372,2021-09-13 15:00:00+00:00,Harford,167.0,141739,183.0,131143,14.0,13108,181.0,197.0,144251,154847,272882
3372,3372,3372,3372,3372,3372,3372,3372,3373,2021-09-14 15:00:00+00:00,Harford,127.0,141866,202.0,131345,5.0,13113,132.0,207.0,144458,154979,273211
3373,3373,3373,3373,3373,3373,3373,3373,3374,2021-09-15 15:00:00+00:00,Harford,126.0,141992,174.0,131519,22.0,13135,148.0,196.0,144654,155127,273511
3374,3374,3374,3374,3374,3374,3374,3374,3375,2021-09-16 15:00:00+00:00,Harford,135.0,142127,201.0,131720,15.0,13150,150.0,216.0,144870,155277,273847
3375,3375,3375,3375,3375,3375,3375,3375,3376,2021-09-17 15:00:00+00:00,Harford,168.0,142295,225.0,131945,17.0,13167,185.0,242.0,145112,155462,274240
3376,3376,3376,3376,3376,3376,3376,3376,3377,2021-09-18 15:00:00+00:00,Harford,74.0,142369,135.0,132080,12.0,13179,86.0,147.0,145259,155548,274449
3377,3377,3377,3377,3377,3377,3377,3377,3378,2021-09-19 15:00:00+00:00,Harford,82.0,142451,129.0,132209,7.0,13186,89.0,136.0,145395,155637,274660
3378,3378,3378,3378,3378,3378,3378,3378,3379,2021-09-20 15:00:00+00:00,Harford,108.0,142559,149.0,132358,18.0,13204,126.0,167.0,145562,155763,274917
3379,3379,3379,3379,3379,3379,3379,3379,3380,2021-09-21 15:00:00+00:00,Harford,109.0,142668,155.0,132513,11.0,13215,120.0,166.0,145728,155883,275181
3380,3380,3380,3380,3380,3380,3380,3380,3381,2021-09-22 15:00:00+00:00,Harford,106.0,142774,140.0,132653,21.0,13236,127.0,161.0,145889,156010,275427
3381,3381,3381,3381,3381,3381,3381,3381,3382,2021-09-23 15:00:00+00:00,Harford,95.0,142869,174.0,132827,14.0,13250,109.0,188.0,146077,156119,275696
3382,3382,3382,3382,3382,3382,3382,3382,3383,2021-09-24 15:00:00+00:00,Harford,136.0,143005,185.0,133012,15.0,13265,151.0,200.0,146277,156270,276017
3383,3383,3383,3383,3383,3383,3383,3383,3384,2021-09-25 15:00:00+00:00,Harford,77.0,143082,143.0,133155,3.0,13268,80.0,146.0,146423,156350,276237
3384,3384,3384,3384,3384,3384,3384,3384,3385,2021-09-26 15:00:00+00:00,Harford,68.0,143150,108.0,133263,12.0,13280,80.0,120.0,146543,156430,276413
3385,3385,3385,3385,3385,3385,3385,3385,3386,2021-09-27 15:00:00+00:00,Harford,129.0,143279,109.0,133372,12.0,13292,141.0,121.0,146664,156571,276651
3386,3386,3386,3386,3386,3386,3386,3386,3387,2021-09-28 15:00:00+00:00,Harford,119.0,143398,133.0,133505,12.0,13304,131.0,145.0,146809,156702,276903
3387,3387,3387,3387,3387,3387,3387,3387,3388,2021-09-29 15:00:00+00:00,Harford,124.0,143522,169.0,133674,21.0,13325,145.0,190.0,146999,156847,277196
3388,3388,3388,3388,3388,3388,3388,3388,3389,2021-09-30 15:00:00+00:00,Harford,118.0,143640,167.0,133841,12.0,13337,130.0,179.0,147178,156977,277481
3389,3389,3389,3389,3389,3389,3389,3389,3390,2021-10-01 15:00:00+00:00,Harford,112.0,143752,190.0,134031,6.0,13343,118.0,196.0,147374,157095,277783
3390,3390,3390,3390,3390,3390,3390,3390,3391,2021-10-02 15:00:00+00:00,Harford,65.0,143817,104.0,134135,9.0,13352,74.0,113.0,147487,157169,277952
3391,3391,3391,3391,3391,3391,3391,3391,3392,2021-10-03 15:00:00+00:00,Harford,49.0,143866,95.0,134230,2.0,13354,51.0,97.0,147584,157220,278096
3392,3392,3392,3392,3392,3392,3392,3392,3393,2021-10-04 15:00:00+00:00,Harford,132.0,143998,157.0,134387,10.0,13364,142.0,167.0,147751,157362,278385
3393,3393,3393,3393,3393,3393,3393,3393,3394,2021-10-05 15:00:00+00:00,Harford,99.0,144097,113.0,134500,2.0,13366,101.0,115.0,147866,157463,278597
3394,3394,3394,3394,3394,3394,3394,3394,3395,2021-10-06 15:00:00+00:00,Harford,125.0,144222,116.0,134616,13.0,13379,138.0,129.0,147995,157601,278838
3395,3395,3395,3395,3395,3395,3395,3395,3396,2021-10-07 15:00:00+00:00,Harford,107.0,144329,137.0,134753,7.0,13386,114.0,144.0,148139,157715,279082
3396,3396,3396,3396,3396,3396,3396,3396,3397,2021-10-08 15:00:00+00:00,Harford,145.0,144474,174.0,134927,1.0,13387,146.0,175.0,148314,157861,279401
3397,3397,3397,3397,3397,3397,3397,3397,3398,2021-10-09 15:00:00+00:00,Harford,64.0,144538,79.0,135006,9.0,13396,73.0,88.0,148402,157934,279544
3398,3398,3398,3398,3398,3398,3398,3398,3399,2021-10-10 15:00:00+00:00,Harford,69.0,144607,55.0,135061,8.0,13404,77.0,63.0,148465,158011,279668
3399,3399,3399,3399,3399,3399,3399,3399,3400,2021-10-11 15:00:00+00:00,Harford,135.0,144742,98.0,135159,4.0,13408,139.0,102.0,148567,158150,279901
3400,3400,3400,3400,3400,3400,3400,3400,3401,2021-10-12 15:00:00+00:00,Harford,86.0,144828,115.0,135274,9.0,13417,95.0,124.0,148691,158245,280102
3401,3401,3401,3401,3401,3401,3401,3401,3402,2021-10-13 15:00:00+00:00,Harford,104.0,144932,106.0,135380,27.0,13444,131.0,133.0,148824,158376,280312
3402,3402,3402,3402,3402,3402,3402,3402,3403,2021-10-14 15:00:00+00:00,Harford,108.0,145040,97.0,135477,4.0,13448,112.0,101.0,148925,158488,280517
3403,3403,3403,3403,3403,3403,3403,3403,3404,2021-10-15 15:00:00+00:00,Harford,117.0,145157,133.0,135610,16.0,13464,133.0,149.0,149074,158621,280767
3404,3404,3404,3404,3404,3404,3404,3404,3405,2021-10-16 15:00:00+00:00,Harford,71.0,145228,73.0,135683,9.0,13473,80.0,82.0,149156,158701,280911
3405,3405,3405,3405,3405,3405,3405,3405,3406,2021-10-17 15:00:00+00:00,Harford,57.0,145285,52.0,135735,10.0,13483,67.0,62.0,149218,158768,281020
3406,3406,3406,3406,3406,3406,3406,3406,3407,2021-10-18 15:00:00+00:00,Harford,123.0,145408,136.0,135871,20.0,13503,143.0,156.0,149374,158911,281279
3407,3407,3407,3407,3407,3407,3407,3407,3408,2021-10-19 15:00:00+00:00,Harford,92.0,145500,102.0,135973,9.0,13512,101.0,111.0,149485,159012,281473
3408,3408,3408,3408,3408,3408,3408,3408,3409,2021-10-20 15:00:00+00:00,Harford,97.0,145597,124.0,136097,18.0,13530,115.0,142.0,149627,159127,281694
3409,3409,3409,3409,3409,3409,3409,3409,3410,2021-10-21 15:00:00+00:00,Harford,91.0,145688,91.0,136188,10.0,13540,101.0,101.0,149728,159228,281876
3410,3410,3410,3410,3410,3410,3410,3410,3411,2021-10-22 15:00:00+00:00,Harford,126.0,145814,172.0,136360,5.0,13545,131.0,177.0,149905,159359,282174
3411,3411,3411,3411,3411,3411,3411,3411,3412,2021-10-23 15:00:00+00:00,Harford,66.0,145880,95.0,136455,15.0,13560,81.0,110.0,150015,159440,282335
3412,3412,3412,3412,3412,3412,3412,3412,3413,2021-10-24 15:00:00+00:00,Harford,52.0,145932,93.0,136548,10.0,13570,62.0,103.0,150118,159502,282480
3413,3413,3413,3413,3413,3413,3413,3413,3414,2021-10-25 15:00:00+00:00,Harford,123.0,146055,211.0,136759,21.0,13591,144.0,232.0,150350,159646,282814
3414,3414,3414,3414,3414,3414,3414,3414,3415,2021-10-26 15:00:00+00:00,Harford,134.0,146189,175.0,136934,23.0,13614,157.0,198.0,150548,159803,283123
3415,3415,3415,3415,3415,3415,3415,3415,3416,2021-10-27 15:00:00+00:00,Harford,121.0,146310,228.0,137162,31.0,13645,152.0,259.0,150807,159955,283472
3416,3416,3416,3416,3416,3416,3416,3416,3417,2021-10-28 15:00:00+00:00,Harford,114.0,146424,202.0,137364,17.0,13662,131.0,219.0,151026,160086,283788
3417,3417,3417,3417,3417,3417,3417,3417,3418,2021-10-29 15:00:00+00:00,Harford,141.0,146565,216.0,137580,9.0,13671,150.0,225.0,151251,160236,284145
3418,3418,3418,3418,3418,3418,3418,3418,3419,2021-10-30 15:00:00+00:00,Harford,62.0,146627,107.0,137687,20.0,13691,82.0,127.0,151378,160318,284314
3419,3419,3419,3419,3419,3419,3419,3419,3420,2021-10-31 15:00:00+00:00,Harford,44.0,146671,84.0,137771,7.0,13698,51.0,91.0,151469,160369,284442
3420,3420,3420,3420,3420,3420,3420,3420,3421,2021-11-01 15:00:00+00:00,Harford,137.0,146808,198.0,137969,12.0,13710,149.0,210.0,151679,160518,284777
3421,3421,3421,3421,3421,3421,3421,3421,3422,2021-11-02 15:00:00+00:00,Harford,121.0,146929,199.0,138168,17.0,13727,138.0,216.0,151895,160656,285097
3422,3422,3422,3422,3422,3422,3422,3422,3423,2021-11-03 15:00:00+00:00,Harford,133.0,147062,187.0,138355,38.0,13765,171.0,225.0,152120,160827,285417
3423,3423,3423,3423,3423,3423,3423,3423,3424,2021-11-04 15:00:00+00:00,Harford,99.0,147161,176.0,138531,19.0,13784,118.0,195.0,152315,160945,285692
3424,3424,3424,3424,3424,3424,3424,3424,3425,2021-11-05 15:00:00+00:00,Harford,107.0,147268,181.0,138712,8.0,13792,115.0,189.0,152504,161060,285980
3425,3425,3425,3425,3425,3425,3425,3425,3426,2021-11-06 15:00:00+00:00,Harford,21.0,147289,42.0,138754,2.0,13794,23.0,44.0,152548,161083,286043
3426,3426,3426,3426,3426,3426,3426,3426,3427,2020-12-14 15:00:00+00:00,Howard,2.0,2,,0,,0,,,0,2,2
3427,3427,3427,3427,3427,3427,3427,3427,3428,2020-12-15 15:00:00+00:00,Howard,3.0,5,,0,,0,,,0,5,5
3428,3428,3428,3428,3428,3428,3428,3428,3429,2020-12-16 15:00:00+00:00,Howard,55.0,60,1.0,1,,0,,,1,60,61
3429,3429,3429,3429,3429,3429,3429,3429,3430,2020-12-17 15:00:00+00:00,Howard,111.0,171,,1,,0,,,1,171,172
3430,3430,3430,3430,3430,3430,3430,3430,3431,2020-12-18 15:00:00+00:00,Howard,241.0,412,,1,,0,,,1,412,413
3431,3431,3431,3431,3431,3431,3431,3431,3432,2020-12-19 15:00:00+00:00,Howard,94.0,506,2.0,3,,0,,,3,506,509
3432,3432,3432,3432,3432,3432,3432,3432,3433,2020-12-20 15:00:00+00:00,Howard,20.0,526,,3,,0,,,3,526,529
3433,3433,3433,3433,3433,3433,3433,3433,3434,2020-12-21 15:00:00+00:00,Howard,336.0,862,5.0,8,,0,,,8,862,870
3434,3434,3434,3434,3434,3434,3434,3434,3435,2020-12-22 15:00:00+00:00,Howard,448.0,1310,3.0,11,,0,,,11,1310,1321
3435,3435,3435,3435,3435,3435,3435,3435,3436,2020-12-23 15:00:00+00:00,Howard,364.0,1674,3.0,14,,0,,,14,1674,1688
3436,3436,3436,3436,3436,3436,3436,3436,3437,2020-12-24 15:00:00+00:00,Howard,212.0,1886,1.0,15,,0,,,15,1886,1901
3437,3437,3437,3437,3437,3437,3437,3437,3438,2020-12-25 15:00:00+00:00,Howard,45.0,1931,,15,,0,,,15,1931,1946
3438,3438,3438,3438,3438,3438,3438,3438,3439,2020-12-26 15:00:00+00:00,Howard,201.0,2132,,15,,0,,,15,2132,2147
3439,3439,3439,3439,3439,3439,3439,3439,3440,2020-12-27 15:00:00+00:00,Howard,91.0,2223,1.0,16,,0,,,16,2223,2239
3440,3440,3440,3440,3440,3440,3440,3440,3441,2020-12-28 15:00:00+00:00,Howard,720.0,2943,7.0,23,,0,,,23,2943,2966
3441,3441,3441,3441,3441,3441,3441,3441,3442,2020-12-29 15:00:00+00:00,Howard,645.0,3588,5.0,28,,0,,,28,3588,3616
3442,3442,3442,3442,3442,3442,3442,3442,3443,2020-12-30 15:00:00+00:00,Howard,741.0,4329,9.0,37,,0,,,37,4329,4366
3443,3443,3443,3443,3443,3443,3443,3443,3444,2020-12-31 15:00:00+00:00,Howard,518.0,4847,1.0,38,,0,,,38,4847,4885
3444,3444,3444,3444,3444,3444,3444,3444,3445,2021-01-01 15:00:00+00:00,Howard,150.0,4997,10.0,48,,0,,,48,4997,5045
3445,3445,3445,3445,3445,3445,3445,3445,3446,2021-01-02 15:00:00+00:00,Howard,196.0,5193,2.0,50,,0,,,50,5193,5243
3446,3446,3446,3446,3446,3446,3446,3446,3447,2021-01-03 15:00:00+00:00,Howard,147.0,5340,3.0,53,,0,,,53,5340,5393
3447,3447,3447,3447,3447,3447,3447,3447,3448,2021-01-04 15:00:00+00:00,Howard,932.0,6272,47.0,100,,0,,,100,6272,6372
3448,3448,3448,3448,3448,3448,3448,3448,3449,2021-01-05 15:00:00+00:00,Howard,856.0,7128,52.0,152,,0,,,152,7128,7280
3449,3449,3449,3449,3449,3449,3449,3449,3450,2021-01-06 15:00:00+00:00,Howard,830.0,7958,98.0,250,,0,,,250,7958,8208
3450,3450,3450,3450,3450,3450,3450,3450,3451,2021-01-07 15:00:00+00:00,Howard,1072.0,9030,175.0,425,,0,,,425,9030,9455
3451,3451,3451,3451,3451,3451,3451,3451,3452,2021-01-08 15:00:00+00:00,Howard,1033.0,10063,218.0,643,,0,,,643,10063,10706
3452,3452,3452,3452,3452,3452,3452,3452,3453,2021-01-09 15:00:00+00:00,Howard,391.0,10454,110.0,753,,0,,,753,10454,11207
3453,3453,3453,3453,3453,3453,3453,3453,3454,2021-01-10 15:00:00+00:00,Howard,136.0,10590,36.0,789,,0,,,789,10590,11379
3454,3454,3454,3454,3454,3454,3454,3454,3455,2021-01-11 15:00:00+00:00,Howard,503.0,11093,272.0,1061,,0,,,1061,11093,12154
3455,3455,3455,3455,3455,3455,3455,3455,3456,2021-01-12 15:00:00+00:00,Howard,632.0,11725,412.0,1473,,0,,,1473,11725,13198
3456,3456,3456,3456,3456,3456,3456,3456,3457,2021-01-13 15:00:00+00:00,Howard,1046.0,12771,244.0,1717,,0,,,1717,12771,14488
3457,3457,3457,3457,3457,3457,3457,3457,3458,2021-01-14 15:00:00+00:00,Howard,1075.0,13846,114.0,1831,,0,,,1831,13846,15677
3458,3458,3458,3458,3458,3458,3458,3458,3459,2021-01-15 15:00:00+00:00,Howard,1030.0,14876,181.0,2012,,0,,,2012,14876,16888
3459,3459,3459,3459,3459,3459,3459,3459,3460,2021-01-16 15:00:00+00:00,Howard,480.0,15356,166.0,2178,,0,,,2178,15356,17534
3460,3460,3460,3460,3460,3460,3460,3460,3461,2021-01-17 15:00:00+00:00,Howard,79.0,15435,44.0,2222,,0,,,2222,15435,17657
3461,3461,3461,3461,3461,3461,3461,3461,3462,2021-01-18 15:00:00+00:00,Howard,636.0,16071,255.0,2477,,0,,,2477,16071,18548
3462,3462,3462,3462,3462,3462,3462,3462,3463,2021-01-19 15:00:00+00:00,Howard,908.0,16979,289.0,2766,,0,,,2766,16979,19745
3463,3463,3463,3463,3463,3463,3463,3463,3464,2021-01-20 15:00:00+00:00,Howard,615.0,17594,312.0,3078,,0,,,3078,17594,20672
3464,3464,3464,3464,3464,3464,3464,3464,3465,2021-01-21 15:00:00+00:00,Howard,1304.0,18898,277.0,3355,,0,,,3355,18898,22253
3465,3465,3465,3465,3465,3465,3465,3465,3466,2021-01-22 15:00:00+00:00,Howard,1642.0,20540,233.0,3588,,0,,,3588,20540,24128
3466,3466,3466,3466,3466,3466,3466,3466,3467,2021-01-23 15:00:00+00:00,Howard,448.0,20988,82.0,3670,,0,,,3670,20988,24658
3467,3467,3467,3467,3467,3467,3467,3467,3468,2021-01-24 15:00:00+00:00,Howard,80.0,21068,45.0,3715,,0,,,3715,21068,24783
3468,3468,3468,3468,3468,3468,3468,3468,3469,2021-01-25 15:00:00+00:00,Howard,1146.0,22214,451.0,4166,,0,,,4166,22214,26380
3469,3469,3469,3469,3469,3469,3469,3469,3470,2021-01-26 15:00:00+00:00,Howard,725.0,22939,405.0,4571,,0,,,4571,22939,27510
3470,3470,3470,3470,3470,3470,3470,3470,3471,2021-01-27 15:00:00+00:00,Howard,1463.0,24402,575.0,5146,,0,,,5146,24402,29548
3471,3471,3471,3471,3471,3471,3471,3471,3472,2021-01-28 15:00:00+00:00,Howard,1656.0,26058,665.0,5811,,0,,,5811,26058,31869
3472,3472,3472,3472,3472,3472,3472,3472,3473,2021-01-29 15:00:00+00:00,Howard,2078.0,28136,468.0,6279,,0,,,6279,28136,34415
3473,3473,3473,3473,3473,3473,3473,3473,3474,2021-01-30 15:00:00+00:00,Howard,2936.0,31072,189.0,6468,,0,,,6468,31072,37540
3474,3474,3474,3474,3474,3474,3474,3474,3475,2021-01-31 15:00:00+00:00,Howard,147.0,31219,51.0,6519,,0,,,6519,31219,37738
3475,3475,3475,3475,3475,3475,3475,3475,3476,2021-02-01 15:00:00+00:00,Howard,254.0,31473,258.0,6777,,0,,,6777,31473,38250
3476,3476,3476,3476,3476,3476,3476,3476,3477,2021-02-02 15:00:00+00:00,Howard,515.0,31988,626.0,7403,,0,,,7403,31988,39391
3477,3477,3477,3477,3477,3477,3477,3477,3478,2021-02-03 15:00:00+00:00,Howard,1004.0,32992,1641.0,9044,,0,,,9044,32992,42036
3478,3478,3478,3478,3478,3478,3478,3478,3479,2021-02-04 15:00:00+00:00,Howard,1357.0,34349,997.0,10041,,0,,,10041,34349,44390
3479,3479,3479,3479,3479,3479,3479,3479,3480,2021-02-05 15:00:00+00:00,Howard,1443.0,35792,961.0,11002,,0,,,11002,35792,46794
3480,3480,3480,3480,3480,3480,3480,3480,3481,2021-02-06 15:00:00+00:00,Howard,787.0,36579,446.0,11448,,0,,,11448,36579,48027
3481,3481,3481,3481,3481,3481,3481,3481,3482,2021-02-07 15:00:00+00:00,Howard,622.0,37201,68.0,11516,,0,,,11516,37201,48717
3482,3482,3482,3482,3482,3482,3482,3482,3483,2021-02-08 15:00:00+00:00,Howard,672.0,37873,545.0,12061,,0,,,12061,37873,49934
3483,3483,3483,3483,3483,3483,3483,3483,3484,2021-02-09 15:00:00+00:00,Howard,1143.0,39016,450.0,12511,,0,,,12511,39016,51527
3484,3484,3484,3484,3484,3484,3484,3484,3485,2021-02-10 15:00:00+00:00,Howard,1601.0,40617,999.0,13510,,0,,,13510,40617,54127
3485,3485,3485,3485,3485,3485,3485,3485,3486,2021-02-11 15:00:00+00:00,Howard,1487.0,42104,733.0,14243,,0,,,14243,42104,56347
3486,3486,3486,3486,3486,3486,3486,3486,3487,2021-02-12 15:00:00+00:00,Howard,1904.0,44008,1014.0,15257,,0,,,15257,44008,59265
3487,3487,3487,3487,3487,3487,3487,3487,3488,2021-02-13 15:00:00+00:00,Howard,850.0,44858,524.0,15781,,0,,,15781,44858,60639
3488,3488,3488,3488,3488,3488,3488,3488,3489,2021-02-14 15:00:00+00:00,Howard,586.0,45444,81.0,15862,,0,,,15862,45444,61306
3489,3489,3489,3489,3489,3489,3489,3489,3490,2021-02-15 15:00:00+00:00,Howard,946.0,46390,1037.0,16899,,0,,,16899,46390,63289
3490,3490,3490,3490,3490,3490,3490,3490,3491,2021-02-16 15:00:00+00:00,Howard,1073.0,47463,1137.0,18036,,0,,,18036,47463,65499
3491,3491,3491,3491,3491,3491,3491,3491,3492,2021-02-17 15:00:00+00:00,Howard,1982.0,49445,890.0,18926,,0,,,18926,49445,68371
3492,3492,3492,3492,3492,3492,3492,3492,3493,2021-02-18 15:00:00+00:00,Howard,193.0,49638,129.0,19055,,0,,,19055,49638,68693
3493,3493,3493,3493,3493,3493,3493,3493,3494,2021-02-19 15:00:00+00:00,Howard,616.0,50254,729.0,19784,,0,,,19784,50254,70038
3494,3494,3494,3494,3494,3494,3494,3494,3495,2021-02-20 15:00:00+00:00,Howard,651.0,50905,3006.0,22790,,0,,,22790,50905,73695
3495,3495,3495,3495,3495,3495,3495,3495,3496,2021-02-21 15:00:00+00:00,Howard,443.0,51348,351.0,23141,,0,,,23141,51348,74489
3496,3496,3496,3496,3496,3496,3496,3496,3497,2021-02-22 15:00:00+00:00,Howard,525.0,51873,518.0,23659,,0,,,23659,51873,75532
3497,3497,3497,3497,3497,3497,3497,3497,3498,2021-02-23 15:00:00+00:00,Howard,1083.0,52956,654.0,24313,,0,,,24313,52956,77269
3498,3498,3498,3498,3498,3498,3498,3498,3499,2021-02-24 15:00:00+00:00,Howard,902.0,53858,2011.0,26324,,0,,,26324,53858,80182
3499,3499,3499,3499,3499,3499,3499,3499,3500,2021-02-25 15:00:00+00:00,Howard,1309.0,55167,2114.0,28438,,0,,,28438,55167,83605
3500,3500,3500,3500,3500,3500,3500,3500,3501,2021-02-26 15:00:00+00:00,Howard,1417.0,56584,2500.0,30938,,0,,,30938,56584,87522
3501,3501,3501,3501,3501,3501,3501,3501,3502,2021-02-27 15:00:00+00:00,Howard,1047.0,57631,748.0,31686,,0,,,31686,57631,89317
3502,3502,3502,3502,3502,3502,3502,3502,3503,2021-02-28 15:00:00+00:00,Howard,1041.0,58672,370.0,32056,,0,,,32056,58672,90728
3503,3503,3503,3503,3503,3503,3503,3503,3504,2021-03-01 15:00:00+00:00,Howard,1895.0,60567,1474.0,33530,,0,,,33530,60567,94097
3504,3504,3504,3504,3504,3504,3504,3504,3505,2021-03-02 15:00:00+00:00,Howard,2635.0,63202,724.0,34254,4.0,4,2639.0,728.0,34258,63206,97456
3505,3505,3505,3505,3505,3505,3505,3505,3506,2021-03-03 15:00:00+00:00,Howard,1950.0,65152,1611.0,35865,8.0,12,1958.0,1619.0,35877,65164,101017
3506,3506,3506,3506,3506,3506,3506,3506,3507,2021-03-04 15:00:00+00:00,Howard,1621.0,66773,834.0,36699,348.0,360,1969.0,1182.0,37059,67133,103472
3507,3507,3507,3507,3507,3507,3507,3507,3508,2021-03-05 15:00:00+00:00,Howard,1830.0,68603,1488.0,38187,342.0,702,2172.0,1830.0,38889,69305,106790
3508,3508,3508,3508,3508,3508,3508,3508,3509,2021-03-06 15:00:00+00:00,Howard,1212.0,69815,589.0,38776,470.0,1172,1682.0,1059.0,39948,70987,108591
3509,3509,3509,3509,3509,3509,3509,3509,3510,2021-03-07 15:00:00+00:00,Howard,1068.0,70883,326.0,39102,601.0,1773,1669.0,927.0,40875,72656,109985
3510,3510,3510,3510,3510,3510,3510,3510,3511,2021-03-08 15:00:00+00:00,Howard,1492.0,72375,551.0,39653,791.0,2564,2283.0,1342.0,42217,74939,112028
3511,3511,3511,3511,3511,3511,3511,3511,3512,2021-03-09 15:00:00+00:00,Howard,1561.0,73936,832.0,40485,731.0,3295,2292.0,1563.0,43780,77231,114421
3512,3512,3512,3512,3512,3512,3512,3512,3513,2021-05-24 15:00:00+00:00,Caroline,26.0,11562,14.0,10113,6.0,2619,32.0,20.0,12732,14181,21675
3513,3513,3513,3513,3513,3513,3513,3513,3514,2021-05-25 15:00:00+00:00,Caroline,29.0,11591,29.0,10142,7.0,2626,36.0,36.0,12768,14217,21733
3514,3514,3514,3514,3514,3514,3514,3514,3515,2021-05-26 15:00:00+00:00,Caroline,91.0,11682,95.0,10237,4.0,2630,95.0,99.0,12867,14312,21919
3515,3515,3515,3515,3515,3515,3515,3515,3516,2021-05-27 15:00:00+00:00,Caroline,26.0,11708,24.0,10261,8.0,2638,34.0,32.0,12899,14346,21969
3516,3516,3516,3516,3516,3516,3516,3516,3517,2021-05-28 15:00:00+00:00,Caroline,31.0,11739,30.0,10291,14.0,2652,45.0,44.0,12943,14391,22030
3517,3517,3517,3517,3517,3517,3517,3517,3518,2021-05-29 15:00:00+00:00,Caroline,12.0,11751,8.0,10299,3.0,2655,15.0,11.0,12954,14406,22050
3518,3518,3518,3518,3518,3518,3518,3518,3519,2021-05-30 15:00:00+00:00,Caroline,14.0,11765,8.0,10307,2.0,2657,16.0,10.0,12964,14422,22072
3519,3519,3519,3519,3519,3519,3519,3519,3520,2021-05-31 15:00:00+00:00,Caroline,2.0,11767,2.0,10309,,2657,,,12966,14424,22076
3520,3520,3520,3520,3520,3520,3520,3520,3521,2021-06-01 15:00:00+00:00,Caroline,17.0,11784,30.0,10339,7.0,2664,24.0,37.0,13003,14448,22123
3521,3521,3521,3521,3521,3521,3521,3521,3522,2021-06-02 15:00:00+00:00,Caroline,24.0,11808,67.0,10406,10.0,2674,34.0,77.0,13080,14482,22214
3522,3522,3522,3522,3522,3522,3522,3522,3523,2021-06-03 15:00:00+00:00,Caroline,40.0,11848,64.0,10470,2.0,2676,42.0,66.0,13146,14524,22318
3523,3523,3523,3523,3523,3523,3523,3523,3524,2021-06-04 15:00:00+00:00,Caroline,14.0,11862,26.0,10496,24.0,2700,38.0,50.0,13196,14562,22358
3524,3524,3524,3524,3524,3524,3524,3524,3525,2021-06-05 15:00:00+00:00,Caroline,8.0,11870,17.0,10513,5.0,2705,13.0,22.0,13218,14575,22383
3525,3525,3525,3525,3525,3525,3525,3525,3526,2021-06-06 15:00:00+00:00,Caroline,11.0,11881,10.0,10523,1.0,2706,12.0,11.0,13229,14587,22404
3526,3526,3526,3526,3526,3526,3526,3526,3527,2021-06-07 15:00:00+00:00,Caroline,17.0,11898,13.0,10536,1.0,2707,18.0,14.0,13243,14605,22434
3527,3527,3527,3527,3527,3527,3527,3527,3528,2021-06-08 15:00:00+00:00,Caroline,14.0,11912,73.0,10609,3.0,2710,17.0,76.0,13319,14622,22521
3528,3528,3528,3528,3528,3528,3528,3528,3529,2021-06-09 15:00:00+00:00,Caroline,24.0,11936,62.0,10671,3.0,2713,27.0,65.0,13384,14649,22607
3529,3529,3529,3529,3529,3529,3529,3529,3530,2021-06-10 15:00:00+00:00,Caroline,41.0,11977,77.0,10748,5.0,2718,46.0,82.0,13466,14695,22725
3530,3530,3530,3530,3530,3530,3530,3530,3531,2021-06-11 15:00:00+00:00,Caroline,21.0,11998,37.0,10785,15.0,2733,36.0,52.0,13518,14731,22783
3531,3531,3531,3531,3531,3531,3531,3531,3532,2021-06-12 15:00:00+00:00,Caroline,14.0,12012,26.0,10811,2.0,2735,16.0,28.0,13546,14747,22823
3532,3532,3532,3532,3532,3532,3532,3532,3533,2021-06-13 15:00:00+00:00,Caroline,5.0,12017,17.0,10828,,2735,,,13563,14752,22845
3533,3533,3533,3533,3533,3533,3533,3533,3534,2021-06-14 15:00:00+00:00,Caroline,13.0,12030,30.0,10858,6.0,2741,19.0,36.0,13599,14771,22888
3534,3534,3534,3534,3534,3534,3534,3534,3535,2021-06-15 15:00:00+00:00,Caroline,29.0,12059,47.0,10905,3.0,2744,32.0,50.0,13649,14803,22964
3535,3535,3535,3535,3535,3535,3535,3535,3536,2021-06-16 15:00:00+00:00,Caroline,36.0,12095,90.0,10995,12.0,2756,48.0,102.0,13751,14851,23090
3536,3536,3536,3536,3536,3536,3536,3536,3537,2021-06-17 15:00:00+00:00,Caroline,19.0,12114,51.0,11046,11.0,2767,30.0,62.0,13813,14881,23160
3537,3537,3537,3537,3537,3537,3537,3537,3538,2021-06-18 15:00:00+00:00,Caroline,26.0,12140,31.0,11077,16.0,2783,42.0,47.0,13860,14923,23217
3538,3538,3538,3538,3538,3538,3538,3538,3539,2021-06-19 15:00:00+00:00,Caroline,11.0,12151,43.0,11120,,2783,,,13903,14934,23271
3539,3539,3539,3539,3539,3539,3539,3539,3540,2021-06-20 15:00:00+00:00,Caroline,3.0,12154,13.0,11133,,2783,,,13916,14937,23287
3540,3540,3540,3540,3540,3540,3540,3540,3541,2021-06-21 15:00:00+00:00,Caroline,6.0,12160,18.0,11151,1.0,2784,7.0,19.0,13935,14944,23311
3541,3541,3541,3541,3541,3541,3541,3541,3542,2021-06-22 15:00:00+00:00,Caroline,8.0,12168,17.0,11168,3.0,2787,11.0,20.0,13955,14955,23336
3542,3542,3542,3542,3542,3542,3542,3542,3543,2021-06-23 15:00:00+00:00,Caroline,36.0,12204,33.0,11201,1.0,2788,37.0,34.0,13989,14992,23405
3543,3543,3543,3543,3543,3543,3543,3543,3544,2021-06-24 15:00:00+00:00,Caroline,23.0,12227,49.0,11250,7.0,2795,30.0,56.0,14045,15022,23477
3544,3544,3544,3544,3544,3544,3544,3544,3545,2021-06-25 15:00:00+00:00,Caroline,14.0,12241,26.0,11276,7.0,2802,21.0,33.0,14078,15043,23517
3545,3545,3545,3545,3545,3545,3545,3545,3546,2021-06-26 15:00:00+00:00,Caroline,2.0,12243,15.0,11291,,2802,,,14093,15045,23534
3546,3546,3546,3546,3546,3546,3546,3546,3547,2021-06-27 15:00:00+00:00,Caroline,7.0,12250,15.0,11306,,2802,,,14108,15052,23556
3547,3547,3547,3547,3547,3547,3547,3547,3548,2021-06-28 15:00:00+00:00,Caroline,17.0,12267,12.0,11318,6.0,2808,23.0,18.0,14126,15075,23585
3548,3548,3548,3548,3548,3548,3548,3548,3549,2021-06-29 15:00:00+00:00,Caroline,19.0,12286,6.0,11324,4.0,2812,23.0,10.0,14136,15098,23610
3549,3549,3549,3549,3549,3549,3549,3549,3550,2021-06-30 15:00:00+00:00,Caroline,19.0,12305,11.0,11335,27.0,2839,46.0,38.0,14174,15144,23640
3550,3550,3550,3550,3550,3550,3550,3550,3551,2021-07-01 15:00:00+00:00,Caroline,22.0,12327,36.0,11371,11.0,2850,33.0,47.0,14221,15177,23698
3551,3551,3551,3551,3551,3551,3551,3551,3552,2021-07-02 15:00:00+00:00,Caroline,22.0,12349,13.0,11384,6.0,2856,28.0,19.0,14240,15205,23733
3552,3552,3552,3552,3552,3552,3552,3552,3553,2021-07-03 15:00:00+00:00,Caroline,5.0,12354,11.0,11395,3.0,2859,8.0,14.0,14254,15213,23749
3553,3553,3553,3553,3553,3553,3553,3553,3554,2021-07-04 15:00:00+00:00,Caroline,1.0,12355,1.0,11396,,2859,,,14255,15214,23751
3554,3554,3554,3554,3554,3554,3554,3554,3555,2021-07-05 15:00:00+00:00,Caroline,12.0,12367,10.0,11406,,2859,,,14265,15226,23773
3555,3555,3555,3555,3555,3555,3555,3555,3556,2021-07-06 15:00:00+00:00,Caroline,11.0,12378,16.0,11422,,2859,,,14281,15237,23800
3556,3556,3556,3556,3556,3556,3556,3556,3557,2021-07-07 15:00:00+00:00,Caroline,36.0,12414,43.0,11465,2.0,2861,38.0,45.0,14326,15275,23879
3557,3557,3557,3557,3557,3557,3557,3557,3558,2021-07-08 15:00:00+00:00,Caroline,13.0,12427,25.0,11490,7.0,2868,20.0,32.0,14358,15295,23917
3558,3558,3558,3558,3558,3558,3558,3558,3559,2021-07-09 15:00:00+00:00,Caroline,29.0,12456,36.0,11526,2.0,2870,31.0,38.0,14396,15326,23982
3559,3559,3559,3559,3559,3559,3559,3559,3560,2021-07-10 15:00:00+00:00,Caroline,8.0,12464,10.0,11536,11.0,2881,19.0,21.0,14417,15345,24000
3560,3560,3560,3560,3560,3560,3560,3560,3561,2021-07-11 15:00:00+00:00,Caroline,3.0,12467,2.0,11538,,2881,,,14419,15348,24005
3561,3561,3561,3561,3561,3561,3561,3561,3562,2021-07-12 15:00:00+00:00,Caroline,14.0,12481,11.0,11549,,2881,,,14430,15362,24030
3562,3562,3562,3562,3562,3562,3562,3562,3563,2021-07-13 15:00:00+00:00,Caroline,9.0,12490,8.0,11557,,2881,,,14438,15371,24047
3563,3563,3563,3563,3563,3563,3563,3563,3564,2021-07-14 15:00:00+00:00,Caroline,33.0,12523,17.0,11574,11.0,2892,44.0,28.0,14466,15415,24097
3564,3564,3564,3564,3564,3564,3564,3564,3565,2021-07-15 15:00:00+00:00,Caroline,19.0,12542,13.0,11587,3.0,2895,22.0,16.0,14482,15437,24129
3565,3565,3565,3565,3565,3565,3565,3565,3566,2021-07-16 15:00:00+00:00,Caroline,28.0,12570,15.0,11602,11.0,2906,39.0,26.0,14508,15476,24172
3566,3566,3566,3566,3566,3566,3566,3566,3567,2021-07-17 15:00:00+00:00,Caroline,11.0,12581,5.0,11607,,2906,,,14513,15487,24188
3567,3567,3567,3567,3567,3567,3567,3567,3568,2021-07-18 15:00:00+00:00,Caroline,8.0,12589,1.0,11608,,2906,,,14514,15495,24197
3568,3568,3568,3568,3568,3568,3568,3568,3569,2021-07-19 15:00:00+00:00,Caroline,16.0,12605,16.0,11624,2.0,2908,18.0,18.0,14532,15513,24229
3569,3569,3569,3569,3569,3569,3569,3569,3570,2021-07-20 15:00:00+00:00,Caroline,28.0,12633,18.0,11642,1.0,2909,29.0,19.0,14551,15542,24275
3570,3570,3570,3570,3570,3570,3570,3570,3571,2021-07-21 15:00:00+00:00,Caroline,57.0,12690,38.0,11680,12.0,2921,69.0,50.0,14601,15611,24370
3571,3571,3571,3571,3571,3571,3571,3571,3572,2021-07-22 15:00:00+00:00,Caroline,41.0,12731,9.0,11689,1.0,2922,42.0,10.0,14611,15653,24420
3572,3572,3572,3572,3572,3572,3572,3572,3573,2021-07-23 15:00:00+00:00,Caroline,29.0,12760,27.0,11716,1.0,2923,30.0,28.0,14639,15683,24476
3573,3573,3573,3573,3573,3573,3573,3573,3574,2021-07-24 15:00:00+00:00,Caroline,12.0,12772,3.0,11719,,2923,,,14642,15695,24491
3574,3574,3574,3574,3574,3574,3574,3574,3575,2021-07-25 15:00:00+00:00,Caroline,8.0,12780,2.0,11721,,2923,,,14644,15703,24501
3575,3575,3575,3575,3575,3575,3575,3575,3576,2021-07-26 15:00:00+00:00,Caroline,17.0,12797,7.0,11728,1.0,2924,18.0,8.0,14652,15721,24525
3576,3576,3576,3576,3576,3576,3576,3576,3577,2021-07-27 15:00:00+00:00,Caroline,19.0,12816,7.0,11735,2.0,2926,21.0,9.0,14661,15742,24551
3577,3577,3577,3577,3577,3577,3577,3577,3578,2021-07-28 15:00:00+00:00,Caroline,34.0,12850,25.0,11760,8.0,2934,42.0,33.0,14694,15784,24610
3578,3578,3578,3578,3578,3578,3578,3578,3579,2021-07-29 15:00:00+00:00,Caroline,45.0,12895,10.0,11770,4.0,2938,49.0,14.0,14708,15833,24665
3579,3579,3579,3579,3579,3579,3579,3579,3580,2021-07-30 15:00:00+00:00,Caroline,52.0,12947,22.0,11792,1.0,2939,53.0,23.0,14731,15886,24739
3580,3580,3580,3580,3580,3580,3580,3580,3581,2021-07-31 15:00:00+00:00,Caroline,10.0,12957,8.0,11800,1.0,2940,11.0,9.0,14740,15897,24757
3581,3581,3581,3581,3581,3581,3581,3581,3582,2021-08-01 15:00:00+00:00,Caroline,12.0,12969,2.0,11802,,2940,,,14742,15909,24771
3582,3582,3582,3582,3582,3582,3582,3582,3583,2021-08-02 15:00:00+00:00,Caroline,21.0,12990,9.0,11811,,2940,,,14751,15930,24801
3583,3583,3583,3583,3583,3583,3583,3583,3584,2021-08-03 15:00:00+00:00,Caroline,29.0,13019,9.0,11820,2.0,2942,31.0,11.0,14762,15961,24839
3584,3584,3584,3584,3584,3584,3584,3584,3585,2021-08-04 15:00:00+00:00,Caroline,48.0,13067,36.0,11856,12.0,2954,60.0,48.0,14810,16021,24923
3585,3585,3585,3585,3585,3585,3585,3585,3586,2021-08-05 15:00:00+00:00,Caroline,44.0,13111,24.0,11880,7.0,2961,51.0,31.0,14841,16072,24991
3586,3586,3586,3586,3586,3586,3586,3586,3587,2021-08-06 15:00:00+00:00,Caroline,57.0,13168,32.0,11912,11.0,2972,68.0,43.0,14884,16140,25080
3587,3587,3587,3587,3587,3587,3587,3587,3588,2021-08-07 15:00:00+00:00,Caroline,19.0,13187,4.0,11916,,2972,,,14888,16159,25103
3588,3588,3588,3588,3588,3588,3588,3588,3589,2021-08-08 15:00:00+00:00,Caroline,16.0,13203,10.0,11926,,2972,,,14898,16175,25129
3589,3589,3589,3589,3589,3589,3589,3589,3590,2021-08-09 15:00:00+00:00,Caroline,23.0,13226,25.0,11951,3.0,2975,26.0,28.0,14926,16201,25177
3590,3590,3590,3590,3590,3590,3590,3590,3591,2021-08-10 15:00:00+00:00,Caroline,46.0,13272,18.0,11969,3.0,2978,49.0,21.0,14947,16250,25241
3591,3591,3591,3591,3591,3591,3591,3591,3592,2021-08-11 15:00:00+00:00,Caroline,37.0,13309,51.0,12020,8.0,2986,45.0,59.0,15006,16295,25329
3592,3592,3592,3592,3592,3592,3592,3592,3593,2021-08-12 15:00:00+00:00,Caroline,34.0,13343,21.0,12041,13.0,2999,47.0,34.0,15040,16342,25384
3593,3593,3593,3593,3593,3593,3593,3593,3594,2021-08-13 15:00:00+00:00,Caroline,34.0,13377,38.0,12079,3.0,3002,37.0,41.0,15081,16379,25456
3594,3594,3594,3594,3594,3594,3594,3594,3595,2021-08-14 15:00:00+00:00,Caroline,12.0,13389,10.0,12089,1.0,3003,13.0,11.0,15092,16392,25478
3595,3595,3595,3595,3595,3595,3595,3595,3596,2021-08-15 15:00:00+00:00,Caroline,11.0,13400,13.0,12102,,3003,,,15105,16403,25502
3596,3596,3596,3596,3596,3596,3596,3596,3597,2021-01-28 15:00:00+00:00,Frederick,906.0,20768,430.0,4137,,0,,,4137,20768,24905
3597,3597,3597,3597,3597,3597,3597,3597,3598,2021-01-29 15:00:00+00:00,Frederick,1368.0,22136,124.0,4261,,0,,,4261,22136,26397
3598,3598,3598,3598,3598,3598,3598,3598,3599,2021-01-30 15:00:00+00:00,Frederick,1042.0,23178,201.0,4462,,0,,,4462,23178,27640
3599,3599,3599,3599,3599,3599,3599,3599,3600,2021-01-31 15:00:00+00:00,Frederick,37.0,23215,8.0,4470,,0,,,4470,23215,27685
3600,3600,3600,3600,3600,3600,3600,3600,3601,2021-02-01 15:00:00+00:00,Frederick,158.0,23373,130.0,4600,,0,,,4600,23373,27973
3601,3601,3601,3601,3601,3601,3601,3601,3602,2021-02-02 15:00:00+00:00,Frederick,650.0,24023,665.0,5265,,0,,,5265,24023,29288
3602,3602,3602,3602,3602,3602,3602,3602,3603,2021-02-03 15:00:00+00:00,Frederick,1806.0,25829,471.0,5736,,0,,,5736,25829,31565
3603,3603,3603,3603,3603,3603,3603,3603,3604,2021-02-04 15:00:00+00:00,Frederick,1039.0,26868,610.0,6346,,0,,,6346,26868,33214
3604,3604,3604,3604,3604,3604,3604,3604,3605,2021-02-05 15:00:00+00:00,Frederick,590.0,27458,447.0,6793,,0,,,6793,27458,34251
3605,3605,3605,3605,3605,3605,3605,3605,3606,2021-02-06 15:00:00+00:00,Frederick,162.0,27620,175.0,6968,,0,,,6968,27620,34588
3606,3606,3606,3606,3606,3606,3606,3606,3607,2021-02-07 15:00:00+00:00,Frederick,88.0,27708,65.0,7033,,0,,,7033,27708,34741
3607,3607,3607,3607,3607,3607,3607,3607,3608,2021-02-08 15:00:00+00:00,Frederick,210.0,27918,518.0,7551,,0,,,7551,27918,35469
3608,3608,3608,3608,3608,3608,3608,3608,3609,2021-02-09 15:00:00+00:00,Frederick,653.0,28571,627.0,8178,,0,,,8178,28571,36749
3609,3609,3609,3609,3609,3609,3609,3609,3610,2021-02-10 15:00:00+00:00,Frederick,554.0,29125,1097.0,9275,,0,,,9275,29125,38400
3610,3610,3610,3610,3610,3610,3610,3610,3611,2021-02-11 15:00:00+00:00,Frederick,569.0,29694,1217.0,10492,,0,,,10492,29694,40186
3611,3611,3611,3611,3611,3611,3611,3611,3612,2021-02-12 15:00:00+00:00,Frederick,798.0,30492,1538.0,12030,,0,,,12030,30492,42522
3612,3612,3612,3612,3612,3612,3612,3612,3613,2021-02-13 15:00:00+00:00,Frederick,633.0,31125,707.0,12737,,0,,,12737,31125,43862
3613,3613,3613,3613,3613,3613,3613,3613,3614,2021-02-14 15:00:00+00:00,Frederick,251.0,31376,31.0,12768,,0,,,12768,31376,44144
3614,3614,3614,3614,3614,3614,3614,3614,3615,2021-02-15 15:00:00+00:00,Frederick,407.0,31783,810.0,13578,,0,,,13578,31783,45361
3615,3615,3615,3615,3615,3615,3615,3615,3616,2021-02-16 15:00:00+00:00,Frederick,593.0,32376,900.0,14478,,0,,,14478,32376,46854
3616,3616,3616,3616,3616,3616,3616,3616,3617,2021-02-17 15:00:00+00:00,Frederick,617.0,32993,1807.0,16285,,0,,,16285,32993,49278
3617,3617,3617,3617,3617,3617,3617,3617,3618,2021-02-18 15:00:00+00:00,Frederick,94.0,33087,193.0,16478,,0,,,16478,33087,49565
3618,3618,3618,3618,3618,3618,3618,3618,3619,2021-02-19 15:00:00+00:00,Frederick,193.0,33280,655.0,17133,,0,,,17133,33280,50413
3619,3619,3619,3619,3619,3619,3619,3619,3620,2021-02-20 15:00:00+00:00,Frederick,199.0,33479,1040.0,18173,,0,,,18173,33479,51652
3620,3620,3620,3620,3620,3620,3620,3620,3621,2021-02-21 15:00:00+00:00,Frederick,135.0,33614,1381.0,19554,,0,,,19554,33614,53168
3621,3621,3621,3621,3621,3621,3621,3621,3622,2021-02-22 15:00:00+00:00,Frederick,308.0,33922,341.0,19895,,0,,,19895,33922,53817
3622,3622,3622,3622,3622,3622,3622,3622,3623,2021-02-23 15:00:00+00:00,Frederick,481.0,34403,681.0,20576,,0,,,20576,34403,54979
3623,3623,3623,3623,3623,3623,3623,3623,3624,2021-02-24 15:00:00+00:00,Frederick,629.0,35032,1976.0,22552,,0,,,22552,35032,57584
3624,3624,3624,3624,3624,3624,3624,3624,3625,2021-08-16 15:00:00+00:00,Caroline,29.0,13429,15.0,12117,5.0,3008,34.0,20.0,15125,16437,25546
3625,3625,3625,3625,3625,3625,3625,3625,3626,2021-08-17 15:00:00+00:00,Caroline,17.0,13446,11.0,12128,9.0,3017,26.0,20.0,15145,16463,25574
3626,3626,3626,3626,3626,3626,3626,3626,3627,2021-08-18 15:00:00+00:00,Caroline,48.0,13494,33.0,12161,5.0,3022,53.0,38.0,15183,16516,25655
3627,3627,3627,3627,3627,3627,3627,3627,3628,2021-08-19 15:00:00+00:00,Caroline,62.0,13556,34.0,12195,6.0,3028,68.0,40.0,15223,16584,25751
3628,3628,3628,3628,3628,3628,3628,3628,3629,2021-08-20 15:00:00+00:00,Caroline,42.0,13598,35.0,12230,3.0,3031,45.0,38.0,15261,16629,25828
3629,3629,3629,3629,3629,3629,3629,3629,3630,2021-08-21 15:00:00+00:00,Caroline,18.0,13616,15.0,12245,3.0,3034,21.0,18.0,15279,16650,25861
3630,3630,3630,3630,3630,3630,3630,3630,3631,2021-08-22 15:00:00+00:00,Caroline,10.0,13626,9.0,12254,,3034,,,15288,16660,25880
3631,3631,3631,3631,3631,3631,3631,3631,3632,2021-08-23 15:00:00+00:00,Caroline,14.0,13640,20.0,12274,2.0,3036,16.0,22.0,15310,16676,25914
3632,3632,3632,3632,3632,3632,3632,3632,3633,2021-08-24 15:00:00+00:00,Caroline,42.0,13682,16.0,12290,5.0,3041,47.0,21.0,15331,16723,25972
3633,3633,3633,3633,3633,3633,3633,3633,3634,2021-08-25 15:00:00+00:00,Caroline,25.0,13707,27.0,12317,4.0,3045,29.0,31.0,15362,16752,26024
3634,3634,3634,3634,3634,3634,3634,3634,3635,2021-08-26 15:00:00+00:00,Caroline,29.0,13736,30.0,12347,17.0,3062,46.0,47.0,15409,16798,26083
3635,3635,3635,3635,3635,3635,3635,3635,3636,2021-08-27 15:00:00+00:00,Caroline,31.0,13767,44.0,12391,3.0,3065,34.0,47.0,15456,16832,26158
3636,3636,3636,3636,3636,3636,3636,3636,3637,2021-08-28 15:00:00+00:00,Caroline,15.0,13782,14.0,12405,,3065,,,15470,16847,26187
3637,3637,3637,3637,3637,3637,3637,3637,3638,2021-08-29 15:00:00+00:00,Caroline,9.0,13791,12.0,12417,,3065,,,15482,16856,26208
3638,3638,3638,3638,3638,3638,3638,3638,3639,2021-08-30 15:00:00+00:00,Caroline,9.0,13800,26.0,12443,4.0,3069,13.0,30.0,15512,16869,26243
3639,3639,3639,3639,3639,3639,3639,3639,3640,2021-08-31 15:00:00+00:00,Caroline,26.0,13826,20.0,12463,,3069,,,15532,16895,26289
3640,3640,3640,3640,3640,3640,3640,3640,3641,2021-09-01 15:00:00+00:00,Caroline,32.0,13858,30.0,12493,8.0,3077,40.0,38.0,15570,16935,26351
3641,3641,3641,3641,3641,3641,3641,3641,3642,2021-09-02 15:00:00+00:00,Caroline,40.0,13898,25.0,12518,1.0,3078,41.0,26.0,15596,16976,26416
3642,3642,3642,3642,3642,3642,3642,3642,3643,2021-09-03 15:00:00+00:00,Caroline,21.0,13919,40.0,12558,4.0,3082,25.0,44.0,15640,17001,26477
3643,3643,3643,3643,3643,3643,3643,3643,3644,2021-09-04 15:00:00+00:00,Caroline,8.0,13927,10.0,12568,,3082,,,15650,17009,26495
3644,3644,3644,3644,3644,3644,3644,3644,3645,2021-09-05 15:00:00+00:00,Caroline,,13927,9.0,12577,,3082,,,15659,17009,26504
3645,3645,3645,3645,3645,3645,3645,3645,3646,2021-09-06 15:00:00+00:00,Caroline,5.0,13932,9.0,12586,,3082,,,15668,17014,26518
3646,3646,3646,3646,3646,3646,3646,3646,3647,2021-09-07 15:00:00+00:00,Caroline,17.0,13949,18.0,12604,,3082,,,15686,17031,26553
3647,3647,3647,3647,3647,3647,3647,3647,3648,2021-09-08 15:00:00+00:00,Caroline,20.0,13969,22.0,12626,2.0,3084,22.0,24.0,15710,17053,26595
3648,3648,3648,3648,3648,3648,3648,3648,3649,2021-09-09 15:00:00+00:00,Caroline,24.0,13993,46.0,12672,5.0,3089,29.0,51.0,15761,17082,26665
3649,3649,3649,3649,3649,3649,3649,3649,3650,2021-09-10 15:00:00+00:00,Caroline,43.0,14036,53.0,12725,5.0,3094,48.0,58.0,15819,17130,26761
3650,3650,3650,3650,3650,3650,3650,3650,3651,2021-09-11 15:00:00+00:00,Caroline,12.0,14048,12.0,12737,,3094,,,15831,17142,26785
3651,3651,3651,3651,3651,3651,3651,3651,3652,2021-09-12 15:00:00+00:00,Caroline,7.0,14055,16.0,12753,,3094,,,15847,17149,26808
3652,3652,3652,3652,3652,3652,3652,3652,3653,2021-09-13 15:00:00+00:00,Caroline,14.0,14069,23.0,12776,,3094,,,15870,17163,26845
3653,3653,3653,3653,3653,3653,3653,3653,3654,2021-09-14 15:00:00+00:00,Caroline,18.0,14087,22.0,12798,2.0,3096,20.0,24.0,15894,17183,26885
3654,3654,3654,3654,3654,3654,3654,3654,3655,2021-09-15 15:00:00+00:00,Caroline,30.0,14117,45.0,12843,12.0,3108,42.0,57.0,15951,17225,26960
3655,3655,3655,3655,3655,3655,3655,3655,3656,2021-09-16 15:00:00+00:00,Caroline,29.0,14146,36.0,12879,9.0,3117,38.0,45.0,15996,17263,27025
3656,3656,3656,3656,3656,3656,3656,3656,3657,2021-09-17 15:00:00+00:00,Caroline,23.0,14169,47.0,12926,3.0,3120,26.0,50.0,16046,17289,27095
3657,3657,3657,3657,3657,3657,3657,3657,3658,2021-09-18 15:00:00+00:00,Caroline,11.0,14180,20.0,12946,1.0,3121,12.0,21.0,16067,17301,27126
3658,3658,3658,3658,3658,3658,3658,3658,3659,2021-09-19 15:00:00+00:00,Caroline,9.0,14189,8.0,12954,,3121,,,16075,17310,27143
3659,3659,3659,3659,3659,3659,3659,3659,3660,2021-09-20 15:00:00+00:00,Caroline,11.0,14200,17.0,12971,,3121,,,16092,17321,27171
3660,3660,3660,3660,3660,3660,3660,3660,3661,2021-09-21 15:00:00+00:00,Caroline,13.0,14213,19.0,12990,,3121,,,16111,17334,27203
3661,3661,3661,3661,3661,3661,3661,3661,3662,2021-09-22 15:00:00+00:00,Caroline,27.0,14240,33.0,13023,12.0,3133,39.0,45.0,16156,17373,27263
3662,3662,3662,3662,3662,3662,3662,3662,3663,2021-09-23 15:00:00+00:00,Caroline,18.0,14258,32.0,13055,4.0,3137,22.0,36.0,16192,17395,27313
3663,3663,3663,3663,3663,3663,3663,3663,3664,2021-09-24 15:00:00+00:00,Caroline,24.0,14282,30.0,13085,5.0,3142,29.0,35.0,16227,17424,27367
3664,3664,3664,3664,3664,3664,3664,3664,3665,2021-09-25 15:00:00+00:00,Caroline,7.0,14289,8.0,13093,1.0,3143,8.0,9.0,16236,17432,27382
3665,3665,3665,3665,3665,3665,3665,3665,3666,2021-09-26 15:00:00+00:00,Caroline,4.0,14293,3.0,13096,,3143,,,16239,17436,27389
3666,3666,3666,3666,3666,3666,3666,3666,3667,2021-09-27 15:00:00+00:00,Caroline,8.0,14301,10.0,13106,2.0,3145,10.0,12.0,16251,17446,27407
3667,3667,3667,3667,3667,3667,3667,3667,3668,2021-09-28 15:00:00+00:00,Caroline,8.0,14309,22.0,13128,1.0,3146,9.0,23.0,16274,17455,27437
3668,3668,3668,3668,3668,3668,3668,3668,3669,2021-09-29 15:00:00+00:00,Caroline,18.0,14327,25.0,13153,3.0,3149,21.0,28.0,16302,17476,27480
3669,3669,3669,3669,3669,3669,3669,3669,3670,2021-09-30 15:00:00+00:00,Caroline,28.0,14355,21.0,13174,3.0,3152,31.0,24.0,16326,17507,27529
3670,3670,3670,3670,3670,3670,3670,3670,3671,2021-10-01 15:00:00+00:00,Caroline,33.0,14388,36.0,13210,2.0,3154,35.0,38.0,16364,17542,27598
3671,3671,3671,3671,3671,3671,3671,3671,3672,2021-10-02 15:00:00+00:00,Caroline,3.0,14391,8.0,13218,,3154,,,16372,17545,27609
3672,3672,3672,3672,3672,3672,3672,3672,3673,2021-10-03 15:00:00+00:00,Caroline,4.0,14395,13.0,13231,,3154,,,16385,17549,27626
3673,3673,3673,3673,3673,3673,3673,3673,3674,2021-10-04 15:00:00+00:00,Caroline,4.0,14399,8.0,13239,,3154,,,16393,17553,27638
3674,3674,3674,3674,3674,3674,3674,3674,3675,2021-10-05 15:00:00+00:00,Caroline,9.0,14408,17.0,13256,1.0,3155,10.0,18.0,16411,17563,27664
3675,3675,3675,3675,3675,3675,3675,3675,3676,2021-10-06 15:00:00+00:00,Caroline,21.0,14429,23.0,13279,4.0,3159,25.0,27.0,16438,17588,27708
3676,3676,3676,3676,3676,3676,3676,3676,3677,2021-10-07 15:00:00+00:00,Caroline,12.0,14441,23.0,13302,1.0,3160,13.0,24.0,16462,17601,27743
3677,3677,3677,3677,3677,3677,3677,3677,3678,2021-10-08 15:00:00+00:00,Caroline,17.0,14458,20.0,13322,6.0,3166,23.0,26.0,16488,17624,27780
3678,3678,3678,3678,3678,3678,3678,3678,3679,2021-10-09 15:00:00+00:00,Caroline,4.0,14462,9.0,13331,,3166,,,16497,17628,27793
3679,3679,3679,3679,3679,3679,3679,3679,3680,2021-10-10 15:00:00+00:00,Caroline,8.0,14470,6.0,13337,,3166,,,16503,17636,27807
3680,3680,3680,3680,3680,3680,3680,3680,3681,2021-10-11 15:00:00+00:00,Caroline,9.0,14479,10.0,13347,1.0,3167,10.0,11.0,16514,17646,27826
3681,3681,3681,3681,3681,3681,3681,3681,3682,2021-10-12 15:00:00+00:00,Caroline,8.0,14487,11.0,13358,2.0,3169,10.0,13.0,16527,17656,27845
3682,3682,3682,3682,3682,3682,3682,3682,3683,2021-10-13 15:00:00+00:00,Caroline,16.0,14503,15.0,13373,5.0,3174,21.0,20.0,16547,17677,27876
3683,3683,3683,3683,3683,3683,3683,3683,3684,2021-10-14 15:00:00+00:00,Caroline,16.0,14519,12.0,13385,1.0,3175,17.0,13.0,16560,17694,27904
3684,3684,3684,3684,3684,3684,3684,3684,3685,2021-10-15 15:00:00+00:00,Caroline,14.0,14533,17.0,13402,1.0,3176,15.0,18.0,16578,17709,27935
3685,3685,3685,3685,3685,3685,3685,3685,3686,2021-10-16 15:00:00+00:00,Caroline,2.0,14535,5.0,13407,,3176,,,16583,17711,27942
3686,3686,3686,3686,3686,3686,3686,3686,3687,2021-10-17 15:00:00+00:00,Caroline,3.0,14538,6.0,13413,,3176,,,16589,17714,27951
3687,3687,3687,3687,3687,3687,3687,3687,3688,2021-10-18 15:00:00+00:00,Caroline,10.0,14548,8.0,13421,,3176,,,16597,17724,27969
3688,3688,3688,3688,3688,3688,3688,3688,3689,2021-10-19 15:00:00+00:00,Caroline,4.0,14552,12.0,13433,,3176,,,16609,17728,27985
3689,3689,3689,3689,3689,3689,3689,3689,3690,2021-10-20 15:00:00+00:00,Caroline,11.0,14563,12.0,13445,2.0,3178,13.0,14.0,16623,17741,28008
3690,3690,3690,3690,3690,3690,3690,3690,3691,2021-10-21 15:00:00+00:00,Caroline,16.0,14579,37.0,13482,5.0,3183,21.0,42.0,16665,17762,28061
3691,3691,3691,3691,3691,3691,3691,3691,3692,2021-10-22 15:00:00+00:00,Caroline,19.0,14598,18.0,13500,2.0,3185,21.0,20.0,16685,17783,28098
3692,3692,3692,3692,3692,3692,3692,3692,3693,2021-10-23 15:00:00+00:00,Caroline,7.0,14605,13.0,13513,,3185,,,16698,17790,28118
3693,3693,3693,3693,3693,3693,3693,3693,3694,2021-10-24 15:00:00+00:00,Caroline,2.0,14607,4.0,13517,,3185,,,16702,17792,28124
3694,3694,3694,3694,3694,3694,3694,3694,3695,2021-10-25 15:00:00+00:00,Caroline,13.0,14620,24.0,13541,,3185,,,16726,17805,28161
3695,3695,3695,3695,3695,3695,3695,3695,3696,2021-10-26 15:00:00+00:00,Caroline,8.0,14628,21.0,13562,1.0,3186,9.0,22.0,16748,17814,28190
3696,3696,3696,3696,3696,3696,3696,3696,3697,2021-10-27 15:00:00+00:00,Caroline,17.0,14645,20.0,13582,2.0,3188,19.0,22.0,16770,17833,28227
3697,3697,3697,3697,3697,3697,3697,3697,3698,2021-10-28 15:00:00+00:00,Caroline,17.0,14662,34.0,13616,6.0,3194,23.0,40.0,16810,17856,28278
3698,3698,3698,3698,3698,3698,3698,3698,3699,2021-10-29 15:00:00+00:00,Caroline,10.0,14672,21.0,13637,,3194,,,16831,17866,28309
3699,3699,3699,3699,3699,3699,3699,3699,3700,2021-10-30 15:00:00+00:00,Caroline,9.0,14681,12.0,13649,1.0,3195,10.0,13.0,16844,17876,28330
3700,3700,3700,3700,3700,3700,3700,3700,3701,2021-10-31 15:00:00+00:00,Caroline,4.0,14685,6.0,13655,,3195,,,16850,17880,28340
3701,3701,3701,3701,3701,3701,3701,3701,3702,2021-11-01 15:00:00+00:00,Caroline,15.0,14700,17.0,13672,,3195,,,16867,17895,28372
3702,3702,3702,3702,3702,3702,3702,3702,3703,2021-11-02 15:00:00+00:00,Caroline,12.0,14712,11.0,13683,3.0,3198,15.0,14.0,16881,17910,28395
3703,3703,3703,3703,3703,3703,3703,3703,3704,2021-11-03 15:00:00+00:00,Caroline,8.0,14720,18.0,13701,,3198,,,16899,17918,28421
3704,3704,3704,3704,3704,3704,3704,3704,3705,2021-11-04 15:00:00+00:00,Caroline,26.0,14746,31.0,13732,8.0,3206,34.0,39.0,16938,17952,28478
3705,3705,3705,3705,3705,3705,3705,3705,3706,2021-11-05 15:00:00+00:00,Caroline,16.0,14762,40.0,13772,2.0,3208,18.0,42.0,16980,17970,28534
3706,3706,3706,3706,3706,3706,3706,3706,3707,2021-11-06 15:00:00+00:00,Caroline,1.0,14763,2.0,13774,,3208,,,16982,17971,28537
3707,3707,3707,3707,3707,3707,3707,3707,3708,2020-12-17 15:00:00+00:00,Kent,5.0,5,,0,,0,,,0,5,5
3708,3708,3708,3708,3708,3708,3708,3708,3709,2020-12-18 15:00:00+00:00,Kent,2.0,7,,0,,0,,,0,7,7
3709,3709,3709,3709,3709,3709,3709,3709,3710,2020-12-19 15:00:00+00:00,Kent,2.0,9,,0,,0,,,0,9,9
3710,3710,3710,3710,3710,3710,3710,3710,3711,2020-12-21 15:00:00+00:00,Kent,13.0,22,,0,,0,,,0,22,22
3711,3711,3711,3711,3711,3711,3711,3711,3712,2020-12-22 15:00:00+00:00,Kent,16.0,38,,0,,0,,,0,38,38
3712,3712,3712,3712,3712,3712,3712,3712,3713,2020-12-23 15:00:00+00:00,Kent,10.0,48,,0,,0,,,0,48,48
3713,3713,3713,3713,3713,3713,3713,3713,3714,2020-12-24 15:00:00+00:00,Kent,3.0,51,,0,,0,,,0,51,51
3714,3714,3714,3714,3714,3714,3714,3714,3715,2020-12-25 15:00:00+00:00,Kent,1.0,52,,0,,0,,,0,52,52
3715,3715,3715,3715,3715,3715,3715,3715,3716,2020-12-26 15:00:00+00:00,Kent,63.0,115,,0,,0,,,0,115,115
3716,3716,3716,3716,3716,3716,3716,3716,3717,2020-12-27 15:00:00+00:00,Kent,1.0,116,,0,,0,,,0,116,116
3717,3717,3717,3717,3717,3717,3717,3717,3718,2020-12-28 15:00:00+00:00,Kent,11.0,127,,0,,0,,,0,127,127
3718,3718,3718,3718,3718,3718,3718,3718,3719,2020-12-29 15:00:00+00:00,Kent,68.0,195,,0,,0,,,0,195,195
3719,3719,3719,3719,3719,3719,3719,3719,3720,2020-12-30 15:00:00+00:00,Kent,73.0,268,1.0,1,,0,,,1,268,269
3720,3720,3720,3720,3720,3720,3720,3720,3721,2020-12-31 15:00:00+00:00,Kent,129.0,397,,1,,0,,,1,397,398
3721,3721,3721,3721,3721,3721,3721,3721,3722,2021-01-02 15:00:00+00:00,Kent,4.0,401,,1,,0,,,1,401,402
3722,3722,3722,3722,3722,3722,3722,3722,3723,2021-01-03 15:00:00+00:00,Kent,84.0,485,,1,,0,,,1,485,486
3723,3723,3723,3723,3723,3723,3723,3723,3724,2021-01-04 15:00:00+00:00,Kent,43.0,528,,1,,0,,,1,528,529
3724,3724,3724,3724,3724,3724,3724,3724,3725,2021-01-05 15:00:00+00:00,Kent,102.0,630,,1,,0,,,1,630,631
3725,3725,3725,3725,3725,3725,3725,3725,3726,2021-01-06 15:00:00+00:00,Kent,86.0,716,,1,,0,,,1,716,717
3726,3726,3726,3726,3726,3726,3726,3726,3727,2021-01-07 15:00:00+00:00,Kent,28.0,744,6.0,7,,0,,,7,744,751
3727,3727,3727,3727,3727,3727,3727,3727,3728,2021-01-08 15:00:00+00:00,Kent,42.0,786,2.0,9,,0,,,9,786,795
3728,3728,3728,3728,3728,3728,3728,3728,3729,2021-01-09 15:00:00+00:00,Kent,2.0,788,1.0,10,,0,,,10,788,798
3729,3729,3729,3729,3729,3729,3729,3729,3730,2021-01-10 15:00:00+00:00,Kent,1.0,789,1.0,11,,0,,,11,789,800
3730,3730,3730,3730,3730,3730,3730,3730,3731,2021-01-11 15:00:00+00:00,Kent,16.0,805,15.0,26,,0,,,26,805,831
3731,3731,3731,3731,3731,3731,3731,3731,3732,2021-01-12 15:00:00+00:00,Kent,37.0,842,14.0,40,,0,,,40,842,882
3732,3732,3732,3732,3732,3732,3732,3732,3733,2021-01-13 15:00:00+00:00,Kent,110.0,952,3.0,43,,0,,,43,952,995
3733,3733,3733,3733,3733,3733,3733,3733,3734,2021-01-14 15:00:00+00:00,Kent,15.0,967,3.0,46,,0,,,46,967,1013
3734,3734,3734,3734,3734,3734,3734,3734,3735,2021-01-15 15:00:00+00:00,Kent,36.0,1003,2.0,48,,0,,,48,1003,1051
3735,3735,3735,3735,3735,3735,3735,3735,3736,2021-01-16 15:00:00+00:00,Kent,35.0,1038,52.0,100,,0,,,100,1038,1138
3736,3736,3736,3736,3736,3736,3736,3736,3737,2021-01-17 15:00:00+00:00,Kent,4.0,1042,2.0,102,,0,,,102,1042,1144
3737,3737,3737,3737,3737,3737,3737,3737,3738,2021-01-18 15:00:00+00:00,Kent,13.0,1055,2.0,104,,0,,,104,1055,1159
3738,3738,3738,3738,3738,3738,3738,3738,3739,2021-01-19 15:00:00+00:00,Kent,79.0,1134,2.0,106,,0,,,106,1134,1240
3739,3739,3739,3739,3739,3739,3739,3739,3740,2021-01-20 15:00:00+00:00,Kent,100.0,1234,45.0,151,,0,,,151,1234,1385
3740,3740,3740,3740,3740,3740,3740,3740,3741,2021-01-21 15:00:00+00:00,Kent,131.0,1365,3.0,154,,0,,,154,1365,1519
3741,3741,3741,3741,3741,3741,3741,3741,3742,2021-01-22 15:00:00+00:00,Kent,104.0,1469,6.0,160,,0,,,160,1469,1629
3742,3742,3742,3742,3742,3742,3742,3742,3743,2021-01-23 15:00:00+00:00,Kent,14.0,1483,,160,,0,,,160,1483,1643
3743,3743,3743,3743,3743,3743,3743,3743,3744,2021-01-24 15:00:00+00:00,Kent,186.0,1669,60.0,220,,0,,,220,1669,1889
3744,3744,3744,3744,3744,3744,3744,3744,3745,2021-01-25 15:00:00+00:00,Kent,261.0,1930,12.0,232,,0,,,232,1930,2162
3745,3745,3745,3745,3745,3745,3745,3745,3746,2021-01-26 15:00:00+00:00,Kent,144.0,2074,79.0,311,,0,,,311,2074,2385
3746,3746,3746,3746,3746,3746,3746,3746,3747,2021-01-27 15:00:00+00:00,Kent,293.0,2367,7.0,318,,0,,,318,2367,2685
3747,3747,3747,3747,3747,3747,3747,3747,3748,2021-01-28 15:00:00+00:00,Kent,103.0,2470,128.0,446,,0,,,446,2470,2916
3748,3748,3748,3748,3748,3748,3748,3748,3749,2021-01-29 15:00:00+00:00,Kent,177.0,2647,12.0,458,,0,,,458,2647,3105
3749,3749,3749,3749,3749,3749,3749,3749,3750,2021-01-30 15:00:00+00:00,Kent,21.0,2668,6.0,464,,0,,,464,2668,3132
3750,3750,3750,3750,3750,3750,3750,3750,3751,2021-01-31 15:00:00+00:00,Kent,1.0,2669,1.0,465,,0,,,465,2669,3134
3751,3751,3751,3751,3751,3751,3751,3751,3752,2021-02-01 15:00:00+00:00,Kent,5.0,2674,9.0,474,,0,,,474,2674,3148
3752,3752,3752,3752,3752,3752,3752,3752,3753,2021-02-02 15:00:00+00:00,Kent,14.0,2688,43.0,517,,0,,,517,2688,3205
3753,3753,3753,3753,3753,3753,3753,3753,3754,2021-02-03 15:00:00+00:00,Kent,192.0,2880,28.0,545,,0,,,545,2880,3425
3754,3754,3754,3754,3754,3754,3754,3754,3755,2021-02-04 15:00:00+00:00,Kent,93.0,2973,160.0,705,,0,,,705,2973,3678
3755,3755,3755,3755,3755,3755,3755,3755,3756,2021-02-05 15:00:00+00:00,Kent,265.0,3238,42.0,747,,0,,,747,3238,3985
3756,3756,3756,3756,3756,3756,3756,3756,3757,2021-02-06 15:00:00+00:00,Kent,27.0,3265,13.0,760,,0,,,760,3265,4025
3757,3757,3757,3757,3757,3757,3757,3757,3758,2021-02-07 15:00:00+00:00,Kent,3.0,3268,,760,,0,,,760,3268,4028
3758,3758,3758,3758,3758,3758,3758,3758,3759,2021-02-08 15:00:00+00:00,Kent,320.0,3588,11.0,771,,0,,,771,3588,4359
3759,3759,3759,3759,3759,3759,3759,3759,3760,2021-02-09 15:00:00+00:00,Kent,83.0,3671,43.0,814,,0,,,814,3671,4485
3760,3760,3760,3760,3760,3760,3760,3760,3761,2021-02-10 15:00:00+00:00,Kent,561.0,4232,60.0,874,,0,,,874,4232,5106
3761,3761,3761,3761,3761,3761,3761,3761,3762,2021-02-11 15:00:00+00:00,Kent,46.0,4278,17.0,891,,0,,,891,4278,5169
3762,3762,3762,3762,3762,3762,3762,3762,3763,2021-02-12 15:00:00+00:00,Kent,32.0,4310,34.0,925,,0,,,925,4310,5235
3763,3763,3763,3763,3763,3763,3763,3763,3764,2021-02-13 15:00:00+00:00,Kent,2.0,4312,9.0,934,,0,,,934,4312,5246
3764,3764,3764,3764,3764,3764,3764,3764,3765,2021-02-14 15:00:00+00:00,Kent,3.0,4315,4.0,938,,0,,,938,4315,5253
3765,3765,3765,3765,3765,3765,3765,3765,3766,2021-02-15 15:00:00+00:00,Kent,14.0,4329,260.0,1198,,0,,,1198,4329,5527
3766,3766,3766,3766,3766,3766,3766,3766,3767,2021-02-16 15:00:00+00:00,Kent,27.0,4356,57.0,1255,,0,,,1255,4356,5611
3767,3767,3767,3767,3767,3767,3767,3767,3768,2021-02-17 15:00:00+00:00,Kent,210.0,4566,93.0,1348,,0,,,1348,4566,5914
3768,3768,3768,3768,3768,3768,3768,3768,3769,2021-02-18 15:00:00+00:00,Kent,3.0,4569,2.0,1350,,0,,,1350,4569,5919
3769,3769,3769,3769,3769,3769,3769,3769,3770,2021-02-19 15:00:00+00:00,Kent,6.0,4575,49.0,1399,,0,,,1399,4575,5974
3770,3770,3770,3770,3770,3770,3770,3770,3771,2021-02-20 15:00:00+00:00,Kent,1.0,4576,32.0,1431,,0,,,1431,4576,6007
3771,3771,3771,3771,3771,3771,3771,3771,3772,2021-02-21 15:00:00+00:00,Kent,2.0,4578,26.0,1457,,0,,,1457,4578,6035
3772,3772,3772,3772,3772,3772,3772,3772,3773,2021-02-22 15:00:00+00:00,Kent,36.0,4614,105.0,1562,,0,,,1562,4614,6176
3773,3773,3773,3773,3773,3773,3773,3773,3774,2021-02-23 15:00:00+00:00,Kent,16.0,4630,230.0,1792,,0,,,1792,4630,6422
3774,3774,3774,3774,3774,3774,3774,3774,3775,2021-02-24 15:00:00+00:00,Kent,83.0,4713,282.0,2074,,0,,,2074,4713,6787
3775,3775,3775,3775,3775,3775,3775,3775,3776,2021-02-25 15:00:00+00:00,Kent,35.0,4748,216.0,2290,,0,,,2290,4748,7038
3776,3776,3776,3776,3776,3776,3776,3776,3777,2021-02-26 15:00:00+00:00,Kent,40.0,4788,197.0,2487,,0,,,2487,4788,7275
3777,3777,3777,3777,3777,3777,3777,3777,3778,2021-02-27 15:00:00+00:00,Kent,22.0,4810,6.0,2493,,0,,,2493,4810,7303
3778,3778,3778,3778,3778,3778,3778,3778,3779,2021-02-28 15:00:00+00:00,Kent,29.0,4839,3.0,2496,,0,,,2496,4839,7335
3779,3779,3779,3779,3779,3779,3779,3779,3780,2021-03-01 15:00:00+00:00,Kent,47.0,4886,39.0,2535,,0,,,2535,4886,7421
3780,3780,3780,3780,3780,3780,3780,3780,3781,2021-03-02 15:00:00+00:00,Kent,53.0,4939,10.0,2545,,0,,,2545,4939,7484
3781,3781,3781,3781,3781,3781,3781,3781,3782,2021-03-03 15:00:00+00:00,Kent,58.0,4997,47.0,2592,,0,,,2592,4997,7589
3782,3782,3782,3782,3782,3782,3782,3782,3783,2021-03-04 15:00:00+00:00,Kent,43.0,5040,248.0,2840,1.0,1,44.0,249.0,2841,5041,7880
3783,3783,3783,3783,3783,3783,3783,3783,3784,2021-03-05 15:00:00+00:00,Kent,27.0,5067,243.0,3083,1.0,2,28.0,244.0,3085,5069,8150
3784,3784,3784,3784,3784,3784,3784,3784,3785,2021-03-06 15:00:00+00:00,Kent,18.0,5085,21.0,3104,16.0,18,34.0,37.0,3122,5103,8189
3785,3785,3785,3785,3785,3785,3785,3785,3786,2021-03-07 15:00:00+00:00,Kent,24.0,5109,4.0,3108,8.0,26,32.0,12.0,3134,5135,8217
3786,3786,3786,3786,3786,3786,3786,3786,3787,2021-03-08 15:00:00+00:00,Kent,49.0,5158,40.0,3148,1.0,27,50.0,41.0,3175,5185,8306
3787,3787,3787,3787,3787,3787,3787,3787,3788,2021-03-09 15:00:00+00:00,Kent,72.0,5230,400.0,3548,8.0,35,80.0,408.0,3583,5265,8778
3788,3788,3788,3788,3788,3788,3788,3788,3789,2021-03-10 15:00:00+00:00,Kent,68.0,5298,2.0,3550,5.0,40,73.0,7.0,3590,5338,8848
3789,3789,3789,3789,3789,3789,3789,3789,3790,2021-03-11 15:00:00+00:00,Kent,46.0,5344,580.0,4130,3.0,43,49.0,583.0,4173,5387,9474
3790,3790,3790,3790,3790,3790,3790,3790,3791,2021-03-12 15:00:00+00:00,Kent,61.0,5405,17.0,4147,3.0,46,64.0,20.0,4193,5451,9552
3791,3791,3791,3791,3791,3791,3791,3791,3792,2021-03-13 15:00:00+00:00,Kent,41.0,5446,9.0,4156,,46,,,4202,5492,9602
3792,3792,3792,3792,3792,3792,3792,3792,3793,2021-02-25 15:00:00+00:00,Frederick,625.0,35657,996.0,23548,,0,,,23548,35657,59205
3793,3793,3793,3793,3793,3793,3793,3793,3794,2021-02-26 15:00:00+00:00,Frederick,1489.0,37146,538.0,24086,,0,,,24086,37146,61232
3794,3794,3794,3794,3794,3794,3794,3794,3795,2021-02-27 15:00:00+00:00,Frederick,1515.0,38661,237.0,24323,,0,,,24323,38661,62984
3795,3795,3795,3795,3795,3795,3795,3795,3796,2021-02-28 15:00:00+00:00,Frederick,455.0,39116,108.0,24431,,0,,,24431,39116,63547
3796,3796,3796,3796,3796,3796,3796,3796,3797,2021-03-01 15:00:00+00:00,Frederick,863.0,39979,196.0,24627,,0,,,24627,39979,64606
3797,3797,3797,3797,3797,3797,3797,3797,3798,2021-03-02 15:00:00+00:00,Frederick,1262.0,41241,274.0,24901,5.0,5,1267.0,279.0,24906,41246,66142
3798,3798,3798,3798,3798,3798,3798,3798,3799,2021-03-03 15:00:00+00:00,Frederick,1441.0,42682,1192.0,26093,61.0,66,1502.0,1253.0,26159,42748,68775
3799,3799,3799,3799,3799,3799,3799,3799,3800,2021-03-04 15:00:00+00:00,Frederick,1462.0,44144,792.0,26885,114.0,180,1576.0,906.0,27065,44324,71029
3800,3800,3800,3800,3800,3800,3800,3800,3801,2021-03-05 15:00:00+00:00,Frederick,1352.0,45496,327.0,27212,140.0,320,1492.0,467.0,27532,45816,72708
3801,3801,3801,3801,3801,3801,3801,3801,3802,2021-03-06 15:00:00+00:00,Frederick,1312.0,46808,141.0,27353,291.0,611,1603.0,432.0,27964,47419,74161
3802,3802,3802,3802,3802,3802,3802,3802,3803,2021-03-07 15:00:00+00:00,Frederick,486.0,47294,96.0,27449,193.0,804,679.0,289.0,28253,48098,74743
3803,3803,3803,3803,3803,3803,3803,3803,3804,2021-03-08 15:00:00+00:00,Frederick,628.0,47922,189.0,27638,225.0,1029,853.0,414.0,28667,48951,75560
3804,3804,3804,3804,3804,3804,3804,3804,3805,2021-03-09 15:00:00+00:00,Frederick,946.0,48868,614.0,28252,220.0,1249,1166.0,834.0,29501,50117,77120
3805,3805,3805,3805,3805,3805,3805,3805,3806,2021-03-10 15:00:00+00:00,Frederick,931.0,49799,723.0,28975,438.0,1687,1369.0,1161.0,30662,51486,78774
3806,3806,3806,3806,3806,3806,3806,3806,3807,2021-03-11 15:00:00+00:00,Frederick,963.0,50762,313.0,29288,110.0,1797,1073.0,423.0,31085,52559,80050
3807,3807,3807,3807,3807,3807,3807,3807,3808,2021-03-12 15:00:00+00:00,Frederick,2157.0,52919,871.0,30159,72.0,1869,2229.0,943.0,32028,54788,83078
3808,3808,3808,3808,3808,3808,3808,3808,3809,2021-03-13 15:00:00+00:00,Frederick,893.0,53812,751.0,30910,32.0,1901,925.0,783.0,32811,55713,84722
3809,3809,3809,3809,3809,3809,3809,3809,3810,2021-03-14 15:00:00+00:00,Frederick,546.0,54358,279.0,31189,10.0,1911,556.0,289.0,33100,56269,85547
3810,3810,3810,3810,3810,3810,3810,3810,3811,2021-03-15 15:00:00+00:00,Frederick,1062.0,55420,506.0,31695,44.0,1955,1106.0,550.0,33650,57375,87115
3811,3811,3811,3811,3811,3811,3811,3811,3812,2021-03-16 15:00:00+00:00,Frederick,873.0,56293,610.0,32305,6.0,1961,879.0,616.0,34266,58254,88598
3812,3812,3812,3812,3812,3812,3812,3812,3813,2021-03-17 15:00:00+00:00,Frederick,2116.0,58409,672.0,32977,44.0,2005,2160.0,716.0,34982,60414,91386
3813,3813,3813,3813,3813,3813,3813,3813,3814,2021-03-18 15:00:00+00:00,Frederick,1169.0,59578,347.0,33324,87.0,2092,1256.0,434.0,35416,61670,92902
3814,3814,3814,3814,3814,3814,3814,3814,3815,2021-03-19 15:00:00+00:00,Frederick,1855.0,61433,299.0,33623,29.0,2121,1884.0,328.0,35744,63554,95056
3815,3815,3815,3815,3815,3815,3815,3815,3816,2021-03-20 15:00:00+00:00,Frederick,598.0,62031,334.0,33957,11.0,2132,609.0,345.0,36089,64163,95988
3816,3816,3816,3816,3816,3816,3816,3816,3817,2021-03-21 15:00:00+00:00,Frederick,601.0,62632,208.0,34165,14.0,2146,615.0,222.0,36311,64778,96797
3817,3817,3817,3817,3817,3817,3817,3817,3818,2021-03-22 15:00:00+00:00,Frederick,929.0,63561,322.0,34487,27.0,2173,956.0,349.0,36660,65734,98048
3818,3818,3818,3818,3818,3818,3818,3818,3819,2021-03-23 15:00:00+00:00,Frederick,1268.0,64829,640.0,35127,29.0,2202,1297.0,669.0,37329,67031,99956
3819,3819,3819,3819,3819,3819,3819,3819,3820,2021-03-24 15:00:00+00:00,Frederick,2206.0,67035,644.0,35771,63.0,2265,2269.0,707.0,38036,69300,102806
3820,3820,3820,3820,3820,3820,3820,3820,3821,2021-03-25 15:00:00+00:00,Frederick,1463.0,68498,787.0,36558,320.0,2585,1783.0,1107.0,39143,71083,105056
3821,3821,3821,3821,3821,3821,3821,3821,3822,2021-03-26 15:00:00+00:00,Frederick,750.0,69248,1585.0,38143,331.0,2916,1081.0,1916.0,41059,72164,107391
3822,3822,3822,3822,3822,3822,3822,3822,3823,2021-03-27 15:00:00+00:00,Frederick,582.0,69830,1453.0,39596,417.0,3333,999.0,1870.0,42929,73163,109426
3823,3823,3823,3823,3823,3823,3823,3823,3824,2021-03-28 15:00:00+00:00,Frederick,480.0,70310,467.0,40063,385.0,3718,865.0,852.0,43781,74028,110373
3824,3824,3824,3824,3824,3824,3824,3824,3825,2021-03-29 15:00:00+00:00,Frederick,1176.0,71486,1088.0,41151,64.0,3782,1240.0,1152.0,44933,75268,112637
3825,3825,3825,3825,3825,3825,3825,3825,3826,2021-03-30 15:00:00+00:00,Frederick,1329.0,72815,1380.0,42531,52.0,3834,1381.0,1432.0,46365,76649,115346
3826,3826,3826,3826,3826,3826,3826,3826,3827,2021-03-31 15:00:00+00:00,Frederick,2783.0,75598,1064.0,43595,600.0,4434,3383.0,1664.0,48029,80032,119193
3827,3827,3827,3827,3827,3827,3827,3827,3828,2021-04-01 15:00:00+00:00,Frederick,1956.0,77554,1679.0,45274,596.0,5030,2552.0,2275.0,50304,82584,122828
3828,3828,3828,3828,3828,3828,3828,3828,3829,2021-04-02 15:00:00+00:00,Frederick,1378.0,78932,1567.0,46841,709.0,5739,2087.0,2276.0,52580,84671,125773
3829,3829,3829,3829,3829,3829,3829,3829,3830,2021-04-03 15:00:00+00:00,Frederick,712.0,79644,1222.0,48063,700.0,6439,1412.0,1922.0,54502,86083,127707
3830,3830,3830,3830,3830,3830,3830,3830,3831,2021-04-04 15:00:00+00:00,Frederick,333.0,79977,379.0,48442,11.0,6450,344.0,390.0,54892,86427,128419
3831,3831,3831,3831,3831,3831,3831,3831,3832,2021-04-05 15:00:00+00:00,Frederick,912.0,80889,1008.0,49450,640.0,7090,1552.0,1648.0,56540,87979,130339
3832,3832,3832,3832,3832,3832,3832,3832,3833,2021-04-06 15:00:00+00:00,Frederick,1087.0,81976,793.0,50243,816.0,7906,1903.0,1609.0,58149,89882,132219
3833,3833,3833,3833,3833,3833,3833,3833,3834,2021-04-07 15:00:00+00:00,Frederick,1158.0,83134,1078.0,51321,1090.0,8996,2248.0,2168.0,60317,92130,134455
3834,3834,3834,3834,3834,3834,3834,3834,3835,2021-04-08 15:00:00+00:00,Frederick,2668.0,85802,1020.0,52341,779.0,9775,3447.0,1799.0,62116,95577,138143
3835,3835,3835,3835,3835,3835,3835,3835,3836,2021-04-09 15:00:00+00:00,Frederick,1162.0,86964,2138.0,54479,755.0,10530,1917.0,2893.0,65009,97494,141443
3836,3836,3836,3836,3836,3836,3836,3836,3837,2021-04-10 15:00:00+00:00,Frederick,1212.0,88176,852.0,55331,434.0,10964,1646.0,1286.0,66295,99140,143507
3837,3837,3837,3837,3837,3837,3837,3837,3838,2021-04-11 15:00:00+00:00,Frederick,379.0,88555,355.0,55686,331.0,11295,710.0,686.0,66981,99850,144241
3838,3838,3838,3838,3838,3838,3838,3838,3839,2021-04-12 15:00:00+00:00,Frederick,658.0,89213,965.0,56651,649.0,11944,1307.0,1614.0,68595,101157,145864
3839,3839,3839,3839,3839,3839,3839,3839,3840,2021-04-13 15:00:00+00:00,Frederick,3032.0,92245,846.0,57497,26.0,11970,3058.0,872.0,69467,104215,149742
3840,3840,3840,3840,3840,3840,3840,3840,3841,2021-04-14 15:00:00+00:00,Frederick,1153.0,93398,1781.0,59278,1.0,11971,1154.0,1782.0,71249,105369,152676
3841,3841,3841,3841,3841,3841,3841,3841,3842,2021-04-15 15:00:00+00:00,Frederick,2732.0,96130,733.0,60011,,11971,,,71982,108101,156141
3842,3842,3842,3842,3842,3842,3842,3842,3843,2021-04-16 15:00:00+00:00,Frederick,965.0,97095,1597.0,61608,,11971,,,73579,109066,158703
3843,3843,3843,3843,3843,3843,3843,3843,3844,2021-04-17 15:00:00+00:00,Frederick,1252.0,98347,402.0,62010,,11971,,,73981,110318,160357
3844,3844,3844,3844,3844,3844,3844,3844,3845,2021-04-18 15:00:00+00:00,Frederick,437.0,98784,382.0,62392,,11971,,,74363,110755,161176
3845,3845,3845,3845,3845,3845,3845,3845,3846,2021-04-19 15:00:00+00:00,Frederick,954.0,99738,1140.0,63532,4.0,11975,958.0,1144.0,75507,111713,163270
3846,3846,3846,3846,3846,3846,3846,3846,3847,2021-04-20 15:00:00+00:00,Frederick,963.0,100701,1739.0,65271,1.0,11976,964.0,1740.0,77247,112677,165972
3847,3847,3847,3847,3847,3847,3847,3847,3848,2021-04-21 15:00:00+00:00,Frederick,1385.0,102086,2553.0,67824,1.0,11977,1386.0,2554.0,79801,114063,169910
3848,3848,3848,3848,3848,3848,3848,3848,3849,2021-04-22 15:00:00+00:00,Frederick,1858.0,103944,2036.0,69860,,11977,,,81837,115921,173804
3849,3849,3849,3849,3849,3849,3849,3849,3850,2021-04-23 15:00:00+00:00,Frederick,2466.0,106410,1188.0,71048,,11977,,,83025,118387,177458
3850,3850,3850,3850,3850,3850,3850,3850,3851,2021-04-24 15:00:00+00:00,Frederick,2076.0,108486,773.0,71821,3.0,11980,2079.0,776.0,83801,120466,180307
3851,3851,3851,3851,3851,3851,3851,3851,3852,2021-04-25 15:00:00+00:00,Frederick,614.0,109100,405.0,72226,,11980,,,84206,121080,181326
3852,3852,3852,3852,3852,3852,3852,3852,3853,2021-04-26 15:00:00+00:00,Frederick,976.0,110076,885.0,73111,24.0,12004,1000.0,909.0,85115,122080,183187
3853,3853,3853,3853,3853,3853,3853,3853,3854,2021-04-27 15:00:00+00:00,Frederick,1328.0,111404,932.0,74043,62.0,12066,1390.0,994.0,86109,123470,185447
3854,3854,3854,3854,3854,3854,3854,3854,3855,2021-04-28 15:00:00+00:00,Frederick,1158.0,112562,2349.0,76392,94.0,12160,1252.0,2443.0,88552,124722,188954
3855,3855,3855,3855,3855,3855,3855,3855,3856,2021-04-29 15:00:00+00:00,Frederick,1050.0,113612,1817.0,78209,113.0,12273,1163.0,1930.0,90482,125885,191821
3856,3856,3856,3856,3856,3856,3856,3856,3857,2021-04-30 15:00:00+00:00,Frederick,1473.0,115085,1404.0,79613,105.0,12378,1578.0,1509.0,91991,127463,194698
3857,3857,3857,3857,3857,3857,3857,3857,3858,2021-05-01 15:00:00+00:00,Frederick,929.0,116014,688.0,80301,64.0,12442,993.0,752.0,92743,128456,196315
3858,3858,3858,3858,3858,3858,3858,3858,3859,2021-05-02 15:00:00+00:00,Frederick,264.0,116278,346.0,80647,45.0,12487,309.0,391.0,93134,128765,196925
3859,3859,3859,3859,3859,3859,3859,3859,3860,2021-05-03 15:00:00+00:00,Frederick,435.0,116713,879.0,81526,91.0,12578,526.0,970.0,94104,129291,198239
3860,3860,3860,3860,3860,3860,3860,3860,3861,2021-05-04 15:00:00+00:00,Frederick,470.0,117183,1019.0,82545,101.0,12679,571.0,1120.0,95224,129862,199728
3861,3861,3861,3861,3861,3861,3861,3861,3862,2021-05-05 15:00:00+00:00,Frederick,595.0,117778,826.0,83371,126.0,12805,721.0,952.0,96176,130583,201149
3862,3862,3862,3862,3862,3862,3862,3862,3863,2021-05-06 15:00:00+00:00,Frederick,496.0,118274,2447.0,85818,94.0,12899,590.0,2541.0,98717,131173,204092
3863,3863,3863,3863,3863,3863,3863,3863,3864,2021-05-07 15:00:00+00:00,Frederick,772.0,119046,926.0,86744,131.0,13030,903.0,1057.0,99774,132076,205790
3864,3864,3864,3864,3864,3864,3864,3864,3865,2021-05-08 15:00:00+00:00,Frederick,458.0,119504,1259.0,88003,78.0,13108,536.0,1337.0,101111,132612,207507
3865,3865,3865,3865,3865,3865,3865,3865,3866,2021-05-09 15:00:00+00:00,Frederick,77.0,119581,240.0,88243,48.0,13156,125.0,288.0,101399,132737,207824
3866,3866,3866,3866,3866,3866,3866,3866,3867,2021-05-10 15:00:00+00:00,Frederick,280.0,119861,794.0,89037,87.0,13243,367.0,881.0,102280,133104,208898
3867,3867,3867,3867,3867,3867,3867,3867,3868,2021-05-11 15:00:00+00:00,Frederick,502.0,120363,2883.0,91920,64.0,13307,566.0,2947.0,105227,133670,212283
3868,3868,3868,3868,3868,3868,3868,3868,3869,2021-05-12 15:00:00+00:00,Frederick,467.0,120830,994.0,92914,89.0,13396,556.0,1083.0,106310,134226,213744
3869,3869,3869,3869,3869,3869,3869,3869,3870,2021-05-13 15:00:00+00:00,Frederick,888.0,121718,2476.0,95390,50.0,13446,938.0,2526.0,108836,135164,217108
3870,3870,3870,3870,3870,3870,3870,3870,3871,2021-05-14 15:00:00+00:00,Frederick,1085.0,122803,893.0,96283,60.0,13506,1145.0,953.0,109789,136309,219086
3871,3871,3871,3871,3871,3871,3871,3871,3872,2021-05-15 15:00:00+00:00,Frederick,930.0,123733,1395.0,97678,40.0,13546,970.0,1435.0,111224,137279,221411
3872,3872,3872,3872,3872,3872,3872,3872,3873,2021-05-16 15:00:00+00:00,Frederick,228.0,123961,317.0,97995,23.0,13569,251.0,340.0,111564,137530,221956
3873,3873,3873,3873,3873,3873,3873,3873,3874,2021-05-17 15:00:00+00:00,Frederick,564.0,124525,1076.0,99071,80.0,13649,644.0,1156.0,112720,138174,223596
3874,3874,3874,3874,3874,3874,3874,3874,3875,2021-05-18 15:00:00+00:00,Frederick,778.0,125303,1506.0,100577,97.0,13746,875.0,1603.0,114323,139049,225880
3875,3875,3875,3875,3875,3875,3875,3875,3876,2021-05-19 15:00:00+00:00,Frederick,1409.0,126712,1509.0,102086,73.0,13819,1482.0,1582.0,115905,140531,228798
3876,3876,3876,3876,3876,3876,3876,3876,3877,2021-05-20 15:00:00+00:00,Frederick,1295.0,128007,1999.0,104085,86.0,13905,1381.0,2085.0,117990,141912,232092
3877,3877,3877,3877,3877,3877,3877,3877,3878,2021-05-21 15:00:00+00:00,Frederick,1203.0,129210,2277.0,106362,71.0,13976,1274.0,2348.0,120338,143186,235572
3878,3878,3878,3878,3878,3878,3878,3878,3879,2021-05-22 15:00:00+00:00,Frederick,984.0,130194,1564.0,107926,29.0,14005,1013.0,1593.0,121931,144199,238120
3879,3879,3879,3879,3879,3879,3879,3879,3880,2021-05-23 15:00:00+00:00,Frederick,255.0,130449,259.0,108185,26.0,14031,281.0,285.0,122216,144480,238634
3880,3880,3880,3880,3880,3880,3880,3880,3881,2021-05-24 15:00:00+00:00,Frederick,499.0,130948,641.0,108826,48.0,14079,547.0,689.0,122905,145027,239774
3881,3881,3881,3881,3881,3881,3881,3881,3882,2021-05-25 15:00:00+00:00,Frederick,444.0,131392,877.0,109703,61.0,14140,505.0,938.0,123843,145532,241095
3882,3882,3882,3882,3882,3882,3882,3882,3883,2021-05-26 15:00:00+00:00,Frederick,658.0,132050,725.0,110428,51.0,14191,709.0,776.0,124619,146241,242478
3883,3883,3883,3883,3883,3883,3883,3883,3884,2021-05-27 15:00:00+00:00,Frederick,473.0,132523,560.0,110988,58.0,14249,531.0,618.0,125237,146772,243511
3884,3884,3884,3884,3884,3884,3884,3884,3885,2021-05-28 15:00:00+00:00,Frederick,639.0,133162,1357.0,112345,87.0,14336,726.0,1444.0,126681,147498,245507
3885,3885,3885,3885,3885,3885,3885,3885,3886,2021-05-29 15:00:00+00:00,Frederick,441.0,133603,909.0,113254,66.0,14402,507.0,975.0,127656,148005,246857
3886,3886,3886,3886,3886,3886,3886,3886,3887,2021-05-30 15:00:00+00:00,Frederick,144.0,133747,135.0,113389,19.0,14421,163.0,154.0,127810,148168,247136
3887,3887,3887,3887,3887,3887,3887,3887,3888,2021-05-31 15:00:00+00:00,Frederick,87.0,133834,135.0,113524,,14421,,,127945,148255,247358
3888,3888,3888,3888,3888,3888,3888,3888,3889,2021-06-01 15:00:00+00:00,Frederick,322.0,134156,659.0,114183,57.0,14478,379.0,716.0,128661,148634,248339
3889,3889,3889,3889,3889,3889,3889,3889,3890,2021-06-02 15:00:00+00:00,Frederick,398.0,134554,685.0,114868,35.0,14513,433.0,720.0,129381,149067,249422
3890,3890,3890,3890,3890,3890,3890,3890,3891,2021-06-03 15:00:00+00:00,Frederick,312.0,134866,850.0,115718,51.0,14564,363.0,901.0,130282,149430,250584
3891,3891,3891,3891,3891,3891,3891,3891,3892,2021-06-04 15:00:00+00:00,Frederick,316.0,135182,1187.0,116905,58.0,14622,374.0,1245.0,131527,149804,252087
3892,3892,3892,3892,3892,3892,3892,3892,3893,2021-06-05 15:00:00+00:00,Frederick,295.0,135477,846.0,117751,40.0,14662,335.0,886.0,132413,150139,253228
3893,3893,3893,3893,3893,3893,3893,3893,3894,2021-06-06 15:00:00+00:00,Frederick,112.0,135589,190.0,117941,16.0,14678,128.0,206.0,132619,150267,253530
3894,3894,3894,3894,3894,3894,3894,3894,3895,2021-06-07 15:00:00+00:00,Frederick,258.0,135847,555.0,118496,37.0,14715,295.0,592.0,133211,150562,254343
3895,3895,3895,3895,3895,3895,3895,3895,3896,2021-06-08 15:00:00+00:00,Frederick,204.0,136051,725.0,119221,56.0,14771,260.0,781.0,133992,150822,255272
3896,3896,3896,3896,3896,3896,3896,3896,3897,2021-06-09 15:00:00+00:00,Frederick,325.0,136376,1180.0,120401,34.0,14805,359.0,1214.0,135206,151181,256777
3897,3897,3897,3897,3897,3897,3897,3897,3898,2021-06-10 15:00:00+00:00,Frederick,267.0,136643,1226.0,121627,39.0,14844,306.0,1265.0,136471,151487,258270
3898,3898,3898,3898,3898,3898,3898,3898,3899,2021-06-11 15:00:00+00:00,Frederick,273.0,136916,1103.0,122730,41.0,14885,314.0,1144.0,137615,151801,259646
3899,3899,3899,3899,3899,3899,3899,3899,3900,2021-06-12 15:00:00+00:00,Frederick,222.0,137138,980.0,123710,34.0,14919,256.0,1014.0,138629,152057,260848
3900,3900,3900,3900,3900,3900,3900,3900,3901,2021-06-13 15:00:00+00:00,Frederick,64.0,137202,263.0,123973,9.0,14928,73.0,272.0,138901,152130,261175
3901,3901,3901,3901,3901,3901,3901,3901,3902,2021-06-14 15:00:00+00:00,Frederick,207.0,137409,546.0,124519,34.0,14962,241.0,580.0,139481,152371,261928
3902,3902,3902,3902,3902,3902,3902,3902,3903,2021-06-15 15:00:00+00:00,Frederick,186.0,137595,484.0,125003,30.0,14992,216.0,514.0,139995,152587,262598
3903,3903,3903,3903,3903,3903,3903,3903,3904,2021-06-16 15:00:00+00:00,Frederick,250.0,137845,718.0,125721,29.0,15021,279.0,747.0,140742,152866,263566
3904,3904,3904,3904,3904,3904,3904,3904,3905,2021-03-10 15:00:00+00:00,Howard,2018.0,75954,1719.0,42204,620.0,3915,2638.0,2339.0,46119,79869,118158
3905,3905,3905,3905,3905,3905,3905,3905,3906,2021-03-11 15:00:00+00:00,Howard,1945.0,77899,931.0,43135,150.0,4065,2095.0,1081.0,47200,81964,121034
3906,3906,3906,3906,3906,3906,3906,3906,3907,2021-03-12 15:00:00+00:00,Howard,2235.0,80134,1833.0,44968,50.0,4115,2285.0,1883.0,49083,84249,125102
3907,3907,3907,3907,3907,3907,3907,3907,3908,2021-03-13 15:00:00+00:00,Howard,1592.0,81726,998.0,45966,22.0,4137,1614.0,1020.0,50103,85863,127692
3908,3908,3908,3908,3908,3908,3908,3908,3909,2021-03-14 15:00:00+00:00,Howard,1505.0,83231,728.0,46694,6.0,4143,1511.0,734.0,50837,87374,129925
3909,3909,3909,3909,3909,3909,3909,3909,3910,2021-03-15 15:00:00+00:00,Howard,1791.0,85022,876.0,47570,11.0,4154,1802.0,887.0,51724,89176,132592
3910,3910,3910,3910,3910,3910,3910,3910,3911,2021-03-16 15:00:00+00:00,Howard,3098.0,88120,963.0,48533,19.0,4173,3117.0,982.0,52706,92293,136653
3911,3911,3911,3911,3911,3911,3911,3911,3912,2021-03-17 15:00:00+00:00,Howard,2165.0,90285,1752.0,50285,32.0,4205,2197.0,1784.0,54490,94490,140570
3912,3912,3912,3912,3912,3912,3912,3912,3913,2021-03-18 15:00:00+00:00,Howard,2314.0,92599,820.0,51105,41.0,4246,2355.0,861.0,55351,96845,143704
3913,3913,3913,3913,3913,3913,3913,3913,3914,2021-03-19 15:00:00+00:00,Howard,1946.0,94545,908.0,52013,47.0,4293,1993.0,955.0,56306,98838,146558
3914,3914,3914,3914,3914,3914,3914,3914,3915,2021-03-20 15:00:00+00:00,Howard,2255.0,96800,815.0,52828,54.0,4347,2309.0,869.0,57175,101147,149628
3915,3915,3915,3915,3915,3915,3915,3915,3916,2021-03-21 15:00:00+00:00,Howard,1522.0,98322,619.0,53447,25.0,4372,1547.0,644.0,57819,102694,151769
3916,3916,3916,3916,3916,3916,3916,3916,3917,2021-03-22 15:00:00+00:00,Howard,1791.0,100113,875.0,54322,82.0,4454,1873.0,957.0,58776,104567,154435
3917,3917,3917,3917,3917,3917,3917,3917,3918,2021-03-23 15:00:00+00:00,Howard,2639.0,102752,1158.0,55480,104.0,4558,2743.0,1262.0,60038,107310,158232
3918,3918,3918,3918,3918,3918,3918,3918,3919,2021-03-24 15:00:00+00:00,Howard,3257.0,106009,1214.0,56694,96.0,4654,3353.0,1310.0,61348,110663,162703
3919,3919,3919,3919,3919,3919,3919,3919,3920,2021-03-25 15:00:00+00:00,Howard,2490.0,108499,1157.0,57851,124.0,4778,2614.0,1281.0,62629,113277,166350
3920,3920,3920,3920,3920,3920,3920,3920,3921,2021-03-26 15:00:00+00:00,Howard,1832.0,110331,1333.0,59184,104.0,4882,1936.0,1437.0,64066,115213,169515
3921,3921,3921,3921,3921,3921,3921,3921,3922,2021-03-27 15:00:00+00:00,Howard,1401.0,111732,1085.0,60269,69.0,4951,1470.0,1154.0,65220,116683,172001
3922,3922,3922,3922,3922,3922,3922,3922,3923,2021-03-28 15:00:00+00:00,Howard,1306.0,113038,1062.0,61331,65.0,5016,1371.0,1127.0,66347,118054,174369
3923,3923,3923,3923,3923,3923,3923,3923,3924,2021-03-29 15:00:00+00:00,Howard,1542.0,114580,1509.0,62840,81.0,5097,1623.0,1590.0,67937,119677,177420
3924,3924,3924,3924,3924,3924,3924,3924,3925,2021-03-30 15:00:00+00:00,Howard,2169.0,116749,2606.0,65446,92.0,5189,2261.0,2698.0,70635,121938,182195
3925,3925,3925,3925,3925,3925,3925,3925,3926,2021-03-31 15:00:00+00:00,Howard,2328.0,119077,2121.0,67567,253.0,5442,2581.0,2374.0,73009,124519,186644
3926,3926,3926,3926,3926,3926,3926,3926,3927,2021-04-01 15:00:00+00:00,Howard,3504.0,122581,2498.0,70065,274.0,5716,3778.0,2772.0,75781,128297,192646
3927,3927,3927,3927,3927,3927,3927,3927,3928,2021-04-02 15:00:00+00:00,Howard,2000.0,124581,2370.0,72435,293.0,6009,2293.0,2663.0,78444,130590,197016
3928,3928,3928,3928,3928,3928,3928,3928,3929,2021-04-03 15:00:00+00:00,Howard,1401.0,125982,1406.0,73841,241.0,6250,1642.0,1647.0,80091,132232,199823
3929,3929,3929,3929,3929,3929,3929,3929,3930,2021-04-04 15:00:00+00:00,Howard,609.0,126591,794.0,74635,52.0,6302,661.0,846.0,80937,132893,201226
3930,3930,3930,3930,3930,3930,3930,3930,3931,2021-04-05 15:00:00+00:00,Howard,2222.0,128813,1657.0,76292,357.0,6659,2579.0,2014.0,82951,135472,205105
3931,3931,3931,3931,3931,3931,3931,3931,3932,2021-04-06 15:00:00+00:00,Howard,2124.0,130937,2076.0,78368,545.0,7204,2669.0,2621.0,85572,138141,209305
3932,3932,3932,3932,3932,3932,3932,3932,3933,2021-04-07 15:00:00+00:00,Howard,2125.0,133062,2505.0,80873,673.0,7877,2798.0,3178.0,88750,140939,213935
3933,3933,3933,3933,3933,3933,3933,3933,3934,2021-04-08 15:00:00+00:00,Howard,3577.0,136639,1965.0,82838,578.0,8455,4155.0,2543.0,91293,145094,219477
3934,3934,3934,3934,3934,3934,3934,3934,3935,2021-04-09 15:00:00+00:00,Howard,1649.0,138288,2359.0,85197,660.0,9115,2309.0,3019.0,94312,147403,223485
3935,3935,3935,3935,3935,3935,3935,3935,3936,2021-04-10 15:00:00+00:00,Howard,1689.0,139977,1767.0,86964,403.0,9518,2092.0,2170.0,96482,149495,226941
3936,3936,3936,3936,3936,3936,3936,3936,3937,2021-04-11 15:00:00+00:00,Howard,1151.0,141128,1117.0,88081,383.0,9901,1534.0,1500.0,97982,151029,229209
3937,3937,3937,3937,3937,3937,3937,3937,3938,2021-04-12 15:00:00+00:00,Howard,1336.0,142464,1708.0,89789,553.0,10454,1889.0,2261.0,100243,152918,232253
3938,3938,3938,3938,3938,3938,3938,3938,3939,2021-04-13 15:00:00+00:00,Howard,2234.0,144698,3247.0,93036,35.0,10489,2269.0,3282.0,103525,155187,237734
3939,3939,3939,3939,3939,3939,3939,3939,3940,2021-04-14 15:00:00+00:00,Howard,2525.0,147223,2081.0,95117,6.0,10495,2531.0,2087.0,105612,157718,242340
3940,3940,3940,3940,3940,3940,3940,3940,3941,2021-04-15 15:00:00+00:00,Howard,3159.0,150382,1769.0,96886,5.0,10500,3164.0,1774.0,107386,160882,247268
3941,3941,3941,3941,3941,3941,3941,3941,3942,2021-04-16 15:00:00+00:00,Howard,1758.0,152140,1683.0,98569,,10500,,,109069,162640,250709
3942,3942,3942,3942,3942,3942,3942,3942,3943,2021-04-17 15:00:00+00:00,Howard,2273.0,154413,1889.0,100458,,10500,,,110958,164913,254871
3943,3943,3943,3943,3943,3943,3943,3943,3944,2021-04-18 15:00:00+00:00,Howard,1137.0,155550,1402.0,101860,,10500,,,112360,166050,257410
3944,3944,3944,3944,3944,3944,3944,3944,3945,2021-04-19 15:00:00+00:00,Howard,1850.0,157400,1826.0,103686,2.0,10502,1852.0,1828.0,114188,167902,261086
3945,3945,3945,3945,3945,3945,3945,3945,3946,2021-04-20 15:00:00+00:00,Howard,2252.0,159652,2608.0,106294,,10502,,,116796,170154,265946
3946,3946,3946,3946,3946,3946,3946,3946,3947,2021-04-21 15:00:00+00:00,Howard,2342.0,161994,3410.0,109704,,10502,,,120206,172496,271698
3947,3947,3947,3947,3947,3947,3947,3947,3948,2021-04-22 15:00:00+00:00,Howard,3595.0,165589,2521.0,112225,2.0,10504,3597.0,2523.0,122729,176093,277814
3948,3948,3948,3948,3948,3948,3948,3948,3949,2021-04-23 15:00:00+00:00,Howard,1993.0,167582,2048.0,114273,,10504,,,124777,178086,281855
3949,3949,3949,3949,3949,3949,3949,3949,3950,2021-04-24 15:00:00+00:00,Howard,2185.0,169767,1644.0,115917,1.0,10505,2186.0,1645.0,126422,180272,285684
3950,3950,3950,3950,3950,3950,3950,3950,3951,2021-04-25 15:00:00+00:00,Howard,1016.0,170783,534.0,116451,,10505,,,126956,181288,287234
3951,3951,3951,3951,3951,3951,3951,3951,3952,2021-04-26 15:00:00+00:00,Howard,1310.0,172093,1427.0,117878,7.0,10512,1317.0,1434.0,128390,182605,289971
3952,3952,3952,3952,3952,3952,3952,3952,3953,2021-04-27 15:00:00+00:00,Howard,1959.0,174052,1770.0,119648,53.0,10565,2012.0,1823.0,130213,184617,293700
3953,3953,3953,3953,3953,3953,3953,3953,3954,2021-04-28 15:00:00+00:00,Howard,1699.0,175751,2226.0,121874,52.0,10617,1751.0,2278.0,132491,186368,297625
3954,3954,3954,3954,3954,3954,3954,3954,3955,2021-04-29 15:00:00+00:00,Howard,1291.0,177042,3331.0,125205,69.0,10686,1360.0,3400.0,135891,187728,302247
3955,3955,3955,3955,3955,3955,3955,3955,3956,2021-04-30 15:00:00+00:00,Howard,1480.0,178522,1721.0,126926,75.0,10761,1555.0,1796.0,137687,189283,305448
3956,3956,3956,3956,3956,3956,3956,3956,3957,2021-05-01 15:00:00+00:00,Howard,1404.0,179926,1495.0,128421,45.0,10806,1449.0,1540.0,139227,190732,308347
3957,3957,3957,3957,3957,3957,3957,3957,3958,2021-05-02 15:00:00+00:00,Howard,719.0,180645,1282.0,129703,45.0,10851,764.0,1327.0,140554,191496,310348
3958,3958,3958,3958,3958,3958,3958,3958,3959,2021-05-03 15:00:00+00:00,Howard,470.0,181115,1860.0,131563,53.0,10904,523.0,1913.0,142467,192019,312678
3959,3959,3959,3959,3959,3959,3959,3959,3960,2021-05-04 15:00:00+00:00,Howard,517.0,181632,2040.0,133603,94.0,10998,611.0,2134.0,144601,192630,315235
3960,3960,3960,3960,3960,3960,3960,3960,3961,2021-05-05 15:00:00+00:00,Howard,1788.0,183420,2355.0,135958,51.0,11049,1839.0,2406.0,147007,194469,319378
3961,3961,3961,3961,3961,3961,3961,3961,3962,2021-05-06 15:00:00+00:00,Howard,892.0,184312,3594.0,139552,61.0,11110,953.0,3655.0,150662,195422,323864
3962,3962,3962,3962,3962,3962,3962,3962,3963,2021-05-07 15:00:00+00:00,Howard,1092.0,185404,1908.0,141460,84.0,11194,1176.0,1992.0,152654,196598,326864
3963,3963,3963,3963,3963,3963,3963,3963,3964,2021-05-08 15:00:00+00:00,Howard,656.0,186060,2410.0,143870,45.0,11239,701.0,2455.0,155109,197299,329930
3964,3964,3964,3964,3964,3964,3964,3964,3965,2021-05-09 15:00:00+00:00,Howard,376.0,186436,804.0,144674,23.0,11262,399.0,827.0,155936,197698,331110
3965,3965,3965,3965,3965,3965,3965,3965,3966,2021-05-10 15:00:00+00:00,Howard,339.0,186775,1776.0,146450,44.0,11306,383.0,1820.0,157756,198081,333225
3966,3966,3966,3966,3966,3966,3966,3966,3967,2021-05-11 15:00:00+00:00,Howard,460.0,187235,2083.0,148533,58.0,11364,518.0,2141.0,159897,198599,335768
3967,3967,3967,3967,3967,3967,3967,3967,3968,2021-05-12 15:00:00+00:00,Howard,890.0,188125,2404.0,150937,97.0,11461,987.0,2501.0,162398,199586,339062
3968,3968,3968,3968,3968,3968,3968,3968,3969,2021-05-13 15:00:00+00:00,Howard,1790.0,189915,2950.0,153887,53.0,11514,1843.0,3003.0,165401,201429,343802
3969,3969,3969,3969,3969,3969,3969,3969,3970,2021-05-14 15:00:00+00:00,Howard,1609.0,191524,1503.0,155390,117.0,11631,1726.0,1620.0,167021,203155,346914
3970,3970,3970,3970,3970,3970,3970,3970,3971,2021-05-15 15:00:00+00:00,Howard,1427.0,192951,1899.0,157289,71.0,11702,1498.0,1970.0,168991,204653,350240
3971,3971,3971,3971,3971,3971,3971,3971,3972,2021-05-16 15:00:00+00:00,Howard,767.0,193718,1074.0,158363,46.0,11748,813.0,1120.0,170111,205466,352081
3972,3972,3972,3972,3972,3972,3972,3972,3973,2021-05-17 15:00:00+00:00,Howard,1379.0,195097,1427.0,159790,70.0,11818,1449.0,1497.0,171608,206915,354887
3973,3973,3973,3973,3973,3973,3973,3973,3974,2021-05-18 15:00:00+00:00,Howard,1799.0,196896,1886.0,161676,76.0,11894,1875.0,1962.0,173570,208790,358572
3974,3974,3974,3974,3974,3974,3974,3974,3975,2021-05-19 15:00:00+00:00,Howard,1415.0,198311,1760.0,163436,77.0,11971,1492.0,1837.0,175407,210282,361747
3975,3975,3975,3975,3975,3975,3975,3975,3976,2021-05-20 15:00:00+00:00,Howard,1348.0,199659,2814.0,166250,63.0,12034,1411.0,2877.0,178284,211693,365909
3976,3976,3976,3976,3976,3976,3976,3976,3977,2021-05-21 15:00:00+00:00,Howard,1096.0,200755,2040.0,168290,67.0,12101,1163.0,2107.0,180391,212856,369045
3977,3977,3977,3977,3977,3977,3977,3977,3978,2021-05-22 15:00:00+00:00,Howard,1490.0,202245,2044.0,170334,47.0,12148,1537.0,2091.0,182482,214393,372579
3978,3978,3978,3978,3978,3978,3978,3978,3979,2021-05-23 15:00:00+00:00,Howard,795.0,203040,895.0,171229,33.0,12181,828.0,928.0,183410,215221,374269
3979,3979,3979,3979,3979,3979,3979,3979,3980,2021-05-24 15:00:00+00:00,Howard,558.0,203598,717.0,171946,54.0,12235,612.0,771.0,184181,215833,375544
3980,3980,3980,3980,3980,3980,3980,3980,3981,2021-05-25 15:00:00+00:00,Howard,465.0,204063,1117.0,173063,53.0,12288,518.0,1170.0,185351,216351,377126
3981,3981,3981,3981,3981,3981,3981,3981,3982,2021-05-26 15:00:00+00:00,Howard,1253.0,205316,2255.0,175318,40.0,12328,1293.0,2295.0,187646,217644,380634
3982,3982,3982,3982,3982,3982,3982,3982,3983,2021-05-27 15:00:00+00:00,Howard,576.0,205892,998.0,176316,31.0,12359,607.0,1029.0,188675,218251,382208
3983,3983,3983,3983,3983,3983,3983,3983,3984,2021-05-28 15:00:00+00:00,Howard,637.0,206529,984.0,177300,53.0,12412,690.0,1037.0,189712,218941,383829
3984,3984,3984,3984,3984,3984,3984,3984,3985,2021-05-29 15:00:00+00:00,Howard,451.0,206980,565.0,177865,37.0,12449,488.0,602.0,190314,219429,384845
3985,3985,3985,3985,3985,3985,3985,3985,3986,2021-05-30 15:00:00+00:00,Howard,344.0,207324,403.0,178268,13.0,12462,357.0,416.0,190730,219786,385592
3986,3986,3986,3986,3986,3986,3986,3986,3987,2021-05-31 15:00:00+00:00,Howard,74.0,207398,156.0,178424,10.0,12472,84.0,166.0,190896,219870,385822
3987,3987,3987,3987,3987,3987,3987,3987,3988,2021-06-01 15:00:00+00:00,Howard,401.0,207799,597.0,179021,59.0,12531,460.0,656.0,191552,220330,386820
3988,3988,3988,3988,3988,3988,3988,3988,3989,2021-06-02 15:00:00+00:00,Howard,810.0,208609,1108.0,180129,38.0,12569,848.0,1146.0,192698,221178,388738
3989,3989,3989,3989,3989,3989,3989,3989,3990,2021-06-03 15:00:00+00:00,Howard,305.0,208914,1638.0,181767,31.0,12600,336.0,1669.0,194367,221514,390681
3990,3990,3990,3990,3990,3990,3990,3990,3991,2021-06-04 15:00:00+00:00,Howard,388.0,209302,1560.0,183327,48.0,12648,436.0,1608.0,195975,221950,392629
3991,3991,3991,3991,3991,3991,3991,3991,3992,2021-06-05 15:00:00+00:00,Howard,327.0,209629,1429.0,184756,32.0,12680,359.0,1461.0,197436,222309,394385
3992,3992,3992,3992,3992,3992,3992,3992,3993,2021-06-06 15:00:00+00:00,Howard,206.0,209835,660.0,185416,33.0,12713,239.0,693.0,198129,222548,395251
3993,3993,3993,3993,3993,3993,3993,3993,3994,2021-06-07 15:00:00+00:00,Howard,325.0,210160,1356.0,186772,34.0,12747,359.0,1390.0,199519,222907,396932
3994,3994,3994,3994,3994,3994,3994,3994,3995,2021-06-08 15:00:00+00:00,Howard,304.0,210464,1682.0,188454,29.0,12776,333.0,1711.0,201230,223240,398918
3995,3995,3995,3995,3995,3995,3995,3995,3996,2021-06-09 15:00:00+00:00,Howard,416.0,210880,1351.0,189805,50.0,12826,466.0,1401.0,202631,223706,400685
3996,3996,3996,3996,3996,3996,3996,3996,3997,2021-06-10 15:00:00+00:00,Howard,284.0,211164,1252.0,191057,35.0,12861,319.0,1287.0,203918,224025,402221
3997,3997,3997,3997,3997,3997,3997,3997,3998,2021-06-11 15:00:00+00:00,Howard,341.0,211505,1110.0,192167,56.0,12917,397.0,1166.0,205084,224422,403672
3998,3998,3998,3998,3998,3998,3998,3998,3999,2021-06-12 15:00:00+00:00,Howard,322.0,211827,1359.0,193526,29.0,12946,351.0,1388.0,206472,224773,405353
3999,3999,3999,3999,3999,3999,3999,3999,4000,2021-06-13 15:00:00+00:00,Howard,126.0,211953,802.0,194328,35.0,12981,161.0,837.0,207309,224934,406281
4000,4000,4000,4000,4000,4000,4000,4000,4001,2021-06-14 15:00:00+00:00,Howard,245.0,212198,522.0,194850,38.0,13019,283.0,560.0,207869,225217,407048
4001,4001,4001,4001,4001,4001,4001,4001,4002,2021-06-15 15:00:00+00:00,Howard,224.0,212422,514.0,195364,17.0,13036,241.0,531.0,208400,225458,407786
4002,4002,4002,4002,4002,4002,4002,4002,4003,2021-06-16 15:00:00+00:00,Howard,272.0,212694,1236.0,196600,31.0,13067,303.0,1267.0,209667,225761,409294
4003,4003,4003,4003,4003,4003,4003,4003,4004,2021-06-17 15:00:00+00:00,Howard,311.0,213005,576.0,197176,21.0,13088,332.0,597.0,210264,226093,410181
4004,4004,4004,4004,4004,4004,4004,4004,4005,2021-06-18 15:00:00+00:00,Howard,284.0,213289,558.0,197734,21.0,13109,305.0,579.0,210843,226398,411023
4005,4005,4005,4005,4005,4005,4005,4005,4006,2021-06-19 15:00:00+00:00,Howard,268.0,213557,484.0,198218,14.0,13123,282.0,498.0,211341,226680,411775
4006,4006,4006,4006,4006,4006,4006,4006,4007,2021-06-20 15:00:00+00:00,Howard,134.0,213691,322.0,198540,10.0,13133,144.0,332.0,211673,226824,412231
4007,4007,4007,4007,4007,4007,4007,4007,4008,2021-06-21 15:00:00+00:00,Howard,205.0,213896,192.0,198732,18.0,13151,223.0,210.0,211883,227047,412628
4008,4008,4008,4008,4008,4008,4008,4008,4009,2021-06-22 15:00:00+00:00,Howard,248.0,214144,387.0,199119,23.0,13174,271.0,410.0,212293,227318,413263
4009,4009,4009,4009,4009,4009,4009,4009,4010,2021-06-23 15:00:00+00:00,Howard,254.0,214398,772.0,199891,26.0,13200,280.0,798.0,213091,227598,414289
4010,4010,4010,4010,4010,4010,4010,4010,4011,2021-06-24 15:00:00+00:00,Howard,241.0,214639,302.0,200193,38.0,13238,279.0,340.0,213431,227877,414832
4011,4011,4011,4011,4011,4011,4011,4011,4012,2021-06-25 15:00:00+00:00,Howard,255.0,214894,534.0,200727,25.0,13263,280.0,559.0,213990,228157,415621
4012,4012,4012,4012,4012,4012,4012,4012,4013,2021-06-26 15:00:00+00:00,Howard,180.0,215074,301.0,201028,15.0,13278,195.0,316.0,214306,228352,416102
4013,4013,4013,4013,4013,4013,4013,4013,4014,2021-06-27 15:00:00+00:00,Howard,164.0,215238,157.0,201185,15.0,13293,179.0,172.0,214478,228531,416423
4014,4014,4014,4014,4014,4014,4014,4014,4015,2021-06-28 15:00:00+00:00,Howard,197.0,215435,293.0,201478,21.0,13314,218.0,314.0,214792,228749,416913
4015,4015,4015,4015,4015,4015,4015,4015,4016,2021-06-29 15:00:00+00:00,Howard,212.0,215647,331.0,201809,22.0,13336,234.0,353.0,215145,228983,417456
4016,4016,4016,4016,4016,4016,4016,4016,4017,2021-06-30 15:00:00+00:00,Howard,285.0,215932,412.0,202221,34.0,13370,319.0,446.0,215591,229302,418153
4017,4017,4017,4017,4017,4017,4017,4017,4018,2021-07-01 15:00:00+00:00,Howard,254.0,216186,352.0,202573,16.0,13386,270.0,368.0,215959,229572,418759
4018,4018,4018,4018,4018,4018,4018,4018,4019,2021-07-02 15:00:00+00:00,Howard,212.0,216398,302.0,202875,11.0,13397,223.0,313.0,216272,229795,419273
4019,4019,4019,4019,4019,4019,4019,4019,4020,2021-07-03 15:00:00+00:00,Howard,145.0,216543,230.0,203105,10.0,13407,155.0,240.0,216512,229950,419648
4020,4020,4020,4020,4020,4020,4020,4020,4021,2021-07-04 15:00:00+00:00,Howard,20.0,216563,29.0,203134,8.0,13415,28.0,37.0,216549,229978,419697
4021,4021,4021,4021,4021,4021,4021,4021,4022,2021-07-05 15:00:00+00:00,Howard,185.0,216748,168.0,203302,14.0,13429,199.0,182.0,216731,230177,420050
4022,4022,4022,4022,4022,4022,4022,4022,4023,2021-07-06 15:00:00+00:00,Howard,224.0,216972,324.0,203626,19.0,13448,243.0,343.0,217074,230420,420598
4023,4023,4023,4023,4023,4023,4023,4023,4024,2021-07-07 15:00:00+00:00,Howard,186.0,217158,294.0,203920,11.0,13459,197.0,305.0,217379,230617,421078
4024,4024,4024,4024,4024,4024,4024,4024,4025,2021-07-08 15:00:00+00:00,Howard,178.0,217336,268.0,204188,25.0,13484,203.0,293.0,217672,230820,421524
4025,4025,4025,4025,4025,4025,4025,4025,4026,2021-07-09 15:00:00+00:00,Howard,195.0,217531,257.0,204445,21.0,13505,216.0,278.0,217950,231036,421976
4026,4026,4026,4026,4026,4026,4026,4026,4027,2021-07-10 15:00:00+00:00,Howard,159.0,217690,265.0,204710,5.0,13510,164.0,270.0,218220,231200,422400
4027,4027,4027,4027,4027,4027,4027,4027,4028,2021-07-11 15:00:00+00:00,Howard,87.0,217777,119.0,204829,14.0,13524,101.0,133.0,218353,231301,422606
4028,4028,4028,4028,4028,4028,4028,4028,4029,2021-07-12 15:00:00+00:00,Howard,186.0,217963,206.0,205035,11.0,13535,197.0,217.0,218570,231498,422998
4029,4029,4029,4029,4029,4029,4029,4029,4030,2021-07-13 15:00:00+00:00,Howard,195.0,218158,259.0,205294,16.0,13551,211.0,275.0,218845,231709,423452
4030,4030,4030,4030,4030,4030,4030,4030,4031,2021-07-14 15:00:00+00:00,Howard,201.0,218359,234.0,205528,13.0,13564,214.0,247.0,219092,231923,423887
4031,4031,4031,4031,4031,4031,4031,4031,4032,2021-07-15 15:00:00+00:00,Howard,188.0,218547,224.0,205752,13.0,13577,201.0,237.0,219329,232124,424299
4032,4032,4032,4032,4032,4032,4032,4032,4033,2021-07-16 15:00:00+00:00,Howard,192.0,218739,224.0,205976,6.0,13583,198.0,230.0,219559,232322,424715
4033,4033,4033,4033,4033,4033,4033,4033,4034,2021-07-17 15:00:00+00:00,Howard,183.0,218922,183.0,206159,15.0,13598,198.0,198.0,219757,232520,425081
4034,4034,4034,4034,4034,4034,4034,4034,4035,2021-07-18 15:00:00+00:00,Howard,73.0,218995,121.0,206280,3.0,13601,76.0,124.0,219881,232596,425275
4035,4035,4035,4035,4035,4035,4035,4035,4036,2021-07-19 15:00:00+00:00,Howard,188.0,219183,178.0,206458,7.0,13608,195.0,185.0,220066,232791,425641
4036,4036,4036,4036,4036,4036,4036,4036,4037,2021-07-20 15:00:00+00:00,Howard,218.0,219401,224.0,206682,7.0,13615,225.0,231.0,220297,233016,426083
4037,4037,4037,4037,4037,4037,4037,4037,4038,2021-07-21 15:00:00+00:00,Howard,198.0,219599,245.0,206927,13.0,13628,211.0,258.0,220555,233227,426526
4038,4038,4038,4038,4038,4038,4038,4038,4039,2021-07-22 15:00:00+00:00,Howard,256.0,219855,252.0,207179,10.0,13638,266.0,262.0,220817,233493,427034
4039,4039,4039,4039,4039,4039,4039,4039,4040,2021-07-23 15:00:00+00:00,Howard,261.0,220116,178.0,207357,18.0,13656,279.0,196.0,221013,233772,427473
4040,4040,4040,4040,4040,4040,4040,4040,4041,2021-07-24 15:00:00+00:00,Howard,173.0,220289,154.0,207511,7.0,13663,180.0,161.0,221174,233952,427800
4041,4041,4041,4041,4041,4041,4041,4041,4042,2021-07-25 15:00:00+00:00,Howard,123.0,220412,58.0,207569,3.0,13666,126.0,61.0,221235,234078,427981
4042,4042,4042,4042,4042,4042,4042,4042,4043,2021-07-26 15:00:00+00:00,Howard,208.0,220620,189.0,207758,24.0,13690,232.0,213.0,221448,234310,428378
4043,4043,4043,4043,4043,4043,4043,4043,4044,2021-07-27 15:00:00+00:00,Howard,263.0,220883,231.0,207989,21.0,13711,284.0,252.0,221700,234594,428872
4044,4044,4044,4044,4044,4044,4044,4044,4045,2021-07-28 15:00:00+00:00,Howard,255.0,221138,192.0,208181,15.0,13726,270.0,207.0,221907,234864,429319
4045,4045,4045,4045,4045,4045,4045,4045,4046,2021-07-29 15:00:00+00:00,Howard,236.0,221374,171.0,208352,12.0,13738,248.0,183.0,222090,235112,429726
4046,4046,4046,4046,4046,4046,4046,4046,4047,2021-07-30 15:00:00+00:00,Howard,266.0,221640,196.0,208548,14.0,13752,280.0,210.0,222300,235392,430188
4047,4047,4047,4047,4047,4047,4047,4047,4048,2021-07-31 15:00:00+00:00,Howard,260.0,221900,191.0,208739,13.0,13765,273.0,204.0,222504,235665,430639
4048,4048,4048,4048,4048,4048,4048,4048,4049,2021-08-01 15:00:00+00:00,Howard,151.0,222051,71.0,208810,5.0,13770,156.0,76.0,222580,235821,430861
4049,4049,4049,4049,4049,4049,4049,4049,4050,2021-08-02 15:00:00+00:00,Howard,287.0,222338,191.0,209001,21.0,13791,308.0,212.0,222792,236129,431339
4050,4050,4050,4050,4050,4050,4050,4050,4051,2021-08-03 15:00:00+00:00,Howard,321.0,222659,180.0,209181,28.0,13819,349.0,208.0,223000,236478,431840
4051,4051,4051,4051,4051,4051,4051,4051,4052,2021-08-04 15:00:00+00:00,Howard,271.0,222930,141.0,209322,17.0,13836,288.0,158.0,223158,236766,432252
4052,4052,4052,4052,4052,4052,4052,4052,4053,2021-08-05 15:00:00+00:00,Howard,262.0,223192,151.0,209473,21.0,13857,283.0,172.0,223330,237049,432665
4053,4053,4053,4053,4053,4053,4053,4053,4054,2021-08-06 15:00:00+00:00,Howard,299.0,223491,185.0,209658,6.0,13863,305.0,191.0,223521,237354,433149
4054,4054,4054,4054,4054,4054,4054,4054,4055,2021-08-07 15:00:00+00:00,Howard,254.0,223745,126.0,209784,18.0,13881,272.0,144.0,223665,237626,433529
4055,4055,4055,4055,4055,4055,4055,4055,4056,2021-08-08 15:00:00+00:00,Howard,151.0,223896,77.0,209861,7.0,13888,158.0,84.0,223749,237784,433757
4056,4056,4056,4056,4056,4056,4056,4056,4057,2021-08-09 15:00:00+00:00,Howard,249.0,224145,164.0,210025,14.0,13902,263.0,178.0,223927,238047,434170
4057,4057,4057,4057,4057,4057,4057,4057,4058,2021-08-10 15:00:00+00:00,Howard,271.0,224416,183.0,210208,10.0,13912,281.0,193.0,224120,238328,434624
4058,4058,4058,4058,4058,4058,4058,4058,4059,2021-08-11 15:00:00+00:00,Howard,210.0,224626,188.0,210396,15.0,13927,225.0,203.0,224323,238553,435022
4059,4059,4059,4059,4059,4059,4059,4059,4060,2021-08-12 15:00:00+00:00,Howard,240.0,224866,173.0,210569,20.0,13947,260.0,193.0,224516,238813,435435
4060,4060,4060,4060,4060,4060,4060,4060,4061,2021-08-13 15:00:00+00:00,Howard,216.0,225082,189.0,210758,15.0,13962,231.0,204.0,224720,239044,435840
4061,4061,4061,4061,4061,4061,4061,4061,4062,2021-08-14 15:00:00+00:00,Howard,194.0,225276,140.0,210898,6.0,13968,200.0,146.0,224866,239244,436174
4062,4062,4062,4062,4062,4062,4062,4062,4063,2021-08-15 15:00:00+00:00,Howard,94.0,225370,129.0,211027,3.0,13971,97.0,132.0,224998,239341,436397
4063,4063,4063,4063,4063,4063,4063,4063,4064,2021-08-16 15:00:00+00:00,Howard,201.0,225571,211.0,211238,14.0,13985,215.0,225.0,225223,239556,436809
4064,4064,4064,4064,4064,4064,4064,4064,4065,2021-08-17 15:00:00+00:00,Howard,254.0,225825,221.0,211459,33.0,14018,287.0,254.0,225477,239843,437284
4065,4065,4065,4065,4065,4065,4065,4065,4066,2021-08-18 15:00:00+00:00,Howard,235.0,226060,210.0,211669,20.0,14038,255.0,230.0,225707,240098,437729
4066,4066,4066,4066,4066,4066,4066,4066,4067,2021-08-19 15:00:00+00:00,Howard,247.0,226307,246.0,211915,19.0,14057,266.0,265.0,225972,240364,438222
4067,4067,4067,4067,4067,4067,4067,4067,4068,2021-08-20 15:00:00+00:00,Howard,209.0,226516,229.0,212144,14.0,14071,223.0,243.0,226215,240587,438660
4068,4068,4068,4068,4068,4068,4068,4068,4069,2021-08-21 15:00:00+00:00,Howard,169.0,226685,202.0,212346,16.0,14087,185.0,218.0,226433,240772,439031
4069,4069,4069,4069,4069,4069,4069,4069,4070,2021-08-22 15:00:00+00:00,Howard,99.0,226784,115.0,212461,2.0,14089,101.0,117.0,226550,240873,439245
4070,4070,4070,4070,4070,4070,4070,4070,4071,2021-08-23 15:00:00+00:00,Howard,210.0,226994,262.0,212723,17.0,14106,227.0,279.0,226829,241100,439717
4071,4071,4071,4071,4071,4071,4071,4071,4072,2021-08-24 15:00:00+00:00,Howard,272.0,227266,265.0,212988,12.0,14118,284.0,277.0,227106,241384,440254
4072,4072,4072,4072,4072,4072,4072,4072,4073,2021-08-25 15:00:00+00:00,Howard,229.0,227495,238.0,213226,5.0,14123,234.0,243.0,227349,241618,440721
4073,4073,4073,4073,4073,4073,4073,4073,4074,2021-08-26 15:00:00+00:00,Howard,314.0,227809,225.0,213451,12.0,14135,326.0,237.0,227586,241944,441260
4074,4074,4074,4074,4074,4074,4074,4074,4075,2021-08-27 15:00:00+00:00,Howard,225.0,228034,252.0,213703,7.0,14142,232.0,259.0,227845,242176,441737
4075,4075,4075,4075,4075,4075,4075,4075,4076,2021-08-28 15:00:00+00:00,Howard,214.0,228248,190.0,213893,3.0,14145,217.0,193.0,228038,242393,442141
4076,4076,4076,4076,4076,4076,4076,4076,4077,2021-08-29 15:00:00+00:00,Howard,163.0,228411,153.0,214046,3.0,14148,166.0,156.0,228194,242559,442457
4077,4077,4077,4077,4077,4077,4077,4077,4078,2021-08-30 15:00:00+00:00,Howard,177.0,228588,229.0,214275,12.0,14160,189.0,241.0,228435,242748,442863
4078,4078,4078,4078,4078,4078,4078,4078,4079,2021-08-31 15:00:00+00:00,Howard,200.0,228788,256.0,214531,21.0,14181,221.0,277.0,228712,242969,443319
4079,4079,4079,4079,4079,4079,4079,4079,4080,2021-09-01 15:00:00+00:00,Howard,154.0,228942,197.0,214728,8.0,14189,162.0,205.0,228917,243131,443670
4080,4080,4080,4080,4080,4080,4080,4080,4081,2021-09-02 15:00:00+00:00,Howard,182.0,229124,227.0,214955,17.0,14206,199.0,244.0,229161,243330,444079
4081,4081,4081,4081,4081,4081,4081,4081,4082,2021-09-03 15:00:00+00:00,Howard,166.0,229290,230.0,215185,16.0,14222,182.0,246.0,229407,243512,444475
4082,4082,4082,4082,4082,4082,4082,4082,4083,2021-09-04 15:00:00+00:00,Howard,130.0,229420,175.0,215360,8.0,14230,138.0,183.0,229590,243650,444780
4083,4083,4083,4083,4083,4083,4083,4083,4084,2021-09-05 15:00:00+00:00,Howard,93.0,229513,99.0,215459,1.0,14231,94.0,100.0,229690,243744,444972
4084,4084,4084,4084,4084,4084,4084,4084,4085,2021-09-06 15:00:00+00:00,Howard,47.0,229560,55.0,215514,2.0,14233,49.0,57.0,229747,243793,445074
4085,4085,4085,4085,4085,4085,4085,4085,4086,2021-09-07 15:00:00+00:00,Howard,175.0,229735,272.0,215786,25.0,14258,200.0,297.0,230044,243993,445521
4086,4086,4086,4086,4086,4086,4086,4086,4087,2021-09-08 15:00:00+00:00,Howard,172.0,229907,193.0,215979,8.0,14266,180.0,201.0,230245,244173,445886
4087,4087,4087,4087,4087,4087,4087,4087,4088,2021-09-09 15:00:00+00:00,Howard,147.0,230054,193.0,216172,12.0,14278,159.0,205.0,230450,244332,446226
4088,4088,4088,4088,4088,4088,4088,4088,4089,2021-09-10 15:00:00+00:00,Howard,161.0,230215,196.0,216368,10.0,14288,171.0,206.0,230656,244503,446583
4089,4089,4089,4089,4089,4089,4089,4089,4090,2021-09-11 15:00:00+00:00,Howard,167.0,230382,171.0,216539,15.0,14303,182.0,186.0,230842,244685,446921
4090,4090,4090,4090,4090,4090,4090,4090,4091,2021-09-12 15:00:00+00:00,Howard,87.0,230469,86.0,216625,1.0,14304,88.0,87.0,230929,244773,447094
4091,4091,4091,4091,4091,4091,4091,4091,4092,2021-09-13 15:00:00+00:00,Howard,126.0,230595,173.0,216798,13.0,14317,139.0,186.0,231115,244912,447393
4092,4092,4092,4092,4092,4092,4092,4092,4093,2021-09-14 15:00:00+00:00,Howard,150.0,230745,200.0,216998,12.0,14329,162.0,212.0,231327,245074,447743
4093,4093,4093,4093,4093,4093,4093,4093,4094,2021-09-15 15:00:00+00:00,Howard,124.0,230869,194.0,217192,15.0,14344,139.0,209.0,231536,245213,448061
4094,4094,4094,4094,4094,4094,4094,4094,4095,2021-09-16 15:00:00+00:00,Howard,156.0,231025,220.0,217412,25.0,14369,181.0,245.0,231781,245394,448437
4095,4095,4095,4095,4095,4095,4095,4095,4096,2021-09-17 15:00:00+00:00,Howard,148.0,231173,227.0,217639,6.0,14375,154.0,233.0,232014,245548,448812
4096,4096,4096,4096,4096,4096,4096,4096,4097,2021-09-18 15:00:00+00:00,Howard,158.0,231331,205.0,217844,4.0,14379,162.0,209.0,232223,245710,449175
4097,4097,4097,4097,4097,4097,4097,4097,4098,2021-09-19 15:00:00+00:00,Howard,105.0,231436,144.0,217988,2.0,14381,107.0,146.0,232369,245817,449424
4098,4098,4098,4098,4098,4098,4098,4098,4099,2021-09-20 15:00:00+00:00,Howard,110.0,231546,140.0,218128,12.0,14393,122.0,152.0,232521,245939,449674
4099,4099,4099,4099,4099,4099,4099,4099,4100,2021-09-21 15:00:00+00:00,Howard,128.0,231674,139.0,218267,16.0,14409,144.0,155.0,232676,246083,449941
4100,4100,4100,4100,4100,4100,4100,4100,4101,2021-09-22 15:00:00+00:00,Howard,118.0,231792,173.0,218440,11.0,14420,129.0,184.0,232860,246212,450232
4101,4101,4101,4101,4101,4101,4101,4101,4102,2021-09-23 15:00:00+00:00,Howard,107.0,231899,143.0,218583,3.0,14423,110.0,146.0,233006,246322,450482
4102,4102,4102,4102,4102,4102,4102,4102,4103,2021-09-24 15:00:00+00:00,Howard,143.0,232042,150.0,218733,11.0,14434,154.0,161.0,233167,246476,450775
4103,4103,4103,4103,4103,4103,4103,4103,4104,2021-09-25 15:00:00+00:00,Howard,115.0,232157,174.0,218907,1.0,14435,116.0,175.0,233342,246592,451064
4104,4104,4104,4104,4104,4104,4104,4104,4105,2021-09-26 15:00:00+00:00,Howard,71.0,232228,94.0,219001,,14435,,,233436,246663,451229
4105,4105,4105,4105,4105,4105,4105,4105,4106,2021-09-27 15:00:00+00:00,Howard,174.0,232402,98.0,219099,9.0,14444,183.0,107.0,233543,246846,451501
4106,4106,4106,4106,4106,4106,4106,4106,4107,2021-09-28 15:00:00+00:00,Howard,132.0,232534,138.0,219237,5.0,14449,137.0,143.0,233686,246983,451771
4107,4107,4107,4107,4107,4107,4107,4107,4108,2021-09-29 15:00:00+00:00,Howard,125.0,232659,142.0,219379,12.0,14461,137.0,154.0,233840,247120,452038
4108,4108,4108,4108,4108,4108,4108,4108,4109,2021-09-30 15:00:00+00:00,Howard,140.0,232799,142.0,219521,16.0,14477,156.0,158.0,233998,247276,452320
4109,4109,4109,4109,4109,4109,4109,4109,4110,2021-10-01 15:00:00+00:00,Howard,154.0,232953,174.0,219695,11.0,14488,165.0,185.0,234183,247441,452648
4110,4110,4110,4110,4110,4110,4110,4110,4111,2021-10-02 15:00:00+00:00,Howard,102.0,233055,128.0,219823,7.0,14495,109.0,135.0,234318,247550,452878
4111,4111,4111,4111,4111,4111,4111,4111,4112,2021-10-03 15:00:00+00:00,Howard,57.0,233112,71.0,219894,1.0,14496,58.0,72.0,234390,247608,453006
4112,4112,4112,4112,4112,4112,4112,4112,4113,2021-10-04 15:00:00+00:00,Howard,113.0,233225,123.0,220017,5.0,14501,118.0,128.0,234518,247726,453242
4113,4113,4113,4113,4113,4113,4113,4113,4114,2021-10-05 15:00:00+00:00,Howard,167.0,233392,126.0,220143,9.0,14510,176.0,135.0,234653,247902,453535
4114,4114,4114,4114,4114,4114,4114,4114,4115,2021-10-06 15:00:00+00:00,Howard,108.0,233500,104.0,220247,8.0,14518,116.0,112.0,234765,248018,453747
4115,4115,4115,4115,4115,4115,4115,4115,4116,2021-10-07 15:00:00+00:00,Howard,148.0,233648,102.0,220349,10.0,14528,158.0,112.0,234877,248176,453997
4116,4116,4116,4116,4116,4116,4116,4116,4117,2021-10-08 15:00:00+00:00,Howard,190.0,233838,147.0,220496,9.0,14537,199.0,156.0,235033,248375,454334
4117,4117,4117,4117,4117,4117,4117,4117,4118,2021-10-09 15:00:00+00:00,Howard,104.0,233942,103.0,220599,4.0,14541,108.0,107.0,235140,248483,454541
4118,4118,4118,4118,4118,4118,4118,4118,4119,2021-10-10 15:00:00+00:00,Howard,78.0,234020,73.0,220672,,14541,,,235213,248561,454692
4119,4119,4119,4119,4119,4119,4119,4119,4120,2021-10-11 15:00:00+00:00,Howard,141.0,234161,112.0,220784,8.0,14549,149.0,120.0,235333,248710,454945
4120,4120,4120,4120,4120,4120,4120,4120,4121,2021-10-12 15:00:00+00:00,Howard,130.0,234291,114.0,220898,7.0,14556,137.0,121.0,235454,248847,455189
4121,4121,4121,4121,4121,4121,4121,4121,4122,2021-10-13 15:00:00+00:00,Howard,123.0,234414,135.0,221033,17.0,14573,140.0,152.0,235606,248987,455447
4122,4122,4122,4122,4122,4122,4122,4122,4123,2021-10-14 15:00:00+00:00,Howard,129.0,234543,106.0,221139,9.0,14582,138.0,115.0,235721,249125,455682
4123,4123,4123,4123,4123,4123,4123,4123,4124,2021-10-15 15:00:00+00:00,Howard,170.0,234713,130.0,221269,14.0,14596,184.0,144.0,235865,249309,455982
4124,4124,4124,4124,4124,4124,4124,4124,4125,2021-10-16 15:00:00+00:00,Howard,71.0,234784,116.0,221385,3.0,14599,74.0,119.0,235984,249383,456169
4125,4125,4125,4125,4125,4125,4125,4125,4126,2021-10-17 15:00:00+00:00,Howard,66.0,234850,78.0,221463,,14599,,,236062,249449,456313
4126,4126,4126,4126,4126,4126,4126,4126,4127,2021-10-18 15:00:00+00:00,Howard,146.0,234996,110.0,221573,12.0,14611,158.0,122.0,236184,249607,456569
4127,4127,4127,4127,4127,4127,4127,4127,4128,2021-10-19 15:00:00+00:00,Howard,97.0,235093,109.0,221682,2.0,14613,99.0,111.0,236295,249706,456775
4128,4128,4128,4128,4128,4128,4128,4128,4129,2021-10-20 15:00:00+00:00,Howard,123.0,235216,92.0,221774,8.0,14621,131.0,100.0,236395,249837,456990
4129,4129,4129,4129,4129,4129,4129,4129,4130,2021-10-21 15:00:00+00:00,Howard,90.0,235306,88.0,221862,11.0,14632,101.0,99.0,236494,249938,457168
4130,4130,4130,4130,4130,4130,4130,4130,4131,2021-10-22 15:00:00+00:00,Howard,150.0,235456,262.0,222124,8.0,14640,158.0,270.0,236764,250096,457580
4131,4131,4131,4131,4131,4131,4131,4131,4132,2021-10-23 15:00:00+00:00,Howard,123.0,235579,143.0,222267,6.0,14646,129.0,149.0,236913,250225,457846
4132,4132,4132,4132,4132,4132,4132,4132,4133,2021-10-24 15:00:00+00:00,Howard,55.0,235634,114.0,222381,1.0,14647,56.0,115.0,237028,250281,458015
4133,4133,4133,4133,4133,4133,4133,4133,4134,2021-10-25 15:00:00+00:00,Howard,147.0,235781,352.0,222733,13.0,14660,160.0,365.0,237393,250441,458514
4134,4134,4134,4134,4134,4134,4134,4134,4135,2021-10-26 15:00:00+00:00,Howard,162.0,235943,280.0,223013,4.0,14664,166.0,284.0,237677,250607,458956
4135,4135,4135,4135,4135,4135,4135,4135,4136,2021-10-27 15:00:00+00:00,Howard,159.0,236102,326.0,223339,23.0,14687,182.0,349.0,238026,250789,459441
4136,4136,4136,4136,4136,4136,4136,4136,4137,2021-10-28 15:00:00+00:00,Howard,134.0,236236,267.0,223606,2.0,14689,136.0,269.0,238295,250925,459842
4137,4137,4137,4137,4137,4137,4137,4137,4138,2021-10-29 15:00:00+00:00,Howard,208.0,236444,342.0,223948,14.0,14703,222.0,356.0,238651,251147,460392
4138,4138,4138,4138,4138,4138,4138,4138,4139,2021-10-30 15:00:00+00:00,Howard,122.0,236566,200.0,224148,9.0,14712,131.0,209.0,238860,251278,460714
4139,4139,4139,4139,4139,4139,4139,4139,4140,2021-10-31 15:00:00+00:00,Howard,67.0,236633,120.0,224268,2.0,14714,69.0,122.0,238982,251347,460901
4140,4140,4140,4140,4140,4140,4140,4140,4141,2021-11-01 15:00:00+00:00,Howard,169.0,236802,299.0,224567,17.0,14731,186.0,316.0,239298,251533,461369
4141,4141,4141,4141,4141,4141,4141,4141,4142,2021-11-02 15:00:00+00:00,Howard,135.0,236937,277.0,224844,13.0,14744,148.0,290.0,239588,251681,461781
4142,4142,4142,4142,4142,4142,4142,4142,4143,2021-11-03 15:00:00+00:00,Howard,141.0,237078,263.0,225107,24.0,14768,165.0,287.0,239875,251846,462185
4143,4143,4143,4143,4143,4143,4143,4143,4144,2021-11-04 15:00:00+00:00,Howard,146.0,237224,265.0,225372,12.0,14780,158.0,277.0,240152,252004,462596
4144,4144,4144,4144,4144,4144,4144,4144,4145,2021-11-05 15:00:00+00:00,Howard,152.0,237376,284.0,225656,14.0,14794,166.0,298.0,240450,252170,463032
4145,4145,4145,4145,4145,4145,4145,4145,4146,2021-11-06 15:00:00+00:00,Howard,29.0,237405,59.0,225715,6.0,14800,35.0,65.0,240515,252205,463120
4146,4146,4146,4146,4146,4146,4146,4146,4147,2020-12-15 15:00:00+00:00,Queen Anne's,1.0,1,,0,,0,,,0,1,1
4147,4147,4147,4147,4147,4147,4147,4147,4148,2020-12-16 15:00:00+00:00,Queen Anne's,4.0,5,,0,,0,,,0,5,5
4148,4148,4148,4148,4148,4148,4148,4148,4149,2020-12-17 15:00:00+00:00,Queen Anne's,10.0,15,,0,,0,,,0,15,15
4149,4149,4149,4149,4149,4149,4149,4149,4150,2020-12-18 15:00:00+00:00,Queen Anne's,17.0,32,,0,,0,,,0,32,32
4150,4150,4150,4150,4150,4150,4150,4150,4151,2020-12-19 15:00:00+00:00,Queen Anne's,3.0,35,,0,,0,,,0,35,35
4151,4151,4151,4151,4151,4151,4151,4151,4152,2020-12-21 15:00:00+00:00,Queen Anne's,25.0,60,,0,,0,,,0,60,60
4152,4152,4152,4152,4152,4152,4152,4152,4153,2020-12-22 15:00:00+00:00,Queen Anne's,106.0,166,,0,,0,,,0,166,166
4153,4153,4153,4153,4153,4153,4153,4153,4154,2020-12-23 15:00:00+00:00,Queen Anne's,38.0,204,,0,,0,,,0,204,204
4154,4154,4154,4154,4154,4154,4154,4154,4155,2020-12-24 15:00:00+00:00,Queen Anne's,11.0,215,,0,,0,,,0,215,215
4155,4155,4155,4155,4155,4155,4155,4155,4156,2020-12-26 15:00:00+00:00,Queen Anne's,14.0,229,,0,,0,,,0,229,229
4156,4156,4156,4156,4156,4156,4156,4156,4157,2020-12-27 15:00:00+00:00,Queen Anne's,5.0,234,,0,,0,,,0,234,234
4157,4157,4157,4157,4157,4157,4157,4157,4158,2020-12-28 15:00:00+00:00,Queen Anne's,59.0,293,,0,,0,,,0,293,293
4158,4158,4158,4158,4158,4158,4158,4158,4159,2020-12-29 15:00:00+00:00,Queen Anne's,93.0,386,,0,,0,,,0,386,386
4159,4159,4159,4159,4159,4159,4159,4159,4160,2020-12-30 15:00:00+00:00,Queen Anne's,107.0,493,2.0,2,,0,,,2,493,495
4160,4160,4160,4160,4160,4160,4160,4160,4161,2020-12-31 15:00:00+00:00,Queen Anne's,82.0,575,,2,,0,,,2,575,577
4161,4161,4161,4161,4161,4161,4161,4161,4162,2021-01-01 15:00:00+00:00,Queen Anne's,2.0,577,,2,,0,,,2,577,579
4162,4162,4162,4162,4162,4162,4162,4162,4163,2021-01-02 15:00:00+00:00,Queen Anne's,15.0,592,,2,,0,,,2,592,594
4163,4163,4163,4163,4163,4163,4163,4163,4164,2021-01-03 15:00:00+00:00,Queen Anne's,27.0,619,,2,,0,,,2,619,621
4164,4164,4164,4164,4164,4164,4164,4164,4165,2021-01-04 15:00:00+00:00,Queen Anne's,253.0,872,,2,,0,,,2,872,874
4165,4165,4165,4165,4165,4165,4165,4165,4166,2021-01-05 15:00:00+00:00,Queen Anne's,106.0,978,3.0,5,,0,,,5,978,983
4166,4166,4166,4166,4166,4166,4166,4166,4167,2021-01-06 15:00:00+00:00,Queen Anne's,260.0,1238,4.0,9,,0,,,9,1238,1247
4167,4167,4167,4167,4167,4167,4167,4167,4168,2021-01-07 15:00:00+00:00,Queen Anne's,117.0,1355,11.0,20,,0,,,20,1355,1375
4168,4168,4168,4168,4168,4168,4168,4168,4169,2021-01-08 15:00:00+00:00,Queen Anne's,330.0,1685,17.0,37,,0,,,37,1685,1722
4169,4169,4169,4169,4169,4169,4169,4169,4170,2021-01-09 15:00:00+00:00,Queen Anne's,19.0,1704,4.0,41,,0,,,41,1704,1745
4170,4170,4170,4170,4170,4170,4170,4170,4171,2021-01-10 15:00:00+00:00,Queen Anne's,9.0,1713,1.0,42,,0,,,42,1713,1755
4171,4171,4171,4171,4171,4171,4171,4171,4172,2021-01-11 15:00:00+00:00,Queen Anne's,186.0,1899,27.0,69,,0,,,69,1899,1968
4172,4172,4172,4172,4172,4172,4172,4172,4173,2021-01-12 15:00:00+00:00,Queen Anne's,131.0,2030,82.0,151,,0,,,151,2030,2181
4173,4173,4173,4173,4173,4173,4173,4173,4174,2021-01-13 15:00:00+00:00,Queen Anne's,241.0,2271,18.0,169,,0,,,169,2271,2440
4174,4174,4174,4174,4174,4174,4174,4174,4175,2021-01-14 15:00:00+00:00,Queen Anne's,99.0,2370,15.0,184,,0,,,184,2370,2554
4175,4175,4175,4175,4175,4175,4175,4175,4176,2021-01-15 15:00:00+00:00,Queen Anne's,389.0,2759,9.0,193,,0,,,193,2759,2952
4176,4176,4176,4176,4176,4176,4176,4176,4177,2021-01-16 15:00:00+00:00,Queen Anne's,32.0,2791,12.0,205,,0,,,205,2791,2996
4177,4177,4177,4177,4177,4177,4177,4177,4178,2021-01-17 15:00:00+00:00,Queen Anne's,10.0,2801,5.0,210,,0,,,210,2801,3011
4178,4178,4178,4178,4178,4178,4178,4178,4179,2021-01-18 15:00:00+00:00,Queen Anne's,42.0,2843,30.0,240,,0,,,240,2843,3083
4179,4179,4179,4179,4179,4179,4179,4179,4180,2021-01-19 15:00:00+00:00,Queen Anne's,145.0,2988,35.0,275,,0,,,275,2988,3263
4180,4180,4180,4180,4180,4180,4180,4180,4181,2021-01-20 15:00:00+00:00,Queen Anne's,155.0,3143,46.0,321,,0,,,321,3143,3464
4181,4181,4181,4181,4181,4181,4181,4181,4182,2021-01-21 15:00:00+00:00,Queen Anne's,119.0,3262,27.0,348,,0,,,348,3262,3610
4182,4182,4182,4182,4182,4182,4182,4182,4183,2021-01-22 15:00:00+00:00,Queen Anne's,554.0,3816,17.0,365,,0,,,365,3816,4181
4183,4183,4183,4183,4183,4183,4183,4183,4184,2021-01-23 15:00:00+00:00,Queen Anne's,18.0,3834,14.0,379,,0,,,379,3834,4213
4184,4184,4184,4184,4184,4184,4184,4184,4185,2021-01-24 15:00:00+00:00,Queen Anne's,8.0,3842,16.0,395,,0,,,395,3842,4237
4185,4185,4185,4185,4185,4185,4185,4185,4186,2021-01-25 15:00:00+00:00,Queen Anne's,75.0,3917,38.0,433,,0,,,433,3917,4350
4186,4186,4186,4186,4186,4186,4186,4186,4187,2021-01-26 15:00:00+00:00,Queen Anne's,157.0,4074,114.0,547,,0,,,547,4074,4621
4187,4187,4187,4187,4187,4187,4187,4187,4188,2021-01-27 15:00:00+00:00,Queen Anne's,176.0,4250,88.0,635,,0,,,635,4250,4885
4188,4188,4188,4188,4188,4188,4188,4188,4189,2021-01-28 15:00:00+00:00,Queen Anne's,182.0,4432,89.0,724,,0,,,724,4432,5156
4189,4189,4189,4189,4189,4189,4189,4189,4190,2021-01-29 15:00:00+00:00,Queen Anne's,129.0,4561,58.0,782,,0,,,782,4561,5343
4190,4190,4190,4190,4190,4190,4190,4190,4191,2021-01-30 15:00:00+00:00,Queen Anne's,25.0,4586,3.0,785,,0,,,785,4586,5371
4191,4191,4191,4191,4191,4191,4191,4191,4192,2021-01-31 15:00:00+00:00,Queen Anne's,10.0,4596,4.0,789,,0,,,789,4596,5385
4192,4192,4192,4192,4192,4192,4192,4192,4193,2021-02-01 15:00:00+00:00,Queen Anne's,26.0,4622,168.0,957,,0,,,957,4622,5579
4193,4193,4193,4193,4193,4193,4193,4193,4194,2021-02-02 15:00:00+00:00,Queen Anne's,54.0,4676,142.0,1099,,0,,,1099,4676,5775
4194,4194,4194,4194,4194,4194,4194,4194,4195,2021-02-03 15:00:00+00:00,Queen Anne's,219.0,4895,269.0,1368,,0,,,1368,4895,6263
4195,4195,4195,4195,4195,4195,4195,4195,4196,2021-02-04 15:00:00+00:00,Queen Anne's,145.0,5040,188.0,1556,,0,,,1556,5040,6596
4196,4196,4196,4196,4196,4196,4196,4196,4197,2021-02-05 15:00:00+00:00,Queen Anne's,352.0,5392,307.0,1863,,0,,,1863,5392,7255
4197,4197,4197,4197,4197,4197,4197,4197,4198,2021-02-06 15:00:00+00:00,Queen Anne's,59.0,5451,28.0,1891,,0,,,1891,5451,7342
4198,4198,4198,4198,4198,4198,4198,4198,4199,2021-02-07 15:00:00+00:00,Queen Anne's,16.0,5467,7.0,1898,,0,,,1898,5467,7365
4199,4199,4199,4199,4199,4199,4199,4199,4200,2021-02-08 15:00:00+00:00,Queen Anne's,50.0,5517,44.0,1942,,0,,,1942,5517,7459
4200,4200,4200,4200,4200,4200,4200,4200,4201,2021-02-09 15:00:00+00:00,Queen Anne's,197.0,5714,65.0,2007,,0,,,2007,5714,7721
4201,4201,4201,4201,4201,4201,4201,4201,4202,2021-02-10 15:00:00+00:00,Queen Anne's,164.0,5878,217.0,2224,,0,,,2224,5878,8102
4202,4202,4202,4202,4202,4202,4202,4202,4203,2021-02-11 15:00:00+00:00,Queen Anne's,181.0,6059,72.0,2296,,0,,,2296,6059,8355
4203,4203,4203,4203,4203,4203,4203,4203,4204,2021-02-12 15:00:00+00:00,Queen Anne's,317.0,6376,404.0,2700,,0,,,2700,6376,9076
4204,4204,4204,4204,4204,4204,4204,4204,4205,2021-02-13 15:00:00+00:00,Queen Anne's,33.0,6409,30.0,2730,,0,,,2730,6409,9139
4205,4205,4205,4205,4205,4205,4205,4205,4206,2021-02-14 15:00:00+00:00,Queen Anne's,40.0,6449,12.0,2742,,0,,,2742,6449,9191
4206,4206,4206,4206,4206,4206,4206,4206,4207,2021-02-15 15:00:00+00:00,Queen Anne's,76.0,6525,37.0,2779,,0,,,2779,6525,9304
4207,4207,4207,4207,4207,4207,4207,4207,4208,2021-02-16 15:00:00+00:00,Queen Anne's,108.0,6633,119.0,2898,,0,,,2898,6633,9531
4208,4208,4208,4208,4208,4208,4208,4208,4209,2021-02-17 15:00:00+00:00,Queen Anne's,187.0,6820,95.0,2993,,0,,,2993,6820,9813
4209,4209,4209,4209,4209,4209,4209,4209,4210,2021-02-18 15:00:00+00:00,Queen Anne's,42.0,6862,11.0,3004,,0,,,3004,6862,9866
4210,4210,4210,4210,4210,4210,4210,4210,4211,2021-02-19 15:00:00+00:00,Queen Anne's,60.0,6922,89.0,3093,,0,,,3093,6922,10015
4211,4211,4211,4211,4211,4211,4211,4211,4212,2021-02-20 15:00:00+00:00,Queen Anne's,50.0,6972,67.0,3160,,0,,,3160,6972,10132
4212,4212,4212,4212,4212,4212,4212,4212,4213,2021-02-21 15:00:00+00:00,Queen Anne's,41.0,7013,20.0,3180,,0,,,3180,7013,10193
4213,4213,4213,4213,4213,4213,4213,4213,4214,2021-02-22 15:00:00+00:00,Queen Anne's,45.0,7058,552.0,3732,,0,,,3732,7058,10790
4214,4214,4214,4214,4214,4214,4214,4214,4215,2021-02-23 15:00:00+00:00,Queen Anne's,68.0,7126,140.0,3872,,0,,,3872,7126,10998
4215,4215,4215,4215,4215,4215,4215,4215,4216,2021-02-24 15:00:00+00:00,Queen Anne's,377.0,7503,146.0,4018,,0,,,4018,7503,11521
4216,4216,4216,4216,4216,4216,4216,4216,4217,2021-02-25 15:00:00+00:00,Queen Anne's,154.0,7657,173.0,4191,,0,,,4191,7657,11848
4217,4217,4217,4217,4217,4217,4217,4217,4218,2021-02-26 15:00:00+00:00,Queen Anne's,400.0,8057,115.0,4306,,0,,,4306,8057,12363
4218,4218,4218,4218,4218,4218,4218,4218,4219,2021-02-27 15:00:00+00:00,Queen Anne's,100.0,8157,21.0,4327,,0,,,4327,8157,12484
4219,4219,4219,4219,4219,4219,4219,4219,4220,2021-02-28 15:00:00+00:00,Queen Anne's,102.0,8259,11.0,4338,,0,,,4338,8259,12597
4220,4220,4220,4220,4220,4220,4220,4220,4221,2021-03-01 15:00:00+00:00,Queen Anne's,155.0,8414,160.0,4498,,0,,,4498,8414,12912
4221,4221,4221,4221,4221,4221,4221,4221,4222,2021-03-02 15:00:00+00:00,Queen Anne's,178.0,8592,74.0,4572,,0,,,4572,8592,13164
4222,4222,4222,4222,4222,4222,4222,4222,4223,2021-03-03 15:00:00+00:00,Queen Anne's,443.0,9035,87.0,4659,,0,,,4659,9035,13694
4223,4223,4223,4223,4223,4223,4223,4223,4224,2021-03-04 15:00:00+00:00,Queen Anne's,175.0,9210,152.0,4811,32.0,32,207.0,184.0,4843,9242,14021
4224,4224,4224,4224,4224,4224,4224,4224,4225,2021-03-05 15:00:00+00:00,Queen Anne's,115.0,9325,92.0,4903,13.0,45,128.0,105.0,4948,9370,14228
4225,4225,4225,4225,4225,4225,4225,4225,4226,2021-03-06 15:00:00+00:00,Queen Anne's,58.0,9383,35.0,4938,42.0,87,100.0,77.0,5025,9470,14321
4226,4226,4226,4226,4226,4226,4226,4226,4227,2021-03-07 15:00:00+00:00,Queen Anne's,82.0,9465,22.0,4960,50.0,137,132.0,72.0,5097,9602,14425
4227,4227,4227,4227,4227,4227,4227,4227,4228,2021-03-08 15:00:00+00:00,Queen Anne's,181.0,9646,438.0,5398,35.0,172,216.0,473.0,5570,9818,15044
4228,4228,4228,4228,4228,4228,4228,4228,4229,2021-03-09 15:00:00+00:00,Queen Anne's,175.0,9821,202.0,5600,41.0,213,216.0,243.0,5813,10034,15421
4229,4229,4229,4229,4229,4229,4229,4229,4230,2021-03-10 15:00:00+00:00,Queen Anne's,140.0,9961,127.0,5727,29.0,242,169.0,156.0,5969,10203,15688
4230,4230,4230,4230,4230,4230,4230,4230,4231,2021-03-11 15:00:00+00:00,Queen Anne's,194.0,10155,206.0,5933,20.0,262,214.0,226.0,6195,10417,16088
4231,4231,4231,4231,4231,4231,4231,4231,4232,2021-03-12 15:00:00+00:00,Queen Anne's,717.0,10872,125.0,6058,40.0,302,757.0,165.0,6360,11174,16930
4232,4232,4232,4232,4232,4232,4232,4232,4233,2021-03-13 15:00:00+00:00,Queen Anne's,120.0,10992,38.0,6096,16.0,318,136.0,54.0,6414,11310,17088
4233,4233,4233,4233,4233,4233,4233,4233,4234,2021-03-14 15:00:00+00:00,Queen Anne's,100.0,11092,48.0,6144,16.0,334,116.0,64.0,6478,11426,17236
4234,4234,4234,4234,4234,4234,4234,4234,4235,2021-03-15 15:00:00+00:00,Queen Anne's,178.0,11270,314.0,6458,2.0,336,180.0,316.0,6794,11606,17728
4235,4235,4235,4235,4235,4235,4235,4235,4236,2021-03-16 15:00:00+00:00,Queen Anne's,255.0,11525,94.0,6552,27.0,363,282.0,121.0,6915,11888,18077
4236,4236,4236,4236,4236,4236,4236,4236,4237,2021-03-17 15:00:00+00:00,Queen Anne's,571.0,12096,89.0,6641,3.0,366,574.0,92.0,7007,12462,18737
4237,4237,4237,4237,4237,4237,4237,4237,4238,2021-03-18 15:00:00+00:00,Queen Anne's,256.0,12352,145.0,6786,31.0,397,287.0,176.0,7183,12749,19138
4238,4238,4238,4238,4238,4238,4238,4238,4239,2021-03-19 15:00:00+00:00,Queen Anne's,203.0,12555,84.0,6870,11.0,408,214.0,95.0,7278,12963,19425
4239,4239,4239,4239,4239,4239,4239,4239,4240,2021-03-20 15:00:00+00:00,Queen Anne's,190.0,12745,62.0,6932,,408,,,7340,13153,19677
4240,4240,4240,4240,4240,4240,4240,4240,4241,2021-06-17 15:00:00+00:00,Frederick,218.0,138063,504.0,126225,21.0,15042,239.0,525.0,141267,153105,264288
4241,4241,4241,4241,4241,4241,4241,4241,4242,2021-06-18 15:00:00+00:00,Frederick,233.0,138296,692.0,126917,29.0,15071,262.0,721.0,141988,153367,265213
4242,4242,4242,4242,4242,4242,4242,4242,4243,2021-06-19 15:00:00+00:00,Frederick,155.0,138451,455.0,127372,37.0,15108,192.0,492.0,142480,153559,265823
4243,4243,4243,4243,4243,4243,4243,4243,4244,2021-06-20 15:00:00+00:00,Frederick,75.0,138526,138.0,127510,7.0,15115,82.0,145.0,142625,153641,266036
4244,4244,4244,4244,4244,4244,4244,4244,4245,2021-06-21 15:00:00+00:00,Frederick,266.0,138792,180.0,127690,30.0,15145,296.0,210.0,142835,153937,266482
4245,4245,4245,4245,4245,4245,4245,4245,4246,2021-06-22 15:00:00+00:00,Frederick,195.0,138987,280.0,127970,14.0,15159,209.0,294.0,143129,154146,266957
4246,4246,4246,4246,4246,4246,4246,4246,4247,2021-06-23 15:00:00+00:00,Frederick,236.0,139223,478.0,128448,14.0,15173,250.0,492.0,143621,154396,267671
4247,4247,4247,4247,4247,4247,4247,4247,4248,2021-06-24 15:00:00+00:00,Frederick,250.0,139473,302.0,128750,23.0,15196,273.0,325.0,143946,154669,268223
4248,4248,4248,4248,4248,4248,4248,4248,4249,2021-06-25 15:00:00+00:00,Frederick,229.0,139702,381.0,129131,20.0,15216,249.0,401.0,144347,154918,268833
4249,4249,4249,4249,4249,4249,4249,4249,4250,2021-06-26 15:00:00+00:00,Frederick,168.0,139870,271.0,129402,28.0,15244,196.0,299.0,144646,155114,269272
4250,4250,4250,4250,4250,4250,4250,4250,4251,2021-06-27 15:00:00+00:00,Frederick,89.0,139959,105.0,129507,6.0,15250,95.0,111.0,144757,155209,269466
4251,4251,4251,4251,4251,4251,4251,4251,4252,2021-06-28 15:00:00+00:00,Frederick,173.0,140132,224.0,129731,18.0,15268,191.0,242.0,144999,155400,269863
4252,4252,4252,4252,4252,4252,4252,4252,4253,2021-06-29 15:00:00+00:00,Frederick,114.0,140246,223.0,129954,23.0,15291,137.0,246.0,145245,155537,270200
4253,4253,4253,4253,4253,4253,4253,4253,4254,2021-06-30 15:00:00+00:00,Frederick,200.0,140446,292.0,130246,36.0,15327,236.0,328.0,145573,155773,270692
4254,4254,4254,4254,4254,4254,4254,4254,4255,2021-07-01 15:00:00+00:00,Frederick,205.0,140651,270.0,130516,18.0,15345,223.0,288.0,145861,155996,271167
4255,4255,4255,4255,4255,4255,4255,4255,4256,2021-07-02 15:00:00+00:00,Frederick,233.0,140884,256.0,130772,26.0,15371,259.0,282.0,146143,156255,271656
4256,4256,4256,4256,4256,4256,4256,4256,4257,2021-07-03 15:00:00+00:00,Frederick,127.0,141011,200.0,130972,12.0,15383,139.0,212.0,146355,156394,271983
4257,4257,4257,4257,4257,4257,4257,4257,4258,2021-07-04 15:00:00+00:00,Frederick,13.0,141024,13.0,130985,3.0,15386,16.0,16.0,146371,156410,272009
4258,4258,4258,4258,4258,4258,4258,4258,4259,2021-07-05 15:00:00+00:00,Frederick,162.0,141186,175.0,131160,17.0,15403,179.0,192.0,146563,156589,272346
4259,4259,4259,4259,4259,4259,4259,4259,4260,2021-07-06 15:00:00+00:00,Frederick,127.0,141313,188.0,131348,20.0,15423,147.0,208.0,146771,156736,272661
4260,4260,4260,4260,4260,4260,4260,4260,4261,2021-07-07 15:00:00+00:00,Frederick,179.0,141492,248.0,131596,17.0,15440,196.0,265.0,147036,156932,273088
4261,4261,4261,4261,4261,4261,4261,4261,4262,2021-07-08 15:00:00+00:00,Frederick,178.0,141670,189.0,131785,13.0,15453,191.0,202.0,147238,157123,273455
4262,4262,4262,4262,4262,4262,4262,4262,4263,2021-07-09 15:00:00+00:00,Frederick,208.0,141878,285.0,132070,24.0,15477,232.0,309.0,147547,157355,273948
4263,4263,4263,4263,4263,4263,4263,4263,4264,2021-07-10 15:00:00+00:00,Frederick,123.0,142001,171.0,132241,19.0,15496,142.0,190.0,147737,157497,274242
4264,4264,4264,4264,4264,4264,4264,4264,4265,2021-07-11 15:00:00+00:00,Frederick,63.0,142064,98.0,132339,8.0,15504,71.0,106.0,147843,157568,274403
4265,4265,4265,4265,4265,4265,4265,4265,4266,2021-07-12 15:00:00+00:00,Frederick,176.0,142240,222.0,132561,10.0,15514,186.0,232.0,148075,157754,274801
4266,4266,4266,4266,4266,4266,4266,4266,4267,2021-07-13 15:00:00+00:00,Frederick,132.0,142372,169.0,132730,6.0,15520,138.0,175.0,148250,157892,275102
4267,4267,4267,4267,4267,4267,4267,4267,4268,2021-07-14 15:00:00+00:00,Frederick,150.0,142522,210.0,132940,10.0,15530,160.0,220.0,148470,158052,275462
4268,4268,4268,4268,4268,4268,4268,4268,4269,2021-07-15 15:00:00+00:00,Frederick,149.0,142671,202.0,133142,9.0,15539,158.0,211.0,148681,158210,275813
4269,4269,4269,4269,4269,4269,4269,4269,4270,2021-07-16 15:00:00+00:00,Frederick,191.0,142862,224.0,133366,8.0,15547,199.0,232.0,148913,158409,276228
4270,4270,4270,4270,4270,4270,4270,4270,4271,2021-07-17 15:00:00+00:00,Frederick,134.0,142996,178.0,133544,30.0,15577,164.0,208.0,149121,158573,276540
4271,4271,4271,4271,4271,4271,4271,4271,4272,2021-07-18 15:00:00+00:00,Frederick,57.0,143053,59.0,133603,5.0,15582,62.0,64.0,149185,158635,276656
4272,4272,4272,4272,4272,4272,4272,4272,4273,2021-07-19 15:00:00+00:00,Frederick,196.0,143249,178.0,133781,24.0,15606,220.0,202.0,149387,158855,277030
4273,4273,4273,4273,4273,4273,4273,4273,4274,2021-07-20 15:00:00+00:00,Frederick,149.0,143398,127.0,133908,9.0,15615,158.0,136.0,149523,159013,277306
4274,4274,4274,4274,4274,4274,4274,4274,4275,2021-07-21 15:00:00+00:00,Frederick,240.0,143638,175.0,134083,17.0,15632,257.0,192.0,149715,159270,277721
4275,4275,4275,4275,4275,4275,4275,4275,4276,2021-07-22 15:00:00+00:00,Frederick,236.0,143874,169.0,134252,26.0,15658,262.0,195.0,149910,159532,278126
4276,4276,4276,4276,4276,4276,4276,4276,4277,2021-07-23 15:00:00+00:00,Frederick,272.0,144146,255.0,134507,33.0,15691,305.0,288.0,150198,159837,278653
4277,4277,4277,4277,4277,4277,4277,4277,4278,2021-07-24 15:00:00+00:00,Frederick,177.0,144323,131.0,134638,18.0,15709,195.0,149.0,150347,160032,278961
4278,4278,4278,4278,4278,4278,4278,4278,4279,2021-07-25 15:00:00+00:00,Frederick,97.0,144420,30.0,134668,4.0,15713,101.0,34.0,150381,160133,279088
4279,4279,4279,4279,4279,4279,4279,4279,4280,2021-07-26 15:00:00+00:00,Frederick,219.0,144639,138.0,134806,23.0,15736,242.0,161.0,150542,160375,279445
4280,4280,4280,4280,4280,4280,4280,4280,4281,2021-07-27 15:00:00+00:00,Frederick,202.0,144841,145.0,134951,22.0,15758,224.0,167.0,150709,160599,279792
4281,4281,4281,4281,4281,4281,4281,4281,4282,2021-07-28 15:00:00+00:00,Frederick,214.0,145055,169.0,135120,11.0,15769,225.0,180.0,150889,160824,280175
4282,4282,4282,4282,4282,4282,4282,4282,4283,2021-07-29 15:00:00+00:00,Frederick,230.0,145285,143.0,135263,20.0,15789,250.0,163.0,151052,161074,280548
4283,4283,4283,4283,4283,4283,4283,4283,4284,2021-07-30 15:00:00+00:00,Frederick,265.0,145550,236.0,135499,18.0,15807,283.0,254.0,151306,161357,281049
4284,4284,4284,4284,4284,4284,4284,4284,4285,2021-07-31 15:00:00+00:00,Frederick,187.0,145737,135.0,135634,24.0,15831,211.0,159.0,151465,161568,281371
4285,4285,4285,4285,4285,4285,4285,4285,4286,2021-08-01 15:00:00+00:00,Frederick,106.0,145843,59.0,135693,2.0,15833,108.0,61.0,151526,161676,281536
4286,4286,4286,4286,4286,4286,4286,4286,4287,2021-08-02 15:00:00+00:00,Frederick,264.0,146107,161.0,135854,29.0,15862,293.0,190.0,151716,161969,281961
4287,4287,4287,4287,4287,4287,4287,4287,4288,2021-08-03 15:00:00+00:00,Frederick,245.0,146352,119.0,135973,19.0,15881,264.0,138.0,151854,162233,282325
4288,4288,4288,4288,4288,4288,4288,4288,4289,2021-08-04 15:00:00+00:00,Frederick,299.0,146651,160.0,136133,21.0,15902,320.0,181.0,152035,162553,282784
4289,4289,4289,4289,4289,4289,4289,4289,4290,2021-08-05 15:00:00+00:00,Frederick,333.0,146984,120.0,136253,8.0,15910,341.0,128.0,152163,162894,283237
4290,4290,4290,4290,4290,4290,4290,4290,4291,2021-08-06 15:00:00+00:00,Frederick,307.0,147291,188.0,136441,11.0,15921,318.0,199.0,152362,163212,283732
4291,4291,4291,4291,4291,4291,4291,4291,4292,2021-08-07 15:00:00+00:00,Frederick,219.0,147510,132.0,136573,19.0,15940,238.0,151.0,152513,163450,284083
4292,4292,4292,4292,4292,4292,4292,4292,4293,2021-08-08 15:00:00+00:00,Frederick,112.0,147622,59.0,136632,11.0,15951,123.0,70.0,152583,163573,284254
4293,4293,4293,4293,4293,4293,4293,4293,4294,2021-08-09 15:00:00+00:00,Frederick,255.0,147877,170.0,136802,41.0,15992,296.0,211.0,152794,163869,284679
4294,4294,4294,4294,4294,4294,4294,4294,4295,2021-08-10 15:00:00+00:00,Frederick,223.0,148100,122.0,136924,10.0,16002,233.0,132.0,152926,164102,285024
4295,4295,4295,4295,4295,4295,4295,4295,4296,2021-08-11 15:00:00+00:00,Frederick,236.0,148336,201.0,137125,29.0,16031,265.0,230.0,153156,164367,285461
4296,4296,4296,4296,4296,4296,4296,4296,4297,2021-03-17 15:00:00+00:00,Dorchester,72.0,6985,43.0,4055,1.0,718,73.0,44.0,4773,7703,11040
4297,4297,4297,4297,4297,4297,4297,4297,4298,2021-03-18 15:00:00+00:00,Dorchester,156.0,7141,85.0,4140,13.0,731,169.0,98.0,4871,7872,11281
4298,4298,4298,4298,4298,4298,4298,4298,4299,2021-03-19 15:00:00+00:00,Dorchester,240.0,7381,34.0,4174,11.0,742,251.0,45.0,4916,8123,11555
4299,4299,4299,4299,4299,4299,4299,4299,4300,2021-03-20 15:00:00+00:00,Dorchester,25.0,7406,6.0,4180,1.0,743,26.0,7.0,4923,8149,11586
4300,4300,4300,4300,4300,4300,4300,4300,4301,2021-03-21 15:00:00+00:00,Dorchester,39.0,7445,7.0,4187,,743,,,4930,8188,11632
4301,4301,4301,4301,4301,4301,4301,4301,4302,2021-03-22 15:00:00+00:00,Dorchester,181.0,7626,34.0,4221,5.0,748,186.0,39.0,4969,8374,11847
4302,4302,4302,4302,4302,4302,4302,4302,4303,2021-03-23 15:00:00+00:00,Dorchester,270.0,7896,24.0,4245,26.0,774,296.0,50.0,5019,8670,12141
4303,4303,4303,4303,4303,4303,4303,4303,4304,2021-03-24 15:00:00+00:00,Dorchester,60.0,7956,16.0,4261,8.0,782,68.0,24.0,5043,8738,12217
4304,4304,4304,4304,4304,4304,4304,4304,4305,2021-03-25 15:00:00+00:00,Dorchester,161.0,8117,129.0,4390,2.0,784,163.0,131.0,5174,8901,12507
4305,4305,4305,4305,4305,4305,4305,4305,4306,2021-03-26 15:00:00+00:00,Dorchester,163.0,8280,42.0,4432,96.0,880,259.0,138.0,5312,9160,12712
4306,4306,4306,4306,4306,4306,4306,4306,4307,2021-03-27 15:00:00+00:00,Dorchester,23.0,8303,33.0,4465,2.0,882,25.0,35.0,5347,9185,12768
4307,4307,4307,4307,4307,4307,4307,4307,4308,2021-03-28 15:00:00+00:00,Dorchester,21.0,8324,15.0,4480,,882,,,5362,9206,12804
4308,4308,4308,4308,4308,4308,4308,4308,4309,2021-03-29 15:00:00+00:00,Dorchester,119.0,8443,131.0,4611,5.0,887,124.0,136.0,5498,9330,13054
4309,4309,4309,4309,4309,4309,4309,4309,4310,2021-03-30 15:00:00+00:00,Dorchester,173.0,8616,238.0,4849,24.0,911,197.0,262.0,5760,9527,13465
4310,4310,4310,4310,4310,4310,4310,4310,4311,2021-03-31 15:00:00+00:00,Dorchester,54.0,8670,137.0,4986,104.0,1015,158.0,241.0,6001,9685,13656
4311,4311,4311,4311,4311,4311,4311,4311,4312,2021-04-01 15:00:00+00:00,Dorchester,92.0,8762,387.0,5373,36.0,1051,128.0,423.0,6424,9813,14135
4312,4312,4312,4312,4312,4312,4312,4312,4313,2021-04-02 15:00:00+00:00,Dorchester,174.0,8936,34.0,5407,6.0,1057,180.0,40.0,6464,9993,14343
4313,4313,4313,4313,4313,4313,4313,4313,4314,2021-04-03 15:00:00+00:00,Dorchester,29.0,8965,14.0,5421,10.0,1067,39.0,24.0,6488,10032,14386
4314,4314,4314,4314,4314,4314,4314,4314,4315,2021-04-04 15:00:00+00:00,Dorchester,9.0,8974,3.0,5424,1.0,1068,10.0,4.0,6492,10042,14398
4315,4315,4315,4315,4315,4315,4315,4315,4316,2021-04-05 15:00:00+00:00,Dorchester,155.0,9129,114.0,5538,39.0,1107,194.0,153.0,6645,10236,14667
4316,4316,4316,4316,4316,4316,4316,4316,4317,2021-04-06 15:00:00+00:00,Dorchester,165.0,9294,295.0,5833,32.0,1139,197.0,327.0,6972,10433,15127
4317,4317,4317,4317,4317,4317,4317,4317,4318,2021-04-07 15:00:00+00:00,Dorchester,115.0,9409,301.0,6134,67.0,1206,182.0,368.0,7340,10615,15543
4318,4318,4318,4318,4318,4318,4318,4318,4319,2021-04-08 15:00:00+00:00,Dorchester,105.0,9514,175.0,6309,191.0,1397,296.0,366.0,7706,10911,15823
4319,4319,4319,4319,4319,4319,4319,4319,4320,2021-04-09 15:00:00+00:00,Dorchester,32.0,9546,40.0,6349,123.0,1520,155.0,163.0,7869,11066,15895
4320,4320,4320,4320,4320,4320,4320,4320,4321,2021-04-10 15:00:00+00:00,Dorchester,36.0,9582,18.0,6367,91.0,1611,127.0,109.0,7978,11193,15949
4321,4321,4321,4321,4321,4321,4321,4321,4322,2021-04-11 15:00:00+00:00,Dorchester,10.0,9592,21.0,6388,7.0,1618,17.0,28.0,8006,11210,15980
4322,4322,4322,4322,4322,4322,4322,4322,4323,2021-04-12 15:00:00+00:00,Dorchester,52.0,9644,216.0,6604,14.0,1632,66.0,230.0,8236,11276,16248
4323,4323,4323,4323,4323,4323,4323,4323,4324,2021-04-13 15:00:00+00:00,Dorchester,147.0,9791,177.0,6781,,1632,,,8413,11423,16572
4324,4324,4324,4324,4324,4324,4324,4324,4325,2021-04-14 15:00:00+00:00,Dorchester,69.0,9860,103.0,6884,,1632,,,8516,11492,16744
4325,4325,4325,4325,4325,4325,4325,4325,4326,2021-04-15 15:00:00+00:00,Dorchester,127.0,9987,153.0,7037,,1632,,,8669,11619,17024
4326,4326,4326,4326,4326,4326,4326,4326,4327,2021-04-16 15:00:00+00:00,Dorchester,131.0,10118,252.0,7289,,1632,,,8921,11750,17407
4327,4327,4327,4327,4327,4327,4327,4327,4328,2021-04-17 15:00:00+00:00,Dorchester,12.0,10130,17.0,7306,,1632,,,8938,11762,17436
4328,4328,4328,4328,4328,4328,4328,4328,4329,2021-04-18 15:00:00+00:00,Dorchester,21.0,10151,19.0,7325,,1632,,,8957,11783,17476
4329,4329,4329,4329,4329,4329,4329,4329,4330,2021-04-19 15:00:00+00:00,Dorchester,61.0,10212,163.0,7488,,1632,,,9120,11844,17700
4330,4330,4330,4330,4330,4330,4330,4330,4331,2021-04-20 15:00:00+00:00,Dorchester,66.0,10278,272.0,7760,,1632,,,9392,11910,18038
4331,4331,4331,4331,4331,4331,4331,4331,4332,2021-04-21 15:00:00+00:00,Dorchester,125.0,10403,71.0,7831,,1632,,,9463,12035,18234
4332,4332,4332,4332,4332,4332,4332,4332,4333,2021-04-22 15:00:00+00:00,Dorchester,256.0,10659,174.0,8005,1.0,1633,257.0,175.0,9638,12292,18664
4333,4333,4333,4333,4333,4333,4333,4333,4334,2021-04-23 15:00:00+00:00,Dorchester,49.0,10708,111.0,8116,,1633,,,9749,12341,18824
4334,4334,4334,4334,4334,4334,4334,4334,4335,2021-04-24 15:00:00+00:00,Dorchester,31.0,10739,30.0,8146,,1633,,,9779,12372,18885
4335,4335,4335,4335,4335,4335,4335,4335,4336,2021-04-25 15:00:00+00:00,Dorchester,11.0,10750,7.0,8153,,1633,,,9786,12383,18903
4336,4336,4336,4336,4336,4336,4336,4336,4337,2021-04-26 15:00:00+00:00,Dorchester,56.0,10806,116.0,8269,,1633,,,9902,12439,19075
4337,4337,4337,4337,4337,4337,4337,4337,4338,2021-04-27 15:00:00+00:00,Dorchester,101.0,10907,164.0,8433,3.0,1636,104.0,167.0,10069,12543,19340
4338,4338,4338,4338,4338,4338,4338,4338,4339,2021-04-28 15:00:00+00:00,Dorchester,90.0,10997,120.0,8553,4.0,1640,94.0,124.0,10193,12637,19550
4339,4339,4339,4339,4339,4339,4339,4339,4340,2021-04-29 15:00:00+00:00,Dorchester,86.0,11083,65.0,8618,2.0,1642,88.0,67.0,10260,12725,19701
4340,4340,4340,4340,4340,4340,4340,4340,4341,2021-04-30 15:00:00+00:00,Dorchester,34.0,11117,131.0,8749,1.0,1643,35.0,132.0,10392,12760,19866
4341,4341,4341,4341,4341,4341,4341,4341,4342,2021-05-01 15:00:00+00:00,Dorchester,13.0,11130,14.0,8763,1.0,1644,14.0,15.0,10407,12774,19893
4342,4342,4342,4342,4342,4342,4342,4342,4343,2021-05-02 15:00:00+00:00,Dorchester,9.0,11139,4.0,8767,1.0,1645,10.0,5.0,10412,12784,19906
4343,4343,4343,4343,4343,4343,4343,4343,4344,2021-05-03 15:00:00+00:00,Dorchester,23.0,11162,134.0,8901,1.0,1646,24.0,135.0,10547,12808,20063
4344,4344,4344,4344,4344,4344,4344,4344,4345,2021-05-04 15:00:00+00:00,Dorchester,20.0,11182,128.0,9029,24.0,1670,44.0,152.0,10699,12852,20211
4345,4345,4345,4345,4345,4345,4345,4345,4346,2021-05-05 15:00:00+00:00,Dorchester,45.0,11227,127.0,9156,25.0,1695,70.0,152.0,10851,12922,20383
4346,4346,4346,4346,4346,4346,4346,4346,4347,2021-05-06 15:00:00+00:00,Dorchester,42.0,11269,74.0,9230,31.0,1726,73.0,105.0,10956,12995,20499
4347,4347,4347,4347,4347,4347,4347,4347,4348,2021-05-07 15:00:00+00:00,Dorchester,26.0,11295,62.0,9292,19.0,1745,45.0,81.0,11037,13040,20587
4348,4348,4348,4348,4348,4348,4348,4348,4349,2021-05-08 15:00:00+00:00,Dorchester,10.0,11305,27.0,9319,20.0,1765,30.0,47.0,11084,13070,20624
4349,4349,4349,4349,4349,4349,4349,4349,4350,2021-05-09 15:00:00+00:00,Dorchester,4.0,11309,14.0,9333,16.0,1781,20.0,30.0,11114,13090,20642
4350,4350,4350,4350,4350,4350,4350,4350,4351,2021-05-10 15:00:00+00:00,Dorchester,44.0,11353,46.0,9379,4.0,1785,48.0,50.0,11164,13138,20732
4351,4351,4351,4351,4351,4351,4351,4351,4352,2021-05-11 15:00:00+00:00,Dorchester,45.0,11398,122.0,9501,3.0,1788,48.0,125.0,11289,13186,20899
4352,4352,4352,4352,4352,4352,4352,4352,4353,2021-05-12 15:00:00+00:00,Dorchester,98.0,11496,66.0,9567,6.0,1794,104.0,72.0,11361,13290,21063
4353,4353,4353,4353,4353,4353,4353,4353,4354,2021-05-13 15:00:00+00:00,Dorchester,70.0,11566,117.0,9684,10.0,1804,80.0,127.0,11488,13370,21250
4354,4354,4354,4354,4354,4354,4354,4354,4355,2021-05-14 15:00:00+00:00,Dorchester,49.0,11615,74.0,9758,18.0,1822,67.0,92.0,11580,13437,21373
4355,4355,4355,4355,4355,4355,4355,4355,4356,2021-05-15 15:00:00+00:00,Dorchester,29.0,11644,23.0,9781,3.0,1825,32.0,26.0,11606,13469,21425
4356,4356,4356,4356,4356,4356,4356,4356,4357,2021-05-16 15:00:00+00:00,Dorchester,24.0,11668,11.0,9792,5.0,1830,29.0,16.0,11622,13498,21460
4357,4357,4357,4357,4357,4357,4357,4357,4358,2021-05-17 15:00:00+00:00,Dorchester,61.0,11729,50.0,9842,18.0,1848,79.0,68.0,11690,13577,21571
4358,4358,4358,4358,4358,4358,4358,4358,4359,2021-05-18 15:00:00+00:00,Dorchester,66.0,11795,61.0,9903,1.0,1849,67.0,62.0,11752,13644,21698
4359,4359,4359,4359,4359,4359,4359,4359,4360,2021-05-19 15:00:00+00:00,Dorchester,58.0,11853,126.0,10029,6.0,1855,64.0,132.0,11884,13708,21882
4360,4360,4360,4360,4360,4360,4360,4360,4361,2021-05-20 15:00:00+00:00,Dorchester,67.0,11920,223.0,10252,17.0,1872,84.0,240.0,12124,13792,22172
4361,4361,4361,4361,4361,4361,4361,4361,4362,2021-05-21 15:00:00+00:00,Dorchester,74.0,11994,55.0,10307,7.0,1879,81.0,62.0,12186,13873,22301
4362,4362,4362,4362,4362,4362,4362,4362,4363,2021-05-22 15:00:00+00:00,Dorchester,49.0,12043,29.0,10336,4.0,1883,53.0,33.0,12219,13926,22379
4363,4363,4363,4363,4363,4363,4363,4363,4364,2021-05-23 15:00:00+00:00,Dorchester,20.0,12063,8.0,10344,2.0,1885,22.0,10.0,12229,13948,22407
4364,4364,4364,4364,4364,4364,4364,4364,4365,2021-05-24 15:00:00+00:00,Dorchester,46.0,12109,43.0,10387,11.0,1896,57.0,54.0,12283,14005,22496
4365,4365,4365,4365,4365,4365,4365,4365,4366,2021-05-25 15:00:00+00:00,Dorchester,32.0,12141,40.0,10427,4.0,1900,36.0,44.0,12327,14041,22568
4366,4366,4366,4366,4366,4366,4366,4366,4367,2021-05-26 15:00:00+00:00,Dorchester,45.0,12186,73.0,10500,2.0,1902,47.0,75.0,12402,14088,22686
4367,4367,4367,4367,4367,4367,4367,4367,4368,2021-05-27 15:00:00+00:00,Dorchester,32.0,12218,61.0,10561,8.0,1910,40.0,69.0,12471,14128,22779
4368,4368,4368,4368,4368,4368,4368,4368,4369,2021-05-28 15:00:00+00:00,Dorchester,30.0,12248,14.0,10575,13.0,1923,43.0,27.0,12498,14171,22823
4369,4369,4369,4369,4369,4369,4369,4369,4370,2021-05-29 15:00:00+00:00,Dorchester,18.0,12266,13.0,10588,4.0,1927,22.0,17.0,12515,14193,22854
4370,4370,4370,4370,4370,4370,4370,4370,4371,2021-05-30 15:00:00+00:00,Dorchester,5.0,12271,5.0,10593,1.0,1928,6.0,6.0,12521,14199,22864
4371,4371,4371,4371,4371,4371,4371,4371,4372,2021-05-31 15:00:00+00:00,Dorchester,6.0,12277,9.0,10602,2.0,1930,8.0,11.0,12532,14207,22879
4372,4372,4372,4372,4372,4372,4372,4372,4373,2021-06-01 15:00:00+00:00,Dorchester,36.0,12313,49.0,10651,3.0,1933,39.0,52.0,12584,14246,22964
4373,4373,4373,4373,4373,4373,4373,4373,4374,2021-06-02 15:00:00+00:00,Dorchester,15.0,12328,39.0,10690,6.0,1939,21.0,45.0,12629,14267,23018
4374,4374,4374,4374,4374,4374,4374,4374,4375,2021-06-03 15:00:00+00:00,Dorchester,35.0,12363,54.0,10744,7.0,1946,42.0,61.0,12690,14309,23107
4375,4375,4375,4375,4375,4375,4375,4375,4376,2021-06-04 15:00:00+00:00,Dorchester,21.0,12384,20.0,10764,12.0,1958,33.0,32.0,12722,14342,23148
4376,4376,4376,4376,4376,4376,4376,4376,4377,2021-06-05 15:00:00+00:00,Dorchester,7.0,12391,25.0,10789,2.0,1960,9.0,27.0,12749,14351,23180
4377,4377,4377,4377,4377,4377,4377,4377,4378,2021-06-06 15:00:00+00:00,Dorchester,3.0,12394,16.0,10805,2.0,1962,5.0,18.0,12767,14356,23199
4378,4378,4378,4378,4378,4378,4378,4378,4379,2021-06-07 15:00:00+00:00,Dorchester,15.0,12409,15.0,10820,1.0,1963,16.0,16.0,12783,14372,23229
4379,4379,4379,4379,4379,4379,4379,4379,4380,2021-06-08 15:00:00+00:00,Dorchester,25.0,12434,85.0,10905,5.0,1968,30.0,90.0,12873,14402,23339
4380,4380,4380,4380,4380,4380,4380,4380,4381,2021-06-09 15:00:00+00:00,Dorchester,26.0,12460,111.0,11016,9.0,1977,35.0,120.0,12993,14437,23476
4381,4381,4381,4381,4381,4381,4381,4381,4382,2021-06-10 15:00:00+00:00,Dorchester,28.0,12488,84.0,11100,8.0,1985,36.0,92.0,13085,14473,23588
4382,4382,4382,4382,4382,4382,4382,4382,4383,2021-06-11 15:00:00+00:00,Dorchester,19.0,12507,36.0,11136,13.0,1998,32.0,49.0,13134,14505,23643
4383,4383,4383,4383,4383,4383,4383,4383,4384,2021-06-12 15:00:00+00:00,Dorchester,3.0,12510,19.0,11155,,1998,,,13153,14508,23665
4384,4384,4384,4384,4384,4384,4384,4384,4385,2021-06-13 15:00:00+00:00,Dorchester,2.0,12512,9.0,11164,,1998,,,13162,14510,23676
4385,4385,4385,4385,4385,4385,4385,4385,4386,2021-06-14 15:00:00+00:00,Dorchester,18.0,12530,64.0,11228,5.0,2003,23.0,69.0,13231,14533,23758
4386,4386,4386,4386,4386,4386,4386,4386,4387,2021-06-15 15:00:00+00:00,Dorchester,27.0,12557,67.0,11295,5.0,2008,32.0,72.0,13303,14565,23852
4387,4387,4387,4387,4387,4387,4387,4387,4388,2021-06-16 15:00:00+00:00,Dorchester,15.0,12572,38.0,11333,9.0,2017,24.0,47.0,13350,14589,23905
4388,4388,4388,4388,4388,4388,4388,4388,4389,2021-06-17 15:00:00+00:00,Dorchester,36.0,12608,51.0,11384,5.0,2022,41.0,56.0,13406,14630,23992
4389,4389,4389,4389,4389,4389,4389,4389,4390,2021-06-18 15:00:00+00:00,Dorchester,35.0,12643,68.0,11452,6.0,2028,41.0,74.0,13480,14671,24095
4390,4390,4390,4390,4390,4390,4390,4390,4391,2021-06-19 15:00:00+00:00,Dorchester,9.0,12652,33.0,11485,2.0,2030,11.0,35.0,13515,14682,24137
4391,4391,4391,4391,4391,4391,4391,4391,4392,2021-06-20 15:00:00+00:00,Dorchester,4.0,12656,5.0,11490,,2030,,,13520,14686,24146
4392,4392,4392,4392,4392,4392,4392,4392,4393,2021-06-21 15:00:00+00:00,Dorchester,14.0,12670,9.0,11499,7.0,2037,21.0,16.0,13536,14707,24169
4393,4393,4393,4393,4393,4393,4393,4393,4394,2021-06-22 15:00:00+00:00,Dorchester,28.0,12698,39.0,11538,2.0,2039,30.0,41.0,13577,14737,24236
4394,4394,4394,4394,4394,4394,4394,4394,4395,2021-06-23 15:00:00+00:00,Dorchester,53.0,12751,30.0,11568,2.0,2041,55.0,32.0,13609,14792,24319
4395,4395,4395,4395,4395,4395,4395,4395,4396,2021-06-24 15:00:00+00:00,Dorchester,53.0,12804,43.0,11611,3.0,2044,56.0,46.0,13655,14848,24415
4396,4396,4396,4396,4396,4396,4396,4396,4397,2021-06-25 15:00:00+00:00,Dorchester,4.0,12808,11.0,11622,7.0,2051,11.0,18.0,13673,14859,24430
4397,4397,4397,4397,4397,4397,4397,4397,4398,2021-06-26 15:00:00+00:00,Dorchester,13.0,12821,13.0,11635,,2051,,,13686,14872,24456
4398,4398,4398,4398,4398,4398,4398,4398,4399,2021-06-27 15:00:00+00:00,Dorchester,1.0,12822,4.0,11639,,2051,,,13690,14873,24461
4399,4399,4399,4399,4399,4399,4399,4399,4400,2021-06-28 15:00:00+00:00,Dorchester,9.0,12831,14.0,11653,5.0,2056,14.0,19.0,13709,14887,24484
4400,4400,4400,4400,4400,4400,4400,4400,4401,2021-06-29 15:00:00+00:00,Dorchester,23.0,12854,22.0,11675,5.0,2061,28.0,27.0,13736,14915,24529
4401,4401,4401,4401,4401,4401,4401,4401,4402,2021-06-30 15:00:00+00:00,Dorchester,61.0,12915,15.0,11690,4.0,2065,65.0,19.0,13755,14980,24605
4402,4402,4402,4402,4402,4402,4402,4402,4403,2021-07-01 15:00:00+00:00,Dorchester,24.0,12939,25.0,11715,5.0,2070,29.0,30.0,13785,15009,24654
4403,4403,4403,4403,4403,4403,4403,4403,4404,2021-07-02 15:00:00+00:00,Dorchester,15.0,12954,18.0,11733,1.0,2071,16.0,19.0,13804,15025,24687
4404,4404,4404,4404,4404,4404,4404,4404,4405,2021-07-03 15:00:00+00:00,Dorchester,7.0,12961,8.0,11741,,2071,,,13812,15032,24702
4405,4405,4405,4405,4405,4405,4405,4405,4406,2021-07-04 15:00:00+00:00,Dorchester,,12961,4.0,11745,,2071,,,13816,15032,24706
4406,4406,4406,4406,4406,4406,4406,4406,4407,2021-07-05 15:00:00+00:00,Dorchester,11.0,12972,12.0,11757,1.0,2072,12.0,13.0,13829,15044,24729
4407,4407,4407,4407,4407,4407,4407,4407,4408,2021-07-06 15:00:00+00:00,Dorchester,10.0,12982,36.0,11793,1.0,2073,11.0,37.0,13866,15055,24775
4408,4408,4408,4408,4408,4408,4408,4408,4409,2021-08-12 15:00:00+00:00,Frederick,235.0,148571,191.0,137316,25.0,16056,260.0,216.0,153372,164627,285887
4409,4409,4409,4409,4409,4409,4409,4409,4410,2021-08-13 15:00:00+00:00,Frederick,264.0,148835,240.0,137556,33.0,16089,297.0,273.0,153645,164924,286391
4410,4410,4410,4410,4410,4410,4410,4410,4411,2021-08-14 15:00:00+00:00,Frederick,186.0,149021,179.0,137735,22.0,16111,208.0,201.0,153846,165132,286756
4411,4411,4411,4411,4411,4411,4411,4411,4412,2021-08-15 15:00:00+00:00,Frederick,112.0,149133,87.0,137822,12.0,16123,124.0,99.0,153945,165256,286955
4412,4412,4412,4412,4412,4412,4412,4412,4413,2021-08-16 15:00:00+00:00,Frederick,230.0,149363,189.0,138011,17.0,16140,247.0,206.0,154151,165503,287374
4413,4413,4413,4413,4413,4413,4413,4413,4414,2021-08-17 15:00:00+00:00,Frederick,188.0,149551,141.0,138152,31.0,16171,219.0,172.0,154323,165722,287703
4414,4414,4414,4414,4414,4414,4414,4414,4415,2021-08-18 15:00:00+00:00,Frederick,212.0,149763,174.0,138326,19.0,16190,231.0,193.0,154516,165953,288089
4415,4415,4415,4415,4415,4415,4415,4415,4416,2021-08-19 15:00:00+00:00,Frederick,171.0,149934,169.0,138495,19.0,16209,190.0,188.0,154704,166143,288429
4416,4416,4416,4416,4416,4416,4416,4416,4417,2021-08-20 15:00:00+00:00,Frederick,208.0,150142,334.0,138829,29.0,16238,237.0,363.0,155067,166380,288971
4417,4417,4417,4417,4417,4417,4417,4417,4418,2021-08-21 15:00:00+00:00,Frederick,165.0,150307,188.0,139017,17.0,16255,182.0,205.0,155272,166562,289324
4418,4418,4418,4418,4418,4418,4418,4418,4419,2021-08-22 15:00:00+00:00,Frederick,92.0,150399,95.0,139112,1.0,16256,93.0,96.0,155368,166655,289511
4419,4419,4419,4419,4419,4419,4419,4419,4420,2021-08-23 15:00:00+00:00,Frederick,246.0,150645,214.0,139326,15.0,16271,261.0,229.0,155597,166916,289971
4420,4420,4420,4420,4420,4420,4420,4420,4421,2021-08-24 15:00:00+00:00,Frederick,182.0,150827,166.0,139492,14.0,16285,196.0,180.0,155777,167112,290319
4421,4421,4421,4421,4421,4421,4421,4421,4422,2021-08-25 15:00:00+00:00,Frederick,233.0,151060,220.0,139712,26.0,16311,259.0,246.0,156023,167371,290772
4422,4422,4422,4422,4422,4422,4422,4422,4423,2021-08-26 15:00:00+00:00,Frederick,280.0,151340,251.0,139963,14.0,16325,294.0,265.0,156288,167665,291303
4423,4423,4423,4423,4423,4423,4423,4423,4424,2021-08-27 15:00:00+00:00,Frederick,269.0,151609,272.0,140235,21.0,16346,290.0,293.0,156581,167955,291844
4424,4424,4424,4424,4424,4424,4424,4424,4425,2021-08-28 15:00:00+00:00,Frederick,217.0,151826,233.0,140468,17.0,16363,234.0,250.0,156831,168189,292294
4425,4425,4425,4425,4425,4425,4425,4425,4426,2021-08-29 15:00:00+00:00,Frederick,109.0,151935,88.0,140556,4.0,16367,113.0,92.0,156923,168302,292491
4426,4426,4426,4426,4426,4426,4426,4426,4427,2021-08-30 15:00:00+00:00,Frederick,240.0,152175,210.0,140766,23.0,16390,263.0,233.0,157156,168565,292941
4427,4427,4427,4427,4427,4427,4427,4427,4428,2021-08-31 15:00:00+00:00,Frederick,172.0,152347,159.0,140925,13.0,16403,185.0,172.0,157328,168750,293272
4428,4428,4428,4428,4428,4428,4428,4428,4429,2021-09-01 15:00:00+00:00,Frederick,209.0,152556,198.0,141123,32.0,16435,241.0,230.0,157558,168991,293679
4429,4429,4429,4429,4429,4429,4429,4429,4430,2021-09-02 15:00:00+00:00,Frederick,161.0,152717,211.0,141334,11.0,16446,172.0,222.0,157780,169163,294051
4430,4430,4430,4430,4430,4430,4430,4430,4431,2021-09-03 15:00:00+00:00,Frederick,152.0,152869,286.0,141620,20.0,16466,172.0,306.0,158086,169335,294489
4431,4431,4431,4431,4431,4431,4431,4431,4432,2021-09-04 15:00:00+00:00,Frederick,143.0,153012,174.0,141794,12.0,16478,155.0,186.0,158272,169490,294806
4432,4432,4432,4432,4432,4432,4432,4432,4433,2021-09-05 15:00:00+00:00,Frederick,68.0,153080,84.0,141878,1.0,16479,69.0,85.0,158357,169559,294958
4433,4433,4433,4433,4433,4433,4433,4433,4434,2021-09-06 15:00:00+00:00,Frederick,40.0,153120,69.0,141947,12.0,16491,52.0,81.0,158438,169611,295067
4434,4434,4434,4434,4434,4434,4434,4434,4435,2021-09-07 15:00:00+00:00,Frederick,142.0,153262,234.0,142181,5.0,16496,147.0,239.0,158677,169758,295443
4435,4435,4435,4435,4435,4435,4435,4435,4436,2021-09-08 15:00:00+00:00,Frederick,143.0,153405,175.0,142356,14.0,16510,157.0,189.0,158866,169915,295761
4436,4436,4436,4436,4436,4436,4436,4436,4437,2021-07-07 15:00:00+00:00,Dorchester,19.0,13001,19.0,11812,,2073,,,13885,15074,24813
4437,4437,4437,4437,4437,4437,4437,4437,4438,2021-07-08 15:00:00+00:00,Dorchester,68.0,13069,30.0,11842,3.0,2076,71.0,33.0,13918,15145,24911
4438,4438,4438,4438,4438,4438,4438,4438,4439,2021-07-09 15:00:00+00:00,Dorchester,18.0,13087,16.0,11858,1.0,2077,19.0,17.0,13935,15164,24945
4439,4439,4439,4439,4439,4439,4439,4439,4440,2021-07-10 15:00:00+00:00,Dorchester,5.0,13092,11.0,11869,1.0,2078,6.0,12.0,13947,15170,24961
4440,4440,4440,4440,4440,4440,4440,4440,4441,2021-07-11 15:00:00+00:00,Dorchester,9.0,13101,6.0,11875,,2078,,,13953,15179,24976
4441,4441,4441,4441,4441,4441,4441,4441,4442,2021-07-12 15:00:00+00:00,Dorchester,13.0,13114,13.0,11888,1.0,2079,14.0,14.0,13967,15193,25002
4442,4442,4442,4442,4442,4442,4442,4442,4443,2021-07-13 15:00:00+00:00,Dorchester,12.0,13126,35.0,11923,2.0,2081,14.0,37.0,14004,15207,25049
4443,4443,4443,4443,4443,4443,4443,4443,4444,2021-07-14 15:00:00+00:00,Dorchester,33.0,13159,49.0,11972,1.0,2082,34.0,50.0,14054,15241,25131
4444,4444,4444,4444,4444,4444,4444,4444,4445,2021-07-15 15:00:00+00:00,Dorchester,19.0,13178,27.0,11999,2.0,2084,21.0,29.0,14083,15262,25177
4445,4445,4445,4445,4445,4445,4445,4445,4446,2021-07-16 15:00:00+00:00,Dorchester,25.0,13203,24.0,12023,2.0,2086,27.0,26.0,14109,15289,25226
4446,4446,4446,4446,4446,4446,4446,4446,4447,2021-07-17 15:00:00+00:00,Dorchester,15.0,13218,10.0,12033,,2086,,,14119,15304,25251
4447,4447,4447,4447,4447,4447,4447,4447,4448,2021-07-18 15:00:00+00:00,Dorchester,2.0,13220,,12033,,2086,,,14119,15306,25253
4448,4448,4448,4448,4448,4448,4448,4448,4449,2021-07-19 15:00:00+00:00,Dorchester,36.0,13256,6.0,12039,11.0,2097,47.0,17.0,14136,15353,25295
4449,4449,4449,4449,4449,4449,4449,4449,4450,2021-07-20 15:00:00+00:00,Dorchester,15.0,13271,17.0,12056,1.0,2098,16.0,18.0,14154,15369,25327
4450,4450,4450,4450,4450,4450,4450,4450,4451,2021-07-21 15:00:00+00:00,Dorchester,23.0,13294,53.0,12109,,2098,,,14207,15392,25403
4451,4451,4451,4451,4451,4451,4451,4451,4452,2021-07-22 15:00:00+00:00,Dorchester,50.0,13344,38.0,12147,3.0,2101,53.0,41.0,14248,15445,25491
4452,4452,4452,4452,4452,4452,4452,4452,4453,2021-07-23 15:00:00+00:00,Dorchester,40.0,13384,19.0,12166,,2101,,,14267,15485,25550
4453,4453,4453,4453,4453,4453,4453,4453,4454,2021-07-24 15:00:00+00:00,Dorchester,15.0,13399,10.0,12176,,2101,,,14277,15500,25575
4454,4454,4454,4454,4454,4454,4454,4454,4455,2021-07-25 15:00:00+00:00,Dorchester,7.0,13406,3.0,12179,,2101,,,14280,15507,25585
4455,4455,4455,4455,4455,4455,4455,4455,4456,2021-07-26 15:00:00+00:00,Dorchester,24.0,13430,11.0,12190,3.0,2104,27.0,14.0,14294,15534,25620
4456,4456,4456,4456,4456,4456,4456,4456,4457,2021-07-27 15:00:00+00:00,Dorchester,31.0,13461,17.0,12207,2.0,2106,33.0,19.0,14313,15567,25668
4457,4457,4457,4457,4457,4457,4457,4457,4458,2021-07-28 15:00:00+00:00,Dorchester,36.0,13497,17.0,12224,2.0,2108,38.0,19.0,14332,15605,25721
4458,4458,4458,4458,4458,4458,4458,4458,4459,2021-07-29 15:00:00+00:00,Dorchester,39.0,13536,26.0,12250,4.0,2112,43.0,30.0,14362,15648,25786
4459,4459,4459,4459,4459,4459,4459,4459,4460,2021-07-30 15:00:00+00:00,Dorchester,32.0,13568,14.0,12264,4.0,2116,36.0,18.0,14380,15684,25832
4460,4460,4460,4460,4460,4460,4460,4460,4461,2021-07-31 15:00:00+00:00,Dorchester,12.0,13580,6.0,12270,,2116,,,14386,15696,25850
4461,4461,4461,4461,4461,4461,4461,4461,4462,2021-08-01 15:00:00+00:00,Dorchester,11.0,13591,8.0,12278,,2116,,,14394,15707,25869
4462,4462,4462,4462,4462,4462,4462,4462,4463,2021-08-02 15:00:00+00:00,Dorchester,36.0,13627,8.0,12286,6.0,2122,42.0,14.0,14408,15749,25913
4463,4463,4463,4463,4463,4463,4463,4463,4464,2021-08-03 15:00:00+00:00,Dorchester,45.0,13672,6.0,12292,14.0,2136,59.0,20.0,14428,15808,25964
4464,4464,4464,4464,4464,4464,4464,4464,4465,2021-08-04 15:00:00+00:00,Dorchester,59.0,13731,25.0,12317,7.0,2143,66.0,32.0,14460,15874,26048
4465,4465,4465,4465,4465,4465,4465,4465,4466,2021-08-05 15:00:00+00:00,Dorchester,62.0,13793,20.0,12337,1.0,2144,63.0,21.0,14481,15937,26130
4466,4466,4466,4466,4466,4466,4466,4466,4467,2021-08-06 15:00:00+00:00,Dorchester,33.0,13826,16.0,12353,3.0,2147,36.0,19.0,14500,15973,26179
4467,4467,4467,4467,4467,4467,4467,4467,4468,2021-08-07 15:00:00+00:00,Dorchester,21.0,13847,4.0,12357,,2147,,,14504,15994,26204
4468,4468,4468,4468,4468,4468,4468,4468,4469,2021-08-08 15:00:00+00:00,Dorchester,14.0,13861,6.0,12363,1.0,2148,15.0,7.0,14511,16009,26224
4469,4469,4469,4469,4469,4469,4469,4469,4470,2021-08-09 15:00:00+00:00,Dorchester,35.0,13896,23.0,12386,9.0,2157,44.0,32.0,14543,16053,26282
4470,4470,4470,4470,4470,4470,4470,4470,4471,2021-08-10 15:00:00+00:00,Dorchester,37.0,13933,14.0,12400,3.0,2160,40.0,17.0,14560,16093,26333
4471,4471,4471,4471,4471,4471,4471,4471,4472,2021-08-11 15:00:00+00:00,Dorchester,34.0,13967,21.0,12421,4.0,2164,38.0,25.0,14585,16131,26388
4472,4472,4472,4472,4472,4472,4472,4472,4473,2021-08-12 15:00:00+00:00,Dorchester,31.0,13998,20.0,12441,3.0,2167,34.0,23.0,14608,16165,26439
4473,4473,4473,4473,4473,4473,4473,4473,4474,2021-08-13 15:00:00+00:00,Dorchester,51.0,14049,37.0,12478,2.0,2169,53.0,39.0,14647,16218,26527
4474,4474,4474,4474,4474,4474,4474,4474,4475,2021-08-14 15:00:00+00:00,Dorchester,16.0,14065,4.0,12482,1.0,2170,17.0,5.0,14652,16235,26547
4475,4475,4475,4475,4475,4475,4475,4475,4476,2021-08-15 15:00:00+00:00,Dorchester,10.0,14075,6.0,12488,1.0,2171,11.0,7.0,14659,16246,26563
4476,4476,4476,4476,4476,4476,4476,4476,4477,2021-08-16 15:00:00+00:00,Dorchester,28.0,14103,33.0,12521,2.0,2173,30.0,35.0,14694,16276,26624
4477,4477,4477,4477,4477,4477,4477,4477,4478,2021-08-17 15:00:00+00:00,Dorchester,38.0,14141,23.0,12544,2.0,2175,40.0,25.0,14719,16316,26685
4478,4478,4478,4478,4478,4478,4478,4478,4479,2021-08-18 15:00:00+00:00,Dorchester,28.0,14169,30.0,12574,3.0,2178,31.0,33.0,14752,16347,26743
4479,4479,4479,4479,4479,4479,4479,4479,4480,2021-08-19 15:00:00+00:00,Dorchester,49.0,14218,32.0,12606,11.0,2189,60.0,43.0,14795,16407,26824
4480,4480,4480,4480,4480,4480,4480,4480,4481,2021-08-20 15:00:00+00:00,Dorchester,25.0,14243,23.0,12629,5.0,2194,30.0,28.0,14823,16437,26872
4481,4481,4481,4481,4481,4481,4481,4481,4482,2021-08-21 15:00:00+00:00,Dorchester,18.0,14261,10.0,12639,,2194,,,14833,16455,26900
4482,4482,4482,4482,4482,4482,4482,4482,4483,2021-08-22 15:00:00+00:00,Dorchester,12.0,14273,6.0,12645,,2194,,,14839,16467,26918
4483,4483,4483,4483,4483,4483,4483,4483,4484,2021-08-23 15:00:00+00:00,Dorchester,14.0,14287,28.0,12673,3.0,2197,17.0,31.0,14870,16484,26960
4484,4484,4484,4484,4484,4484,4484,4484,4485,2021-08-24 15:00:00+00:00,Dorchester,59.0,14346,25.0,12698,8.0,2205,67.0,33.0,14903,16551,27044
4485,4485,4485,4485,4485,4485,4485,4485,4486,2021-08-25 15:00:00+00:00,Dorchester,38.0,14384,31.0,12729,2.0,2207,40.0,33.0,14936,16591,27113
4486,4486,4486,4486,4486,4486,4486,4486,4487,2021-08-26 15:00:00+00:00,Dorchester,56.0,14440,66.0,12795,2.0,2209,58.0,68.0,15004,16649,27235
4487,4487,4487,4487,4487,4487,4487,4487,4488,2021-08-27 15:00:00+00:00,Dorchester,30.0,14470,36.0,12831,9.0,2218,39.0,45.0,15049,16688,27301
4488,4488,4488,4488,4488,4488,4488,4488,4489,2021-08-28 15:00:00+00:00,Dorchester,11.0,14481,15.0,12846,,2218,,,15064,16699,27327
4489,4489,4489,4489,4489,4489,4489,4489,4490,2021-08-29 15:00:00+00:00,Dorchester,18.0,14499,17.0,12863,,2218,,,15081,16717,27362
4490,4490,4490,4490,4490,4490,4490,4490,4491,2021-08-30 15:00:00+00:00,Dorchester,24.0,14523,31.0,12894,4.0,2222,28.0,35.0,15116,16745,27417
4491,4491,4491,4491,4491,4491,4491,4491,4492,2021-08-31 15:00:00+00:00,Dorchester,35.0,14558,28.0,12922,1.0,2223,36.0,29.0,15145,16781,27480
4492,4492,4492,4492,4492,4492,4492,4492,4493,2021-03-21 15:00:00+00:00,Queen Anne's,158.0,12903,55.0,6987,1.0,409,159.0,56.0,7396,13312,19890
4493,4493,4493,4493,4493,4493,4493,4493,4494,2021-03-22 15:00:00+00:00,Queen Anne's,235.0,13138,59.0,7046,4.0,413,239.0,63.0,7459,13551,20184
4494,4494,4494,4494,4494,4494,4494,4494,4495,2021-03-23 15:00:00+00:00,Queen Anne's,180.0,13318,75.0,7121,2.0,415,182.0,77.0,7536,13733,20439
4495,4495,4495,4495,4495,4495,4495,4495,4496,2021-03-24 15:00:00+00:00,Queen Anne's,306.0,13624,288.0,7409,2.0,417,308.0,290.0,7826,14041,21033
4496,4496,4496,4496,4496,4496,4496,4496,4497,2021-03-25 15:00:00+00:00,Queen Anne's,300.0,13924,135.0,7544,7.0,424,307.0,142.0,7968,14348,21468
4497,4497,4497,4497,4497,4497,4497,4497,4498,2021-03-26 15:00:00+00:00,Queen Anne's,611.0,14535,475.0,8019,5.0,429,616.0,480.0,8448,14964,22554
4498,4498,4498,4498,4498,4498,4498,4498,4499,2021-03-27 15:00:00+00:00,Queen Anne's,99.0,14634,83.0,8102,85.0,514,184.0,168.0,8616,15148,22736
4499,4499,4499,4499,4499,4499,4499,4499,4500,2021-03-28 15:00:00+00:00,Queen Anne's,121.0,14755,103.0,8205,8.0,522,129.0,111.0,8727,15277,22960
4500,4500,4500,4500,4500,4500,4500,4500,4501,2021-03-29 15:00:00+00:00,Queen Anne's,327.0,15082,151.0,8356,59.0,581,386.0,210.0,8937,15663,23438
4501,4501,4501,4501,4501,4501,4501,4501,4502,2021-03-30 15:00:00+00:00,Queen Anne's,195.0,15277,146.0,8502,47.0,628,242.0,193.0,9130,15905,23779
4502,4502,4502,4502,4502,4502,4502,4502,4503,2021-03-31 15:00:00+00:00,Queen Anne's,574.0,15851,485.0,8987,49.0,677,623.0,534.0,9664,16528,24838
4503,4503,4503,4503,4503,4503,4503,4503,4504,2021-04-01 15:00:00+00:00,Queen Anne's,251.0,16102,193.0,9180,118.0,795,369.0,311.0,9975,16897,25282
4504,4504,4504,4504,4504,4504,4504,4504,4505,2021-04-02 15:00:00+00:00,Queen Anne's,247.0,16349,143.0,9323,29.0,824,276.0,172.0,10147,17173,25672
4505,4505,4505,4505,4505,4505,4505,4505,4506,2021-04-03 15:00:00+00:00,Queen Anne's,183.0,16532,78.0,9401,100.0,924,283.0,178.0,10325,17456,25933
4506,4506,4506,4506,4506,4506,4506,4506,4507,2021-04-04 15:00:00+00:00,Queen Anne's,59.0,16591,90.0,9491,1.0,925,60.0,91.0,10416,17516,26082
4507,4507,4507,4507,4507,4507,4507,4507,4508,2021-04-05 15:00:00+00:00,Queen Anne's,128.0,16719,140.0,9631,69.0,994,197.0,209.0,10625,17713,26350
4508,4508,4508,4508,4508,4508,4508,4508,4509,2021-04-06 15:00:00+00:00,Queen Anne's,142.0,16861,193.0,9824,102.0,1096,244.0,295.0,10920,17957,26685
4509,4509,4509,4509,4509,4509,4509,4509,4510,2021-04-07 15:00:00+00:00,Queen Anne's,242.0,17103,192.0,10016,118.0,1214,360.0,310.0,11230,18317,27119
4510,4510,4510,4510,4510,4510,4510,4510,4511,2021-04-08 15:00:00+00:00,Queen Anne's,212.0,17315,262.0,10278,169.0,1383,381.0,431.0,11661,18698,27593
4511,4511,4511,4511,4511,4511,4511,4511,4512,2021-04-09 15:00:00+00:00,Queen Anne's,455.0,17770,409.0,10687,76.0,1459,531.0,485.0,12146,19229,28457
4512,4512,4512,4512,4512,4512,4512,4512,4513,2021-04-10 15:00:00+00:00,Queen Anne's,84.0,17854,145.0,10832,89.0,1548,173.0,234.0,12380,19402,28686
4513,4513,4513,4513,4513,4513,4513,4513,4514,2021-04-11 15:00:00+00:00,Queen Anne's,92.0,17946,113.0,10945,22.0,1570,114.0,135.0,12515,19516,28891
4514,4514,4514,4514,4514,4514,4514,4514,4515,2021-04-12 15:00:00+00:00,Queen Anne's,135.0,18081,240.0,11185,68.0,1638,203.0,308.0,12823,19719,29266
4515,4515,4515,4515,4515,4515,4515,4515,4516,2021-04-13 15:00:00+00:00,Queen Anne's,134.0,18215,218.0,11403,1.0,1639,135.0,219.0,13042,19854,29618
4516,4516,4516,4516,4516,4516,4516,4516,4517,2021-04-14 15:00:00+00:00,Queen Anne's,446.0,18661,490.0,11893,,1639,,,13532,20300,30554
4517,4517,4517,4517,4517,4517,4517,4517,4518,2021-04-15 15:00:00+00:00,Queen Anne's,198.0,18859,342.0,12235,4.0,1643,202.0,346.0,13878,20502,31094
4518,4518,4518,4518,4518,4518,4518,4518,4519,2021-04-16 15:00:00+00:00,Queen Anne's,204.0,19063,610.0,12845,,1643,,,14488,20706,31908
4519,4519,4519,4519,4519,4519,4519,4519,4520,2021-04-17 15:00:00+00:00,Queen Anne's,123.0,19186,86.0,12931,,1643,,,14574,20829,32117
4520,4520,4520,4520,4520,4520,4520,4520,4521,2021-09-01 15:00:00+00:00,Dorchester,34.0,14592,28.0,12950,5.0,2228,39.0,33.0,15178,16820,27542
4521,4521,4521,4521,4521,4521,4521,4521,4522,2021-09-02 15:00:00+00:00,Dorchester,44.0,14636,27.0,12977,4.0,2232,48.0,31.0,15209,16868,27613
4522,4522,4522,4522,4522,4522,4522,4522,4523,2021-09-03 15:00:00+00:00,Dorchester,29.0,14665,38.0,13015,1.0,2233,30.0,39.0,15248,16898,27680
4523,4523,4523,4523,4523,4523,4523,4523,4524,2021-09-04 15:00:00+00:00,Dorchester,10.0,14675,24.0,13039,,2233,,,15272,16908,27714
4524,4524,4524,4524,4524,4524,4524,4524,4525,2021-09-05 15:00:00+00:00,Dorchester,8.0,14683,7.0,13046,,2233,,,15279,16916,27729
4525,4525,4525,4525,4525,4525,4525,4525,4526,2021-09-06 15:00:00+00:00,Dorchester,7.0,14690,8.0,13054,,2233,,,15287,16923,27744
4526,4526,4526,4526,4526,4526,4526,4526,4527,2021-09-07 15:00:00+00:00,Dorchester,25.0,14715,41.0,13095,2.0,2235,27.0,43.0,15330,16950,27810
4527,4527,4527,4527,4527,4527,4527,4527,4528,2021-09-08 15:00:00+00:00,Dorchester,22.0,14737,29.0,13124,7.0,2242,29.0,36.0,15366,16979,27861
4528,4528,4528,4528,4528,4528,4528,4528,4529,2021-09-09 15:00:00+00:00,Dorchester,50.0,14787,45.0,13169,1.0,2243,51.0,46.0,15412,17030,27956
4529,4529,4529,4529,4529,4529,4529,4529,4530,2021-09-10 15:00:00+00:00,Dorchester,32.0,14819,39.0,13208,5.0,2248,37.0,44.0,15456,17067,28027
4530,4530,4530,4530,4530,4530,4530,4530,4531,2021-09-11 15:00:00+00:00,Dorchester,15.0,14834,14.0,13222,,2248,,,15470,17082,28056
4531,4531,4531,4531,4531,4531,4531,4531,4532,2021-09-12 15:00:00+00:00,Dorchester,13.0,14847,9.0,13231,,2248,,,15479,17095,28078
4532,4532,4532,4532,4532,4532,4532,4532,4533,2021-09-13 15:00:00+00:00,Dorchester,17.0,14864,14.0,13245,1.0,2249,18.0,15.0,15494,17113,28109
4533,4533,4533,4533,4533,4533,4533,4533,4534,2021-09-14 15:00:00+00:00,Dorchester,21.0,14885,28.0,13273,1.0,2250,22.0,29.0,15523,17135,28158
4534,4534,4534,4534,4534,4534,4534,4534,4535,2021-09-15 15:00:00+00:00,Dorchester,8.0,14893,28.0,13301,9.0,2259,17.0,37.0,15560,17152,28194
4535,4535,4535,4535,4535,4535,4535,4535,4536,2021-09-16 15:00:00+00:00,Dorchester,24.0,14917,42.0,13343,,2259,,,15602,17176,28260
4536,4536,4536,4536,4536,4536,4536,4536,4537,2021-09-17 15:00:00+00:00,Dorchester,19.0,14936,34.0,13377,3.0,2262,22.0,37.0,15639,17198,28313
4537,4537,4537,4537,4537,4537,4537,4537,4538,2021-09-18 15:00:00+00:00,Dorchester,7.0,14943,12.0,13389,,2262,,,15651,17205,28332
4538,4538,4538,4538,4538,4538,4538,4538,4539,2021-09-19 15:00:00+00:00,Dorchester,9.0,14952,14.0,13403,,2262,,,15665,17214,28355
4539,4539,4539,4539,4539,4539,4539,4539,4540,2021-09-20 15:00:00+00:00,Dorchester,16.0,14968,7.0,13410,1.0,2263,17.0,8.0,15673,17231,28378
4540,4540,4540,4540,4540,4540,4540,4540,4541,2021-09-21 15:00:00+00:00,Dorchester,30.0,14998,46.0,13456,,2263,,,15719,17261,28454
4541,4541,4541,4541,4541,4541,4541,4541,4542,2021-09-22 15:00:00+00:00,Dorchester,10.0,15008,32.0,13488,2.0,2265,12.0,34.0,15753,17273,28496
4542,4542,4542,4542,4542,4542,4542,4542,4543,2021-09-23 15:00:00+00:00,Dorchester,18.0,15026,31.0,13519,,2265,,,15784,17291,28545
4543,4543,4543,4543,4543,4543,4543,4543,4544,2021-09-24 15:00:00+00:00,Dorchester,15.0,15041,25.0,13544,,2265,,,15809,17306,28585
4544,4544,4544,4544,4544,4544,4544,4544,4545,2021-09-25 15:00:00+00:00,Dorchester,9.0,15050,18.0,13562,,2265,,,15827,17315,28612
4545,4545,4545,4545,4545,4545,4545,4545,4546,2021-09-26 15:00:00+00:00,Dorchester,4.0,15054,12.0,13574,,2265,,,15839,17319,28628
4546,4546,4546,4546,4546,4546,4546,4546,4547,2021-09-27 15:00:00+00:00,Dorchester,4.0,15058,9.0,13583,1.0,2266,5.0,10.0,15849,17324,28641
4547,4547,4547,4547,4547,4547,4547,4547,4548,2021-09-28 15:00:00+00:00,Dorchester,19.0,15077,31.0,13614,2.0,2268,21.0,33.0,15882,17345,28691
4548,4548,4548,4548,4548,4548,4548,4548,4549,2021-04-18 15:00:00+00:00,Queen Anne's,103.0,19289,115.0,13046,,1643,,,14689,20932,32335
4549,4549,4549,4549,4549,4549,4549,4549,4550,2021-04-19 15:00:00+00:00,Queen Anne's,145.0,19434,320.0,13366,,1643,,,15009,21077,32800
4550,4550,4550,4550,4550,4550,4550,4550,4551,2021-04-20 15:00:00+00:00,Queen Anne's,161.0,19595,215.0,13581,,1643,,,15224,21238,33176
4551,4551,4551,4551,4551,4551,4551,4551,4552,2021-04-21 15:00:00+00:00,Queen Anne's,291.0,19886,272.0,13853,,1643,,,15496,21529,33739
4552,4552,4552,4552,4552,4552,4552,4552,4553,2021-04-22 15:00:00+00:00,Queen Anne's,220.0,20106,298.0,14151,,1643,,,15794,21749,34257
4553,4553,4553,4553,4553,4553,4553,4553,4554,2021-04-23 15:00:00+00:00,Queen Anne's,497.0,20603,548.0,14699,,1643,,,16342,22246,35302
4554,4554,4554,4554,4554,4554,4554,4554,4555,2021-04-24 15:00:00+00:00,Queen Anne's,111.0,20714,185.0,14884,,1643,,,16527,22357,35598
4555,4555,4555,4555,4555,4555,4555,4555,4556,2021-04-25 15:00:00+00:00,Queen Anne's,67.0,20781,34.0,14918,2.0,1645,69.0,36.0,16563,22426,35699
4556,4556,4556,4556,4556,4556,4556,4556,4557,2021-04-26 15:00:00+00:00,Queen Anne's,66.0,20847,167.0,15085,6.0,1651,72.0,173.0,16736,22498,35932
4557,4557,4557,4557,4557,4557,4557,4557,4558,2021-04-27 15:00:00+00:00,Queen Anne's,253.0,21100,177.0,15262,11.0,1662,264.0,188.0,16924,22762,36362
4558,4558,4558,4558,4558,4558,4558,4558,4559,2021-04-28 15:00:00+00:00,Queen Anne's,233.0,21333,556.0,15818,18.0,1680,251.0,574.0,17498,23013,37151
4559,4559,4559,4559,4559,4559,4559,4559,4560,2021-04-29 15:00:00+00:00,Queen Anne's,163.0,21496,275.0,16093,12.0,1692,175.0,287.0,17785,23188,37589
4560,4560,4560,4560,4560,4560,4560,4560,4561,2021-04-30 15:00:00+00:00,Queen Anne's,264.0,21760,262.0,16355,3.0,1695,267.0,265.0,18050,23455,38115
4561,4561,4561,4561,4561,4561,4561,4561,4562,2021-05-01 15:00:00+00:00,Queen Anne's,144.0,21904,129.0,16484,3.0,1698,147.0,132.0,18182,23602,38388
4562,4562,4562,4562,4562,4562,4562,4562,4563,2021-05-02 15:00:00+00:00,Queen Anne's,35.0,21939,78.0,16562,3.0,1701,38.0,81.0,18263,23640,38501
4563,4563,4563,4563,4563,4563,4563,4563,4564,2021-05-03 15:00:00+00:00,Queen Anne's,29.0,21968,111.0,16673,19.0,1720,48.0,130.0,18393,23688,38641
4564,4564,4564,4564,4564,4564,4564,4564,4565,2021-05-04 15:00:00+00:00,Queen Anne's,82.0,22050,128.0,16801,19.0,1739,101.0,147.0,18540,23789,38851
4565,4565,4565,4565,4565,4565,4565,4565,4566,2021-05-05 15:00:00+00:00,Queen Anne's,89.0,22139,197.0,16998,20.0,1759,109.0,217.0,18757,23898,39137
4566,4566,4566,4566,4566,4566,4566,4566,4567,2021-05-06 15:00:00+00:00,Queen Anne's,116.0,22255,319.0,17317,13.0,1772,129.0,332.0,19089,24027,39572
4567,4567,4567,4567,4567,4567,4567,4567,4568,2021-05-07 15:00:00+00:00,Queen Anne's,53.0,22308,180.0,17497,12.0,1784,65.0,192.0,19281,24092,39805
4568,4568,4568,4568,4568,4568,4568,4568,4569,2021-05-08 15:00:00+00:00,Queen Anne's,26.0,22334,57.0,17554,5.0,1789,31.0,62.0,19343,24123,39888
4569,4569,4569,4569,4569,4569,4569,4569,4570,2021-05-09 15:00:00+00:00,Queen Anne's,26.0,22360,75.0,17629,2.0,1791,28.0,77.0,19420,24151,39989
4570,4570,4570,4570,4570,4570,4570,4570,4571,2021-05-10 15:00:00+00:00,Queen Anne's,45.0,22405,102.0,17731,10.0,1801,55.0,112.0,19532,24206,40136
4571,4571,4571,4571,4571,4571,4571,4571,4572,2021-05-11 15:00:00+00:00,Queen Anne's,49.0,22454,112.0,17843,10.0,1811,59.0,122.0,19654,24265,40297
4572,4572,4572,4572,4572,4572,4572,4572,4573,2021-05-12 15:00:00+00:00,Queen Anne's,76.0,22530,430.0,18273,99.0,1910,175.0,529.0,20183,24440,40803
4573,4573,4573,4573,4573,4573,4573,4573,4574,2021-05-13 15:00:00+00:00,Queen Anne's,96.0,22626,377.0,18650,12.0,1922,108.0,389.0,20572,24548,41276
4574,4574,4574,4574,4574,4574,4574,4574,4575,2021-05-14 15:00:00+00:00,Queen Anne's,93.0,22719,154.0,18804,16.0,1938,109.0,170.0,20742,24657,41523
4575,4575,4575,4575,4575,4575,4575,4575,4576,2021-05-15 15:00:00+00:00,Queen Anne's,89.0,22808,126.0,18930,8.0,1946,97.0,134.0,20876,24754,41738
4576,4576,4576,4576,4576,4576,4576,4576,4577,2021-09-29 15:00:00+00:00,Dorchester,17.0,15094,25.0,13639,1.0,2269,18.0,26.0,15908,17363,28733
4577,4577,4577,4577,4577,4577,4577,4577,4578,2021-09-30 15:00:00+00:00,Dorchester,23.0,15117,42.0,13681,2.0,2271,25.0,44.0,15952,17388,28798
4578,4578,4578,4578,4578,4578,4578,4578,4579,2021-10-01 15:00:00+00:00,Dorchester,18.0,15135,26.0,13707,2.0,2273,20.0,28.0,15980,17408,28842
4579,4579,4579,4579,4579,4579,4579,4579,4580,2021-10-02 15:00:00+00:00,Dorchester,12.0,15147,19.0,13726,,2273,,,15999,17420,28873
4580,4580,4580,4580,4580,4580,4580,4580,4581,2021-10-03 15:00:00+00:00,Dorchester,6.0,15153,10.0,13736,,2273,,,16009,17426,28889
4581,4581,4581,4581,4581,4581,4581,4581,4582,2021-10-04 15:00:00+00:00,Dorchester,19.0,15172,22.0,13758,,2273,,,16031,17445,28930
4582,4582,4582,4582,4582,4582,4582,4582,4583,2021-10-05 15:00:00+00:00,Dorchester,17.0,15189,23.0,13781,1.0,2274,18.0,24.0,16055,17463,28970
4583,4583,4583,4583,4583,4583,4583,4583,4584,2021-10-06 15:00:00+00:00,Dorchester,17.0,15206,8.0,13789,6.0,2280,23.0,14.0,16069,17486,28995
4584,4584,4584,4584,4584,4584,4584,4584,4585,2021-10-07 15:00:00+00:00,Dorchester,10.0,15216,29.0,13818,2.0,2282,12.0,31.0,16100,17498,29034
4585,4585,4585,4585,4585,4585,4585,4585,4586,2021-10-08 15:00:00+00:00,Dorchester,24.0,15240,19.0,13837,2.0,2284,26.0,21.0,16121,17524,29077
4586,4586,4586,4586,4586,4586,4586,4586,4587,2021-10-09 15:00:00+00:00,Dorchester,6.0,15246,8.0,13845,,2284,,,16129,17530,29091
4587,4587,4587,4587,4587,4587,4587,4587,4588,2021-10-10 15:00:00+00:00,Dorchester,1.0,15247,4.0,13849,,2284,,,16133,17531,29096
4588,4588,4588,4588,4588,4588,4588,4588,4589,2021-10-11 15:00:00+00:00,Dorchester,9.0,15256,16.0,13865,1.0,2285,10.0,17.0,16150,17541,29121
4589,4589,4589,4589,4589,4589,4589,4589,4590,2021-10-12 15:00:00+00:00,Dorchester,10.0,15266,12.0,13877,1.0,2286,11.0,13.0,16163,17552,29143
4590,4590,4590,4590,4590,4590,4590,4590,4591,2021-10-13 15:00:00+00:00,Dorchester,18.0,15284,10.0,13887,2.0,2288,20.0,12.0,16175,17572,29171
4591,4591,4591,4591,4591,4591,4591,4591,4592,2021-10-14 15:00:00+00:00,Dorchester,12.0,15296,10.0,13897,2.0,2290,14.0,12.0,16187,17586,29193
4592,4592,4592,4592,4592,4592,4592,4592,4593,2021-10-15 15:00:00+00:00,Dorchester,34.0,15330,18.0,13915,2.0,2292,36.0,20.0,16207,17622,29245
4593,4593,4593,4593,4593,4593,4593,4593,4594,2021-10-16 15:00:00+00:00,Dorchester,7.0,15337,8.0,13923,,2292,,,16215,17629,29260
4594,4594,4594,4594,4594,4594,4594,4594,4595,2021-10-17 15:00:00+00:00,Dorchester,5.0,15342,5.0,13928,1.0,2293,6.0,6.0,16221,17635,29270
4595,4595,4595,4595,4595,4595,4595,4595,4596,2021-10-18 15:00:00+00:00,Dorchester,17.0,15359,16.0,13944,1.0,2294,18.0,17.0,16238,17653,29303
4596,4596,4596,4596,4596,4596,4596,4596,4597,2021-10-19 15:00:00+00:00,Dorchester,10.0,15369,28.0,13972,1.0,2295,11.0,29.0,16267,17664,29341
4597,4597,4597,4597,4597,4597,4597,4597,4598,2021-10-20 15:00:00+00:00,Dorchester,28.0,15397,10.0,13982,2.0,2297,30.0,12.0,16279,17694,29379
4598,4598,4598,4598,4598,4598,4598,4598,4599,2021-10-21 15:00:00+00:00,Dorchester,7.0,15404,21.0,14003,2.0,2299,9.0,23.0,16302,17703,29407
4599,4599,4599,4599,4599,4599,4599,4599,4600,2021-10-22 15:00:00+00:00,Dorchester,10.0,15414,27.0,14030,,2299,,,16329,17713,29444
4600,4600,4600,4600,4600,4600,4600,4600,4601,2021-10-23 15:00:00+00:00,Dorchester,6.0,15420,7.0,14037,1.0,2300,7.0,8.0,16337,17720,29457
4601,4601,4601,4601,4601,4601,4601,4601,4602,2021-10-24 15:00:00+00:00,Dorchester,8.0,15428,6.0,14043,,2300,,,16343,17728,29471
4602,4602,4602,4602,4602,4602,4602,4602,4603,2021-10-25 15:00:00+00:00,Dorchester,20.0,15448,30.0,14073,2.0,2302,22.0,32.0,16375,17750,29521
4603,4603,4603,4603,4603,4603,4603,4603,4604,2021-10-26 15:00:00+00:00,Dorchester,12.0,15460,36.0,14109,,2302,,,16411,17762,29569
4604,4604,4604,4604,4604,4604,4604,4604,4605,2021-05-16 15:00:00+00:00,Queen Anne's,84.0,22892,84.0,19014,5.0,1951,89.0,89.0,20965,24843,41906
4605,4605,4605,4605,4605,4605,4605,4605,4606,2021-05-17 15:00:00+00:00,Queen Anne's,107.0,22999,98.0,19112,23.0,1974,130.0,121.0,21086,24973,42111
4606,4606,4606,4606,4606,4606,4606,4606,4607,2021-05-18 15:00:00+00:00,Queen Anne's,129.0,23128,143.0,19255,18.0,1992,147.0,161.0,21247,25120,42383
4607,4607,4607,4607,4607,4607,4607,4607,4608,2021-05-19 15:00:00+00:00,Queen Anne's,239.0,23367,213.0,19468,36.0,2028,275.0,249.0,21496,25395,42835
4608,4608,4608,4608,4608,4608,4608,4608,4609,2021-05-20 15:00:00+00:00,Queen Anne's,129.0,23496,169.0,19637,14.0,2042,143.0,183.0,21679,25538,43133
4609,4609,4609,4609,4609,4609,4609,4609,4610,2021-05-21 15:00:00+00:00,Queen Anne's,75.0,23571,142.0,19779,13.0,2055,88.0,155.0,21834,25626,43350
4610,4610,4610,4610,4610,4610,4610,4610,4611,2021-05-22 15:00:00+00:00,Queen Anne's,60.0,23631,96.0,19875,8.0,2063,68.0,104.0,21938,25694,43506
4611,4611,4611,4611,4611,4611,4611,4611,4612,2021-05-23 15:00:00+00:00,Queen Anne's,57.0,23688,52.0,19927,2.0,2065,59.0,54.0,21992,25753,43615
4612,4612,4612,4612,4612,4612,4612,4612,4613,2021-05-24 15:00:00+00:00,Queen Anne's,79.0,23767,57.0,19984,10.0,2075,89.0,67.0,22059,25842,43751
4613,4613,4613,4613,4613,4613,4613,4613,4614,2021-05-25 15:00:00+00:00,Queen Anne's,96.0,23863,424.0,20408,21.0,2096,117.0,445.0,22504,25959,44271
4614,4614,4614,4614,4614,4614,4614,4614,4615,2021-05-26 15:00:00+00:00,Queen Anne's,103.0,23966,333.0,20741,39.0,2135,142.0,372.0,22876,26101,44707
4615,4615,4615,4615,4615,4615,4615,4615,4616,2021-05-27 15:00:00+00:00,Queen Anne's,55.0,24021,239.0,20980,21.0,2156,76.0,260.0,23136,26177,45001
4616,4616,4616,4616,4616,4616,4616,4616,4617,2021-05-28 15:00:00+00:00,Queen Anne's,31.0,24052,60.0,21040,6.0,2162,37.0,66.0,23202,26214,45092
4617,4617,4617,4617,4617,4617,4617,4617,4618,2021-05-29 15:00:00+00:00,Queen Anne's,49.0,24101,47.0,21087,4.0,2166,53.0,51.0,23253,26267,45188
4618,4618,4618,4618,4618,4618,4618,4618,4619,2021-05-30 15:00:00+00:00,Queen Anne's,16.0,24117,58.0,21145,,2166,,,23311,26283,45262
4619,4619,4619,4619,4619,4619,4619,4619,4620,2021-05-31 15:00:00+00:00,Queen Anne's,7.0,24124,18.0,21163,1.0,2167,8.0,19.0,23330,26291,45287
4620,4620,4620,4620,4620,4620,4620,4620,4621,2021-06-01 15:00:00+00:00,Queen Anne's,63.0,24187,83.0,21246,13.0,2180,76.0,96.0,23426,26367,45433
4621,4621,4621,4621,4621,4621,4621,4621,4622,2021-06-02 15:00:00+00:00,Queen Anne's,51.0,24238,104.0,21350,7.0,2187,58.0,111.0,23537,26425,45588
4622,4622,4622,4622,4622,4622,4622,4622,4623,2021-06-03 15:00:00+00:00,Queen Anne's,43.0,24281,144.0,21494,7.0,2194,50.0,151.0,23688,26475,45775
4623,4623,4623,4623,4623,4623,4623,4623,4624,2021-06-04 15:00:00+00:00,Queen Anne's,27.0,24308,84.0,21578,8.0,2202,35.0,92.0,23780,26510,45886
4624,4624,4624,4624,4624,4624,4624,4624,4625,2021-06-05 15:00:00+00:00,Queen Anne's,16.0,24324,78.0,21656,3.0,2205,19.0,81.0,23861,26529,45980
4625,4625,4625,4625,4625,4625,4625,4625,4626,2021-06-06 15:00:00+00:00,Queen Anne's,10.0,24334,71.0,21727,3.0,2208,13.0,74.0,23935,26542,46061
4626,4626,4626,4626,4626,4626,4626,4626,4627,2021-06-07 15:00:00+00:00,Queen Anne's,31.0,24365,107.0,21834,14.0,2222,45.0,121.0,24056,26587,46199
4627,4627,4627,4627,4627,4627,4627,4627,4628,2021-06-08 15:00:00+00:00,Queen Anne's,26.0,24391,130.0,21964,1.0,2223,27.0,131.0,24187,26614,46355
4628,4628,4628,4628,4628,4628,4628,4628,4629,2021-06-09 15:00:00+00:00,Queen Anne's,48.0,24439,179.0,22143,6.0,2229,54.0,185.0,24372,26668,46582
4629,4629,4629,4629,4629,4629,4629,4629,4630,2021-06-10 15:00:00+00:00,Queen Anne's,34.0,24473,139.0,22282,8.0,2237,42.0,147.0,24519,26710,46755
4630,4630,4630,4630,4630,4630,4630,4630,4631,2021-06-11 15:00:00+00:00,Queen Anne's,40.0,24513,89.0,22371,3.0,2240,43.0,92.0,24611,26753,46884
4631,4631,4631,4631,4631,4631,4631,4631,4632,2021-06-12 15:00:00+00:00,Queen Anne's,16.0,24529,45.0,22416,1.0,2241,17.0,46.0,24657,26770,46945
4632,4632,4632,4632,4632,4632,4632,4632,4633,2021-10-27 15:00:00+00:00,Dorchester,16.0,15476,32.0,14141,,2302,,,16443,17778,29617
4633,4633,4633,4633,4633,4633,4633,4633,4634,2021-10-28 15:00:00+00:00,Dorchester,13.0,15489,28.0,14169,,2302,,,16471,17791,29658
4634,4634,4634,4634,4634,4634,4634,4634,4635,2021-10-29 15:00:00+00:00,Dorchester,17.0,15506,31.0,14200,1.0,2303,18.0,32.0,16503,17809,29706
4635,4635,4635,4635,4635,4635,4635,4635,4636,2021-10-30 15:00:00+00:00,Dorchester,6.0,15512,18.0,14218,,2303,,,16521,17815,29730
4636,4636,4636,4636,4636,4636,4636,4636,4637,2021-10-31 15:00:00+00:00,Dorchester,3.0,15515,10.0,14228,,2303,,,16531,17818,29743
4637,4637,4637,4637,4637,4637,4637,4637,4638,2021-11-01 15:00:00+00:00,Dorchester,14.0,15529,19.0,14247,,2303,,,16550,17832,29776
4638,4638,4638,4638,4638,4638,4638,4638,4639,2021-11-02 15:00:00+00:00,Dorchester,18.0,15547,18.0,14265,,2303,,,16568,17850,29812
4639,4639,4639,4639,4639,4639,4639,4639,4640,2021-11-03 15:00:00+00:00,Dorchester,7.0,15554,24.0,14289,2.0,2305,9.0,26.0,16594,17859,29843
4640,4640,4640,4640,4640,4640,4640,4640,4641,2021-11-04 15:00:00+00:00,Dorchester,15.0,15569,30.0,14319,1.0,2306,16.0,31.0,16625,17875,29888
4641,4641,4641,4641,4641,4641,4641,4641,4642,2021-11-05 15:00:00+00:00,Dorchester,12.0,15581,39.0,14358,2.0,2308,14.0,41.0,16666,17889,29939
4642,4642,4642,4642,4642,4642,4642,4642,4643,2021-11-06 15:00:00+00:00,Dorchester,2.0,15583,,14358,,2308,,,16666,17891,29941
4643,4643,4643,4643,4643,4643,4643,4643,4644,2020-12-17 15:00:00+00:00,Somerset,11.0,11,,0,,0,,,0,11,11
4644,4644,4644,4644,4644,4644,4644,4644,4645,2020-12-18 15:00:00+00:00,Somerset,40.0,51,,0,,0,,,0,51,51
4645,4645,4645,4645,4645,4645,4645,4645,4646,2020-12-19 15:00:00+00:00,Somerset,11.0,62,,0,,0,,,0,62,62
4646,4646,4646,4646,4646,4646,4646,4646,4647,2020-12-21 15:00:00+00:00,Somerset,1.0,63,,0,,0,,,0,63,63
4647,4647,4647,4647,4647,4647,4647,4647,4648,2020-12-22 15:00:00+00:00,Somerset,9.0,72,,0,,0,,,0,72,72
4648,4648,4648,4648,4648,4648,4648,4648,4649,2020-12-23 15:00:00+00:00,Somerset,20.0,92,,0,,0,,,0,92,92
4649,4649,4649,4649,4649,4649,4649,4649,4650,2020-12-24 15:00:00+00:00,Somerset,11.0,103,,0,,0,,,0,103,103
4650,4650,4650,4650,4650,4650,4650,4650,4651,2020-12-26 15:00:00+00:00,Somerset,1.0,104,,0,,0,,,0,104,104
4651,4651,4651,4651,4651,4651,4651,4651,4652,2020-12-27 15:00:00+00:00,Somerset,84.0,188,1.0,1,,0,,,1,188,189
4652,4652,4652,4652,4652,4652,4652,4652,4653,2020-12-28 15:00:00+00:00,Somerset,104.0,292,1.0,2,,0,,,2,292,294
4653,4653,4653,4653,4653,4653,4653,4653,4654,2020-12-29 15:00:00+00:00,Somerset,44.0,336,,2,,0,,,2,336,338
4654,4654,4654,4654,4654,4654,4654,4654,4655,2020-12-30 15:00:00+00:00,Somerset,46.0,382,,2,,0,,,2,382,384
4655,4655,4655,4655,4655,4655,4655,4655,4656,2020-12-31 15:00:00+00:00,Somerset,22.0,404,,2,,0,,,2,404,406
4656,4656,4656,4656,4656,4656,4656,4656,4657,2021-01-01 15:00:00+00:00,Somerset,6.0,410,1.0,3,,0,,,3,410,413
4657,4657,4657,4657,4657,4657,4657,4657,4658,2021-01-02 15:00:00+00:00,Somerset,6.0,416,,3,,0,,,3,416,419
4658,4658,4658,4658,4658,4658,4658,4658,4659,2021-01-03 15:00:00+00:00,Somerset,3.0,419,,3,,0,,,3,419,422
4659,4659,4659,4659,4659,4659,4659,4659,4660,2021-01-04 15:00:00+00:00,Somerset,9.0,428,,3,,0,,,3,428,431
4660,4660,4660,4660,4660,4660,4660,4660,4661,2021-01-05 15:00:00+00:00,Somerset,23.0,451,,3,,0,,,3,451,454
4661,4661,4661,4661,4661,4661,4661,4661,4662,2021-01-06 15:00:00+00:00,Somerset,98.0,549,,3,,0,,,3,549,552
4662,4662,4662,4662,4662,4662,4662,4662,4663,2021-01-07 15:00:00+00:00,Somerset,19.0,568,15.0,18,,0,,,18,568,586
4663,4663,4663,4663,4663,4663,4663,4663,4664,2021-01-08 15:00:00+00:00,Somerset,58.0,626,32.0,50,,0,,,50,626,676
4664,4664,4664,4664,4664,4664,4664,4664,4665,2021-01-09 15:00:00+00:00,Somerset,58.0,684,14.0,64,,0,,,64,684,748
4665,4665,4665,4665,4665,4665,4665,4665,4666,2021-01-10 15:00:00+00:00,Somerset,1.0,685,,64,,0,,,64,685,749
4666,4666,4666,4666,4666,4666,4666,4666,4667,2021-01-11 15:00:00+00:00,Somerset,13.0,698,,64,,0,,,64,698,762
4667,4667,4667,4667,4667,4667,4667,4667,4668,2021-01-12 15:00:00+00:00,Somerset,17.0,715,4.0,68,,0,,,68,715,783
4668,4668,4668,4668,4668,4668,4668,4668,4669,2021-01-13 15:00:00+00:00,Somerset,73.0,788,20.0,88,,0,,,88,788,876
4669,4669,4669,4669,4669,4669,4669,4669,4670,2021-01-14 15:00:00+00:00,Somerset,31.0,819,11.0,99,,0,,,99,819,918
4670,4670,4670,4670,4670,4670,4670,4670,4671,2021-01-15 15:00:00+00:00,Somerset,72.0,891,2.0,101,,0,,,101,891,992
4671,4671,4671,4671,4671,4671,4671,4671,4672,2021-01-16 15:00:00+00:00,Somerset,4.0,895,,101,,0,,,101,895,996
4672,4672,4672,4672,4672,4672,4672,4672,4673,2021-01-17 15:00:00+00:00,Somerset,37.0,932,81.0,182,,0,,,182,932,1114
4673,4673,4673,4673,4673,4673,4673,4673,4674,2021-01-18 15:00:00+00:00,Somerset,34.0,966,74.0,256,,0,,,256,966,1222
4674,4674,4674,4674,4674,4674,4674,4674,4675,2021-01-19 15:00:00+00:00,Somerset,39.0,1005,12.0,268,,0,,,268,1005,1273
4675,4675,4675,4675,4675,4675,4675,4675,4676,2021-01-20 15:00:00+00:00,Somerset,228.0,1233,2.0,270,,0,,,270,1233,1503
4676,4676,4676,4676,4676,4676,4676,4676,4677,2021-01-21 15:00:00+00:00,Somerset,72.0,1305,3.0,273,,0,,,273,1305,1578
4677,4677,4677,4677,4677,4677,4677,4677,4678,2021-01-22 15:00:00+00:00,Somerset,204.0,1509,7.0,280,,0,,,280,1509,1789
4678,4678,4678,4678,4678,4678,4678,4678,4679,2021-01-23 15:00:00+00:00,Somerset,154.0,1663,4.0,284,,0,,,284,1663,1947
4679,4679,4679,4679,4679,4679,4679,4679,4680,2021-01-24 15:00:00+00:00,Somerset,3.0,1666,2.0,286,,0,,,286,1666,1952
4680,4680,4680,4680,4680,4680,4680,4680,4681,2021-01-25 15:00:00+00:00,Somerset,28.0,1694,18.0,304,,0,,,304,1694,1998
4681,4681,4681,4681,4681,4681,4681,4681,4682,2021-01-26 15:00:00+00:00,Somerset,20.0,1714,33.0,337,,0,,,337,1714,2051
4682,4682,4682,4682,4682,4682,4682,4682,4683,2021-01-27 15:00:00+00:00,Somerset,179.0,1893,45.0,382,,0,,,382,1893,2275
4683,4683,4683,4683,4683,4683,4683,4683,4684,2021-01-28 15:00:00+00:00,Somerset,24.0,1917,17.0,399,,0,,,399,1917,2316
4684,4684,4684,4684,4684,4684,4684,4684,4685,2021-01-29 15:00:00+00:00,Somerset,214.0,2131,15.0,414,,0,,,414,2131,2545
4685,4685,4685,4685,4685,4685,4685,4685,4686,2021-01-30 15:00:00+00:00,Somerset,27.0,2158,53.0,467,,0,,,467,2158,2625
4686,4686,4686,4686,4686,4686,4686,4686,4687,2021-01-31 15:00:00+00:00,Somerset,,2158,1.0,468,,0,,,468,2158,2626
4687,4687,4687,4687,4687,4687,4687,4687,4688,2021-02-01 15:00:00+00:00,Somerset,43.0,2201,4.0,472,,0,,,472,2201,2673
4688,4688,4688,4688,4688,4688,4688,4688,4689,2021-06-13 15:00:00+00:00,Queen Anne's,10.0,24539,47.0,22463,1.0,2242,11.0,48.0,24705,26781,47002
4689,4689,4689,4689,4689,4689,4689,4689,4690,2021-06-14 15:00:00+00:00,Queen Anne's,32.0,24571,77.0,22540,2.0,2244,34.0,79.0,24784,26815,47111
4690,4690,4690,4690,4690,4690,4690,4690,4691,2021-06-15 15:00:00+00:00,Queen Anne's,28.0,24599,105.0,22645,4.0,2248,32.0,109.0,24893,26847,47244
4691,4691,4691,4691,4691,4691,4691,4691,4692,2021-06-16 15:00:00+00:00,Queen Anne's,29.0,24628,108.0,22753,3.0,2251,32.0,111.0,25004,26879,47381
4692,4692,4692,4692,4692,4692,4692,4692,4693,2021-06-17 15:00:00+00:00,Queen Anne's,42.0,24670,80.0,22833,6.0,2257,48.0,86.0,25090,26927,47503
4693,4693,4693,4693,4693,4693,4693,4693,4694,2021-06-18 15:00:00+00:00,Queen Anne's,24.0,24694,53.0,22886,6.0,2263,30.0,59.0,25149,26957,47580
4694,4694,4694,4694,4694,4694,4694,4694,4695,2021-06-19 15:00:00+00:00,Queen Anne's,10.0,24704,41.0,22927,1.0,2264,11.0,42.0,25191,26968,47631
4695,4695,4695,4695,4695,4695,4695,4695,4696,2021-06-20 15:00:00+00:00,Queen Anne's,6.0,24710,17.0,22944,3.0,2267,9.0,20.0,25211,26977,47654
4696,4696,4696,4696,4696,4696,4696,4696,4697,2021-06-21 15:00:00+00:00,Queen Anne's,28.0,24738,28.0,22972,30.0,2297,58.0,58.0,25269,27035,47710
4697,4697,4697,4697,4697,4697,4697,4697,4698,2021-06-22 15:00:00+00:00,Queen Anne's,32.0,24770,55.0,23027,7.0,2304,39.0,62.0,25331,27074,47797
4698,4698,4698,4698,4698,4698,4698,4698,4699,2021-06-23 15:00:00+00:00,Queen Anne's,23.0,24793,52.0,23079,2.0,2306,25.0,54.0,25385,27099,47872
4699,4699,4699,4699,4699,4699,4699,4699,4700,2021-06-24 15:00:00+00:00,Queen Anne's,31.0,24824,41.0,23120,3.0,2309,34.0,44.0,25429,27133,47944
4700,4700,4700,4700,4700,4700,4700,4700,4701,2021-06-25 15:00:00+00:00,Queen Anne's,37.0,24861,33.0,23153,4.0,2313,41.0,37.0,25466,27174,48014
4701,4701,4701,4701,4701,4701,4701,4701,4702,2021-06-26 15:00:00+00:00,Queen Anne's,17.0,24878,21.0,23174,2.0,2315,19.0,23.0,25489,27193,48052
4702,4702,4702,4702,4702,4702,4702,4702,4703,2021-06-27 15:00:00+00:00,Queen Anne's,6.0,24884,23.0,23197,,2315,,,25512,27199,48081
4703,4703,4703,4703,4703,4703,4703,4703,4704,2021-06-28 15:00:00+00:00,Queen Anne's,25.0,24909,27.0,23224,8.0,2323,33.0,35.0,25547,27232,48133
4704,4704,4704,4704,4704,4704,4704,4704,4705,2021-06-29 15:00:00+00:00,Queen Anne's,32.0,24941,41.0,23265,3.0,2326,35.0,44.0,25591,27267,48206
4705,4705,4705,4705,4705,4705,4705,4705,4706,2021-06-30 15:00:00+00:00,Queen Anne's,32.0,24973,50.0,23315,5.0,2331,37.0,55.0,25646,27304,48288
4706,4706,4706,4706,4706,4706,4706,4706,4707,2021-07-01 15:00:00+00:00,Queen Anne's,24.0,24997,35.0,23350,2.0,2333,26.0,37.0,25683,27330,48347
4707,4707,4707,4707,4707,4707,4707,4707,4708,2021-07-02 15:00:00+00:00,Queen Anne's,25.0,25022,20.0,23370,7.0,2340,32.0,27.0,25710,27362,48392
4708,4708,4708,4708,4708,4708,4708,4708,4709,2021-07-03 15:00:00+00:00,Queen Anne's,11.0,25033,17.0,23387,,2340,,,25727,27373,48420
4709,4709,4709,4709,4709,4709,4709,4709,4710,2021-07-04 15:00:00+00:00,Queen Anne's,,25033,6.0,23393,,2340,,,25733,27373,48426
4710,4710,4710,4710,4710,4710,4710,4710,4711,2021-07-05 15:00:00+00:00,Queen Anne's,22.0,25055,24.0,23417,1.0,2341,23.0,25.0,25758,27396,48472
4711,4711,4711,4711,4711,4711,4711,4711,4712,2021-07-06 15:00:00+00:00,Queen Anne's,17.0,25072,25.0,23442,1.0,2342,18.0,26.0,25784,27414,48514
4712,4712,4712,4712,4712,4712,4712,4712,4713,2021-07-07 15:00:00+00:00,Queen Anne's,30.0,25102,35.0,23477,5.0,2347,35.0,40.0,25824,27449,48579
4713,4713,4713,4713,4713,4713,4713,4713,4714,2021-07-08 15:00:00+00:00,Queen Anne's,12.0,25114,31.0,23508,,2347,,,25855,27461,48622
4714,4714,4714,4714,4714,4714,4714,4714,4715,2021-07-09 15:00:00+00:00,Queen Anne's,34.0,25148,38.0,23546,3.0,2350,37.0,41.0,25896,27498,48694
4715,4715,4715,4715,4715,4715,4715,4715,4716,2021-07-10 15:00:00+00:00,Queen Anne's,15.0,25163,14.0,23560,,2350,,,25910,27513,48723
4716,4716,4716,4716,4716,4716,4716,4716,4717,2021-02-02 15:00:00+00:00,Somerset,13.0,2214,26.0,498,,0,,,498,2214,2712
4717,4717,4717,4717,4717,4717,4717,4717,4718,2021-02-03 15:00:00+00:00,Somerset,120.0,2334,86.0,584,,0,,,584,2334,2918
4718,4718,4718,4718,4718,4718,4718,4718,4719,2021-02-04 15:00:00+00:00,Somerset,101.0,2435,22.0,606,,0,,,606,2435,3041
4719,4719,4719,4719,4719,4719,4719,4719,4720,2021-02-05 15:00:00+00:00,Somerset,129.0,2564,82.0,688,,0,,,688,2564,3252
4720,4720,4720,4720,4720,4720,4720,4720,4721,2021-02-06 15:00:00+00:00,Somerset,9.0,2573,2.0,690,,0,,,690,2573,3263
4721,4721,4721,4721,4721,4721,4721,4721,4722,2021-02-07 15:00:00+00:00,Somerset,6.0,2579,26.0,716,,0,,,716,2579,3295
4722,4722,4722,4722,4722,4722,4722,4722,4723,2021-02-08 15:00:00+00:00,Somerset,29.0,2608,40.0,756,,0,,,756,2608,3364
4723,4723,4723,4723,4723,4723,4723,4723,4724,2021-02-09 15:00:00+00:00,Somerset,18.0,2626,21.0,777,,0,,,777,2626,3403
4724,4724,4724,4724,4724,4724,4724,4724,4725,2021-02-10 15:00:00+00:00,Somerset,136.0,2762,70.0,847,,0,,,847,2762,3609
4725,4725,4725,4725,4725,4725,4725,4725,4726,2021-02-11 15:00:00+00:00,Somerset,46.0,2808,60.0,907,,0,,,907,2808,3715
4726,4726,4726,4726,4726,4726,4726,4726,4727,2021-02-12 15:00:00+00:00,Somerset,16.0,2824,1.0,908,,0,,,908,2824,3732
4727,4727,4727,4727,4727,4727,4727,4727,4728,2021-02-13 15:00:00+00:00,Somerset,2.0,2826,6.0,914,,0,,,914,2826,3740
4728,4728,4728,4728,4728,4728,4728,4728,4729,2021-02-15 15:00:00+00:00,Somerset,3.0,2829,22.0,936,,0,,,936,2829,3765
4729,4729,4729,4729,4729,4729,4729,4729,4730,2021-02-16 15:00:00+00:00,Somerset,42.0,2871,47.0,983,,0,,,983,2871,3854
4730,4730,4730,4730,4730,4730,4730,4730,4731,2021-02-17 15:00:00+00:00,Somerset,21.0,2892,229.0,1212,,0,,,1212,2892,4104
4731,4731,4731,4731,4731,4731,4731,4731,4732,2021-02-18 15:00:00+00:00,Somerset,89.0,2981,62.0,1274,,0,,,1274,2981,4255
4732,4732,4732,4732,4732,4732,4732,4732,4733,2021-02-19 15:00:00+00:00,Somerset,37.0,3018,229.0,1503,,0,,,1503,3018,4521
4733,4733,4733,4733,4733,4733,4733,4733,4734,2021-02-20 15:00:00+00:00,Somerset,34.0,3052,144.0,1647,,0,,,1647,3052,4699
4734,4734,4734,4734,4734,4734,4734,4734,4735,2021-02-21 15:00:00+00:00,Somerset,1.0,3053,,1647,,0,,,1647,3053,4700
4735,4735,4735,4735,4735,4735,4735,4735,4736,2021-02-22 15:00:00+00:00,Somerset,136.0,3189,29.0,1676,,0,,,1676,3189,4865
4736,4736,4736,4736,4736,4736,4736,4736,4737,2021-02-23 15:00:00+00:00,Somerset,4.0,3193,29.0,1705,,0,,,1705,3193,4898
4737,4737,4737,4737,4737,4737,4737,4737,4738,2021-02-24 15:00:00+00:00,Somerset,16.0,3209,176.0,1881,,0,,,1881,3209,5090
4738,4738,4738,4738,4738,4738,4738,4738,4739,2021-02-25 15:00:00+00:00,Somerset,132.0,3341,103.0,1984,,0,,,1984,3341,5325
4739,4739,4739,4739,4739,4739,4739,4739,4740,2021-02-26 15:00:00+00:00,Somerset,16.0,3357,234.0,2218,,0,,,2218,3357,5575
4740,4740,4740,4740,4740,4740,4740,4740,4741,2021-02-27 15:00:00+00:00,Somerset,15.0,3372,7.0,2225,,0,,,2225,3372,5597
4741,4741,4741,4741,4741,4741,4741,4741,4742,2021-02-28 15:00:00+00:00,Somerset,7.0,3379,1.0,2226,,0,,,2226,3379,5605
4742,4742,4742,4742,4742,4742,4742,4742,4743,2021-03-01 15:00:00+00:00,Somerset,28.0,3407,30.0,2256,,0,,,2256,3407,5663
4743,4743,4743,4743,4743,4743,4743,4743,4744,2021-03-02 15:00:00+00:00,Somerset,33.0,3440,17.0,2273,,0,,,2273,3440,5713
4744,4744,4744,4744,4744,4744,4744,4744,4745,2021-07-11 15:00:00+00:00,Queen Anne's,9.0,25172,10.0,23570,,2350,,,25920,27522,48742
4745,4745,4745,4745,4745,4745,4745,4745,4746,2021-07-12 15:00:00+00:00,Queen Anne's,23.0,25195,26.0,23596,1.0,2351,24.0,27.0,25947,27546,48791
4746,4746,4746,4746,4746,4746,4746,4746,4747,2021-07-13 15:00:00+00:00,Queen Anne's,33.0,25228,27.0,23623,22.0,2373,55.0,49.0,25996,27601,48851
4747,4747,4747,4747,4747,4747,4747,4747,4748,2021-07-14 15:00:00+00:00,Queen Anne's,26.0,25254,24.0,23647,4.0,2377,30.0,28.0,26024,27631,48901
4748,4748,4748,4748,4748,4748,4748,4748,4749,2021-07-15 15:00:00+00:00,Queen Anne's,19.0,25273,29.0,23676,3.0,2380,22.0,32.0,26056,27653,48949
4749,4749,4749,4749,4749,4749,4749,4749,4750,2021-07-16 15:00:00+00:00,Queen Anne's,21.0,25294,28.0,23704,3.0,2383,24.0,31.0,26087,27677,48998
4750,4750,4750,4750,4750,4750,4750,4750,4751,2021-07-17 15:00:00+00:00,Queen Anne's,16.0,25310,16.0,23720,1.0,2384,17.0,17.0,26104,27694,49030
4751,4751,4751,4751,4751,4751,4751,4751,4752,2021-07-18 15:00:00+00:00,Queen Anne's,10.0,25320,3.0,23723,,2384,,,26107,27704,49043
4752,4752,4752,4752,4752,4752,4752,4752,4753,2021-07-19 15:00:00+00:00,Queen Anne's,28.0,25348,32.0,23755,8.0,2392,36.0,40.0,26147,27740,49103
4753,4753,4753,4753,4753,4753,4753,4753,4754,2021-07-20 15:00:00+00:00,Queen Anne's,29.0,25377,28.0,23783,2.0,2394,31.0,30.0,26177,27771,49160
4754,4754,4754,4754,4754,4754,4754,4754,4755,2021-07-21 15:00:00+00:00,Queen Anne's,30.0,25407,25.0,23808,3.0,2397,33.0,28.0,26205,27804,49215
4755,4755,4755,4755,4755,4755,4755,4755,4756,2021-07-22 15:00:00+00:00,Queen Anne's,81.0,25488,33.0,23841,4.0,2401,85.0,37.0,26242,27889,49329
4756,4756,4756,4756,4756,4756,4756,4756,4757,2021-07-23 15:00:00+00:00,Queen Anne's,39.0,25527,30.0,23871,4.0,2405,43.0,34.0,26276,27932,49398
4757,4757,4757,4757,4757,4757,4757,4757,4758,2021-07-24 15:00:00+00:00,Queen Anne's,24.0,25551,21.0,23892,1.0,2406,25.0,22.0,26298,27957,49443
4758,4758,4758,4758,4758,4758,4758,4758,4759,2021-07-25 15:00:00+00:00,Queen Anne's,18.0,25569,4.0,23896,,2406,,,26302,27975,49465
4759,4759,4759,4759,4759,4759,4759,4759,4760,2021-07-26 15:00:00+00:00,Queen Anne's,39.0,25608,30.0,23926,3.0,2409,42.0,33.0,26335,28017,49534
4760,4760,4760,4760,4760,4760,4760,4760,4761,2021-07-27 15:00:00+00:00,Queen Anne's,33.0,25641,21.0,23947,1.0,2410,34.0,22.0,26357,28051,49588
4761,4761,4761,4761,4761,4761,4761,4761,4762,2021-07-28 15:00:00+00:00,Queen Anne's,53.0,25694,20.0,23967,14.0,2424,67.0,34.0,26391,28118,49661
4762,4762,4762,4762,4762,4762,4762,4762,4763,2021-07-29 15:00:00+00:00,Queen Anne's,78.0,25772,24.0,23991,5.0,2429,83.0,29.0,26420,28201,49763
4763,4763,4763,4763,4763,4763,4763,4763,4764,2021-07-30 15:00:00+00:00,Queen Anne's,64.0,25836,21.0,24012,7.0,2436,71.0,28.0,26448,28272,49848
4764,4764,4764,4764,4764,4764,4764,4764,4765,2021-07-31 15:00:00+00:00,Queen Anne's,25.0,25861,15.0,24027,,2436,,,26463,28297,49888
4765,4765,4765,4765,4765,4765,4765,4765,4766,2021-08-01 15:00:00+00:00,Queen Anne's,22.0,25883,9.0,24036,2.0,2438,24.0,11.0,26474,28321,49919
4766,4766,4766,4766,4766,4766,4766,4766,4767,2021-08-02 15:00:00+00:00,Queen Anne's,72.0,25955,23.0,24059,5.0,2443,77.0,28.0,26502,28398,50014
4767,4767,4767,4767,4767,4767,4767,4767,4768,2021-08-03 15:00:00+00:00,Queen Anne's,40.0,25995,26.0,24085,,2443,,,26528,28438,50080
4768,4768,4768,4768,4768,4768,4768,4768,4769,2021-08-04 15:00:00+00:00,Queen Anne's,69.0,26064,22.0,24107,2.0,2445,71.0,24.0,26552,28509,50171
4769,4769,4769,4769,4769,4769,4769,4769,4770,2021-08-05 15:00:00+00:00,Queen Anne's,74.0,26138,25.0,24132,13.0,2458,87.0,38.0,26590,28596,50270
4770,4770,4770,4770,4770,4770,4770,4770,4771,2021-08-06 15:00:00+00:00,Queen Anne's,68.0,26206,25.0,24157,9.0,2467,77.0,34.0,26624,28673,50363
4771,4771,4771,4771,4771,4771,4771,4771,4772,2021-08-07 15:00:00+00:00,Queen Anne's,38.0,26244,18.0,24175,1.0,2468,39.0,19.0,26643,28712,50419
4772,4772,4772,4772,4772,4772,4772,4772,4773,2021-08-08 15:00:00+00:00,Queen Anne's,26.0,26270,7.0,24182,1.0,2469,27.0,8.0,26651,28739,50452
4773,4773,4773,4773,4773,4773,4773,4773,4774,2021-08-09 15:00:00+00:00,Queen Anne's,51.0,26321,38.0,24220,5.0,2474,56.0,43.0,26694,28795,50541
4774,4774,4774,4774,4774,4774,4774,4774,4775,2021-08-10 15:00:00+00:00,Queen Anne's,56.0,26377,25.0,24245,3.0,2477,59.0,28.0,26722,28854,50622
4775,4775,4775,4775,4775,4775,4775,4775,4776,2021-08-11 15:00:00+00:00,Queen Anne's,58.0,26435,18.0,24263,4.0,2481,62.0,22.0,26744,28916,50698
4776,4776,4776,4776,4776,4776,4776,4776,4777,2021-08-12 15:00:00+00:00,Queen Anne's,63.0,26498,42.0,24305,14.0,2495,77.0,56.0,26800,28993,50803
4777,4777,4777,4777,4777,4777,4777,4777,4778,2021-08-13 15:00:00+00:00,Queen Anne's,51.0,26549,30.0,24335,1.0,2496,52.0,31.0,26831,29045,50884
4778,4778,4778,4778,4778,4778,4778,4778,4779,2021-08-14 15:00:00+00:00,Queen Anne's,29.0,26578,18.0,24353,3.0,2499,32.0,21.0,26852,29077,50931
4779,4779,4779,4779,4779,4779,4779,4779,4780,2021-08-15 15:00:00+00:00,Queen Anne's,17.0,26595,20.0,24373,3.0,2502,20.0,23.0,26875,29097,50968
4780,4780,4780,4780,4780,4780,4780,4780,4781,2021-08-16 15:00:00+00:00,Queen Anne's,28.0,26623,41.0,24414,2.0,2504,30.0,43.0,26918,29127,51037
4781,4781,4781,4781,4781,4781,4781,4781,4782,2021-08-17 15:00:00+00:00,Queen Anne's,33.0,26656,33.0,24447,1.0,2505,34.0,34.0,26952,29161,51103
4782,4782,4782,4782,4782,4782,4782,4782,4783,2021-08-18 15:00:00+00:00,Queen Anne's,44.0,26700,37.0,24484,5.0,2510,49.0,42.0,26994,29210,51184
4783,4783,4783,4783,4783,4783,4783,4783,4784,2021-08-19 15:00:00+00:00,Queen Anne's,45.0,26745,57.0,24541,12.0,2522,57.0,69.0,27063,29267,51286
4784,4784,4784,4784,4784,4784,4784,4784,4785,2021-08-20 15:00:00+00:00,Queen Anne's,54.0,26799,35.0,24576,6.0,2528,60.0,41.0,27104,29327,51375
4785,4785,4785,4785,4785,4785,4785,4785,4786,2021-08-21 15:00:00+00:00,Queen Anne's,26.0,26825,29.0,24605,1.0,2529,27.0,30.0,27134,29354,51430
4786,4786,4786,4786,4786,4786,4786,4786,4787,2021-08-22 15:00:00+00:00,Queen Anne's,21.0,26846,24.0,24629,3.0,2532,24.0,27.0,27161,29378,51475
4787,4787,4787,4787,4787,4787,4787,4787,4788,2021-08-23 15:00:00+00:00,Queen Anne's,33.0,26879,57.0,24686,1.0,2533,34.0,58.0,27219,29412,51565
4788,4788,4788,4788,4788,4788,4788,4788,4789,2021-08-24 15:00:00+00:00,Queen Anne's,39.0,26918,34.0,24720,1.0,2534,40.0,35.0,27254,29452,51638
4789,4789,4789,4789,4789,4789,4789,4789,4790,2021-08-25 15:00:00+00:00,Queen Anne's,44.0,26962,41.0,24761,4.0,2538,48.0,45.0,27299,29500,51723
4790,4790,4790,4790,4790,4790,4790,4790,4791,2021-08-26 15:00:00+00:00,Queen Anne's,68.0,27030,61.0,24822,6.0,2544,74.0,67.0,27366,29574,51852
4791,4791,4791,4791,4791,4791,4791,4791,4792,2021-08-27 15:00:00+00:00,Queen Anne's,47.0,27077,52.0,24874,1.0,2545,48.0,53.0,27419,29622,51951
4792,4792,4792,4792,4792,4792,4792,4792,4793,2021-08-28 15:00:00+00:00,Queen Anne's,25.0,27102,37.0,24911,2.0,2547,27.0,39.0,27458,29649,52013
4793,4793,4793,4793,4793,4793,4793,4793,4794,2021-08-29 15:00:00+00:00,Queen Anne's,26.0,27128,27.0,24938,,2547,,,27485,29675,52066
4794,4794,4794,4794,4794,4794,4794,4794,4795,2021-08-30 15:00:00+00:00,Queen Anne's,29.0,27157,53.0,24991,4.0,2551,33.0,57.0,27542,29708,52148
4795,4795,4795,4795,4795,4795,4795,4795,4796,2021-08-31 15:00:00+00:00,Queen Anne's,34.0,27191,41.0,25032,4.0,2555,38.0,45.0,27587,29746,52223
4796,4796,4796,4796,4796,4796,4796,4796,4797,2021-09-01 15:00:00+00:00,Queen Anne's,40.0,27231,54.0,25086,4.0,2559,44.0,58.0,27645,29790,52317
4797,4797,4797,4797,4797,4797,4797,4797,4798,2021-09-02 15:00:00+00:00,Queen Anne's,35.0,27266,53.0,25139,9.0,2568,44.0,62.0,27707,29834,52405
4798,4798,4798,4798,4798,4798,4798,4798,4799,2021-09-03 15:00:00+00:00,Queen Anne's,22.0,27288,26.0,25165,,2568,,,27733,29856,52453
4799,4799,4799,4799,4799,4799,4799,4799,4800,2021-09-04 15:00:00+00:00,Queen Anne's,16.0,27304,27.0,25192,1.0,2569,17.0,28.0,27761,29873,52496
4800,4800,4800,4800,4800,4800,4800,4800,4801,2021-09-05 15:00:00+00:00,Queen Anne's,14.0,27318,20.0,25212,,2569,,,27781,29887,52530
4801,4801,4801,4801,4801,4801,4801,4801,4802,2021-09-06 15:00:00+00:00,Queen Anne's,3.0,27321,8.0,25220,,2569,,,27789,29890,52541
4802,4802,4802,4802,4802,4802,4802,4802,4803,2021-09-07 15:00:00+00:00,Queen Anne's,18.0,27339,27.0,25247,6.0,2575,24.0,33.0,27822,29914,52586
4803,4803,4803,4803,4803,4803,4803,4803,4804,2021-09-08 15:00:00+00:00,Queen Anne's,31.0,27370,59.0,25306,8.0,2583,39.0,67.0,27889,29953,52676
4804,4804,4804,4804,4804,4804,4804,4804,4805,2021-09-09 15:00:00+00:00,Queen Anne's,43.0,27413,49.0,25355,2.0,2585,45.0,51.0,27940,29998,52768
4805,4805,4805,4805,4805,4805,4805,4805,4806,2021-09-10 15:00:00+00:00,Queen Anne's,31.0,27444,62.0,25417,5.0,2590,36.0,67.0,28007,30034,52861
4806,4806,4806,4806,4806,4806,4806,4806,4807,2021-09-11 15:00:00+00:00,Queen Anne's,15.0,27459,31.0,25448,1.0,2591,16.0,32.0,28039,30050,52907
4807,4807,4807,4807,4807,4807,4807,4807,4808,2021-09-12 15:00:00+00:00,Queen Anne's,19.0,27478,22.0,25470,,2591,,,28061,30069,52948
4808,4808,4808,4808,4808,4808,4808,4808,4809,2021-09-13 15:00:00+00:00,Queen Anne's,26.0,27504,35.0,25505,,2591,,,28096,30095,53009
4809,4809,4809,4809,4809,4809,4809,4809,4810,2021-09-14 15:00:00+00:00,Queen Anne's,24.0,27528,32.0,25537,1.0,2592,25.0,33.0,28129,30120,53065
4810,4810,4810,4810,4810,4810,4810,4810,4811,2021-09-15 15:00:00+00:00,Queen Anne's,22.0,27550,36.0,25573,3.0,2595,25.0,39.0,28168,30145,53123
4811,4811,4811,4811,4811,4811,4811,4811,4812,2021-09-16 15:00:00+00:00,Queen Anne's,36.0,27586,57.0,25630,4.0,2599,40.0,61.0,28229,30185,53216
4812,4812,4812,4812,4812,4812,4812,4812,4813,2021-09-17 15:00:00+00:00,Queen Anne's,27.0,27613,51.0,25681,5.0,2604,32.0,56.0,28285,30217,53294
4813,4813,4813,4813,4813,4813,4813,4813,4814,2021-09-18 15:00:00+00:00,Queen Anne's,21.0,27634,26.0,25707,3.0,2607,24.0,29.0,28314,30241,53341
4814,4814,4814,4814,4814,4814,4814,4814,4815,2021-09-19 15:00:00+00:00,Queen Anne's,16.0,27650,15.0,25722,,2607,,,28329,30257,53372
4815,4815,4815,4815,4815,4815,4815,4815,4816,2021-09-20 15:00:00+00:00,Queen Anne's,23.0,27673,35.0,25757,3.0,2610,26.0,38.0,28367,30283,53430
4816,4816,4816,4816,4816,4816,4816,4816,4817,2021-09-21 15:00:00+00:00,Queen Anne's,32.0,27705,34.0,25791,3.0,2613,35.0,37.0,28404,30318,53496
4817,4817,4817,4817,4817,4817,4817,4817,4818,2021-09-22 15:00:00+00:00,Queen Anne's,33.0,27738,44.0,25835,4.0,2617,37.0,48.0,28452,30355,53573
4818,4818,4818,4818,4818,4818,4818,4818,4819,2021-09-23 15:00:00+00:00,Queen Anne's,25.0,27763,34.0,25869,3.0,2620,28.0,37.0,28489,30383,53632
4819,4819,4819,4819,4819,4819,4819,4819,4820,2021-09-24 15:00:00+00:00,Queen Anne's,35.0,27798,33.0,25902,,2620,,,28522,30418,53700
4820,4820,4820,4820,4820,4820,4820,4820,4821,2021-09-25 15:00:00+00:00,Queen Anne's,17.0,27815,19.0,25921,,2620,,,28541,30435,53736
4821,4821,4821,4821,4821,4821,4821,4821,4822,2021-09-26 15:00:00+00:00,Queen Anne's,12.0,27827,11.0,25932,1.0,2621,13.0,12.0,28553,30448,53759
4822,4822,4822,4822,4822,4822,4822,4822,4823,2021-09-27 15:00:00+00:00,Queen Anne's,26.0,27853,20.0,25952,,2621,,,28573,30474,53805
4823,4823,4823,4823,4823,4823,4823,4823,4824,2021-09-28 15:00:00+00:00,Queen Anne's,19.0,27872,24.0,25976,1.0,2622,20.0,25.0,28598,30494,53848
4824,4824,4824,4824,4824,4824,4824,4824,4825,2021-09-29 15:00:00+00:00,Queen Anne's,30.0,27902,28.0,26004,1.0,2623,31.0,29.0,28627,30525,53906
4825,4825,4825,4825,4825,4825,4825,4825,4826,2021-09-30 15:00:00+00:00,Queen Anne's,27.0,27929,39.0,26043,14.0,2637,41.0,53.0,28680,30566,53972
4826,4826,4826,4826,4826,4826,4826,4826,4827,2021-10-01 15:00:00+00:00,Queen Anne's,25.0,27954,26.0,26069,5.0,2642,30.0,31.0,28711,30596,54023
4827,4827,4827,4827,4827,4827,4827,4827,4828,2021-10-02 15:00:00+00:00,Queen Anne's,16.0,27970,11.0,26080,1.0,2643,17.0,12.0,28723,30613,54050
4828,4828,4828,4828,4828,4828,4828,4828,4829,2021-10-03 15:00:00+00:00,Queen Anne's,9.0,27979,13.0,26093,,2643,,,28736,30622,54072
4829,4829,4829,4829,4829,4829,4829,4829,4830,2021-10-04 15:00:00+00:00,Queen Anne's,18.0,27997,16.0,26109,2.0,2645,20.0,18.0,28754,30642,54106
4830,4830,4830,4830,4830,4830,4830,4830,4831,2021-10-05 15:00:00+00:00,Queen Anne's,20.0,28017,15.0,26124,,2645,,,28769,30662,54141
4831,4831,4831,4831,4831,4831,4831,4831,4832,2021-10-06 15:00:00+00:00,Queen Anne's,22.0,28039,15.0,26139,2.0,2647,24.0,17.0,28786,30686,54178
4832,4832,4832,4832,4832,4832,4832,4832,4833,2021-10-07 15:00:00+00:00,Queen Anne's,26.0,28065,34.0,26173,6.0,2653,32.0,40.0,28826,30718,54238
4833,4833,4833,4833,4833,4833,4833,4833,4834,2021-10-08 15:00:00+00:00,Queen Anne's,17.0,28082,16.0,26189,,2653,,,28842,30735,54271
4834,4834,4834,4834,4834,4834,4834,4834,4835,2021-10-09 15:00:00+00:00,Queen Anne's,13.0,28095,14.0,26203,,2653,,,28856,30748,54298
4835,4835,4835,4835,4835,4835,4835,4835,4836,2021-10-10 15:00:00+00:00,Queen Anne's,4.0,28099,14.0,26217,,2653,,,28870,30752,54316
4836,4836,4836,4836,4836,4836,4836,4836,4837,2021-10-11 15:00:00+00:00,Queen Anne's,25.0,28124,30.0,26247,1.0,2654,26.0,31.0,28901,30778,54371
4837,4837,4837,4837,4837,4837,4837,4837,4838,2021-10-12 15:00:00+00:00,Queen Anne's,12.0,28136,20.0,26267,1.0,2655,13.0,21.0,28922,30791,54403
4838,4838,4838,4838,4838,4838,4838,4838,4839,2021-10-13 15:00:00+00:00,Queen Anne's,12.0,28148,29.0,26296,2.0,2657,14.0,31.0,28953,30805,54444
4839,4839,4839,4839,4839,4839,4839,4839,4840,2021-10-14 15:00:00+00:00,Queen Anne's,22.0,28170,18.0,26314,10.0,2667,32.0,28.0,28981,30837,54484
4840,4840,4840,4840,4840,4840,4840,4840,4841,2021-10-15 15:00:00+00:00,Queen Anne's,25.0,28195,27.0,26341,,2667,,,29008,30862,54536
4841,4841,4841,4841,4841,4841,4841,4841,4842,2021-10-16 15:00:00+00:00,Queen Anne's,6.0,28201,8.0,26349,,2667,,,29016,30868,54550
4842,4842,4842,4842,4842,4842,4842,4842,4843,2021-10-17 15:00:00+00:00,Queen Anne's,6.0,28207,4.0,26353,1.0,2668,7.0,5.0,29021,30875,54560
4843,4843,4843,4843,4843,4843,4843,4843,4844,2021-10-18 15:00:00+00:00,Queen Anne's,32.0,28239,25.0,26378,,2668,,,29046,30907,54617
4844,4844,4844,4844,4844,4844,4844,4844,4845,2021-10-19 15:00:00+00:00,Queen Anne's,16.0,28255,7.0,26385,,2668,,,29053,30923,54640
4845,4845,4845,4845,4845,4845,4845,4845,4846,2021-10-20 15:00:00+00:00,Queen Anne's,11.0,28266,18.0,26403,1.0,2669,12.0,19.0,29072,30935,54669
4846,4846,4846,4846,4846,4846,4846,4846,4847,2021-10-21 15:00:00+00:00,Queen Anne's,22.0,28288,14.0,26417,11.0,2680,33.0,25.0,29097,30968,54705
4847,4847,4847,4847,4847,4847,4847,4847,4848,2021-10-22 15:00:00+00:00,Queen Anne's,23.0,28311,32.0,26449,1.0,2681,24.0,33.0,29130,30992,54760
4848,4848,4848,4848,4848,4848,4848,4848,4849,2021-10-23 15:00:00+00:00,Queen Anne's,7.0,28318,19.0,26468,,2681,,,29149,30999,54786
4849,4849,4849,4849,4849,4849,4849,4849,4850,2021-10-24 15:00:00+00:00,Queen Anne's,14.0,28332,10.0,26478,,2681,,,29159,31013,54810
4850,4850,4850,4850,4850,4850,4850,4850,4851,2021-10-25 15:00:00+00:00,Queen Anne's,39.0,28371,35.0,26513,2.0,2683,41.0,37.0,29196,31054,54884
4851,4851,4851,4851,4851,4851,4851,4851,4852,2021-10-26 15:00:00+00:00,Queen Anne's,16.0,28387,37.0,26550,3.0,2686,19.0,40.0,29236,31073,54937
4852,4852,4852,4852,4852,4852,4852,4852,4853,2021-10-27 15:00:00+00:00,Queen Anne's,22.0,28409,37.0,26587,1.0,2687,23.0,38.0,29274,31096,54996
4853,4853,4853,4853,4853,4853,4853,4853,4854,2021-10-28 15:00:00+00:00,Queen Anne's,37.0,28446,40.0,26627,9.0,2696,46.0,49.0,29323,31142,55073
4854,4854,4854,4854,4854,4854,4854,4854,4855,2021-10-29 15:00:00+00:00,Queen Anne's,33.0,28479,30.0,26657,3.0,2699,36.0,33.0,29356,31178,55136
4855,4855,4855,4855,4855,4855,4855,4855,4856,2021-10-30 15:00:00+00:00,Queen Anne's,16.0,28495,16.0,26673,,2699,,,29372,31194,55168
4856,4856,4856,4856,4856,4856,4856,4856,4857,2021-10-31 15:00:00+00:00,Queen Anne's,10.0,28505,9.0,26682,1.0,2700,11.0,10.0,29382,31205,55187
4857,4857,4857,4857,4857,4857,4857,4857,4858,2021-11-01 15:00:00+00:00,Queen Anne's,40.0,28545,37.0,26719,3.0,2703,43.0,40.0,29422,31248,55264
4858,4858,4858,4858,4858,4858,4858,4858,4859,2021-11-02 15:00:00+00:00,Queen Anne's,18.0,28563,25.0,26744,1.0,2704,19.0,26.0,29448,31267,55307
4859,4859,4859,4859,4859,4859,4859,4859,4860,2021-11-03 15:00:00+00:00,Queen Anne's,32.0,28595,28.0,26772,5.0,2709,37.0,33.0,29481,31304,55367
4860,4860,4860,4860,4860,4860,4860,4860,4861,2021-11-04 15:00:00+00:00,Queen Anne's,22.0,28617,34.0,26806,8.0,2717,30.0,42.0,29523,31334,55423
4861,4861,4861,4861,4861,4861,4861,4861,4862,2021-11-05 15:00:00+00:00,Queen Anne's,21.0,28638,31.0,26837,1.0,2718,22.0,32.0,29555,31356,55475
4862,4862,4862,4862,4862,4862,4862,4862,4863,2021-11-06 15:00:00+00:00,Queen Anne's,4.0,28642,5.0,26842,,2718,,,29560,31360,55484
4863,4863,4863,4863,4863,4863,4863,4863,4864,2020-12-16 15:00:00+00:00,St. Mary's,3.0,3,,0,,0,,,0,3,3
4864,4864,4864,4864,4864,4864,4864,4864,4865,2020-12-17 15:00:00+00:00,St. Mary's,1.0,4,,0,,0,,,0,4,4
4865,4865,4865,4865,4865,4865,4865,4865,4866,2020-12-18 15:00:00+00:00,St. Mary's,23.0,27,,0,,0,,,0,27,27
4866,4866,4866,4866,4866,4866,4866,4866,4867,2020-12-19 15:00:00+00:00,St. Mary's,1.0,28,,0,,0,,,0,28,28
4867,4867,4867,4867,4867,4867,4867,4867,4868,2020-12-21 15:00:00+00:00,St. Mary's,50.0,78,,0,,0,,,0,78,78
4868,4868,4868,4868,4868,4868,4868,4868,4869,2020-12-22 15:00:00+00:00,St. Mary's,56.0,134,1.0,1,,0,,,1,134,135
4869,4869,4869,4869,4869,4869,4869,4869,4870,2020-12-23 15:00:00+00:00,St. Mary's,72.0,206,,1,,0,,,1,206,207
4870,4870,4870,4870,4870,4870,4870,4870,4871,2020-12-24 15:00:00+00:00,St. Mary's,8.0,214,,1,,0,,,1,214,215
4871,4871,4871,4871,4871,4871,4871,4871,4872,2020-12-25 15:00:00+00:00,St. Mary's,22.0,236,,1,,0,,,1,236,237
4872,4872,4872,4872,4872,4872,4872,4872,4873,2020-12-26 15:00:00+00:00,St. Mary's,2.0,238,,1,,0,,,1,238,239
4873,4873,4873,4873,4873,4873,4873,4873,4874,2020-12-27 15:00:00+00:00,St. Mary's,9.0,247,,1,,0,,,1,247,248
4874,4874,4874,4874,4874,4874,4874,4874,4875,2020-12-28 15:00:00+00:00,St. Mary's,96.0,343,,1,,0,,,1,343,344
4875,4875,4875,4875,4875,4875,4875,4875,4876,2020-12-29 15:00:00+00:00,St. Mary's,467.0,810,,1,,0,,,1,810,811
4876,4876,4876,4876,4876,4876,4876,4876,4877,2020-12-30 15:00:00+00:00,St. Mary's,374.0,1184,,1,,0,,,1,1184,1185
4877,4877,4877,4877,4877,4877,4877,4877,4878,2020-12-31 15:00:00+00:00,St. Mary's,317.0,1501,1.0,2,,0,,,2,1501,1503
4878,4878,4878,4878,4878,4878,4878,4878,4879,2021-01-01 15:00:00+00:00,St. Mary's,14.0,1515,1.0,3,,0,,,3,1515,1518
4879,4879,4879,4879,4879,4879,4879,4879,4880,2021-01-02 15:00:00+00:00,St. Mary's,2.0,1517,,3,,0,,,3,1517,1520
4880,4880,4880,4880,4880,4880,4880,4880,4881,2021-01-03 15:00:00+00:00,St. Mary's,6.0,1523,,3,,0,,,3,1523,1526
4881,4881,4881,4881,4881,4881,4881,4881,4882,2021-01-04 15:00:00+00:00,St. Mary's,118.0,1641,1.0,4,,0,,,4,1641,1645
4882,4882,4882,4882,4882,4882,4882,4882,4883,2021-01-05 15:00:00+00:00,St. Mary's,167.0,1808,,4,,0,,,4,1808,1812
4883,4883,4883,4883,4883,4883,4883,4883,4884,2021-01-06 15:00:00+00:00,St. Mary's,355.0,2163,5.0,9,,0,,,9,2163,2172
4884,4884,4884,4884,4884,4884,4884,4884,4885,2021-01-07 15:00:00+00:00,St. Mary's,173.0,2336,9.0,18,,0,,,18,2336,2354
4885,4885,4885,4885,4885,4885,4885,4885,4886,2021-01-08 15:00:00+00:00,St. Mary's,359.0,2695,29.0,47,,0,,,47,2695,2742
4886,4886,4886,4886,4886,4886,4886,4886,4887,2021-01-09 15:00:00+00:00,St. Mary's,295.0,2990,1.0,48,,0,,,48,2990,3038
4887,4887,4887,4887,4887,4887,4887,4887,4888,2021-01-10 15:00:00+00:00,St. Mary's,3.0,2993,,48,,0,,,48,2993,3041
4888,4888,4888,4888,4888,4888,4888,4888,4889,2021-01-11 15:00:00+00:00,St. Mary's,171.0,3164,46.0,94,,0,,,94,3164,3258
4889,4889,4889,4889,4889,4889,4889,4889,4890,2021-01-12 15:00:00+00:00,St. Mary's,232.0,3396,45.0,139,,0,,,139,3396,3535
4890,4890,4890,4890,4890,4890,4890,4890,4891,2021-01-13 15:00:00+00:00,St. Mary's,620.0,4016,35.0,174,,0,,,174,4016,4190
4891,4891,4891,4891,4891,4891,4891,4891,4892,2021-01-14 15:00:00+00:00,St. Mary's,687.0,4703,12.0,186,,0,,,186,4703,4889
4892,4892,4892,4892,4892,4892,4892,4892,4893,2021-01-15 15:00:00+00:00,St. Mary's,790.0,5493,32.0,218,,0,,,218,5493,5711
4893,4893,4893,4893,4893,4893,4893,4893,4894,2021-01-16 15:00:00+00:00,St. Mary's,586.0,6079,12.0,230,,0,,,230,6079,6309
4894,4894,4894,4894,4894,4894,4894,4894,4895,2021-01-17 15:00:00+00:00,St. Mary's,6.0,6085,6.0,236,,0,,,236,6085,6321
4895,4895,4895,4895,4895,4895,4895,4895,4896,2021-01-18 15:00:00+00:00,St. Mary's,370.0,6455,30.0,266,,0,,,266,6455,6721
4896,4896,4896,4896,4896,4896,4896,4896,4897,2021-01-19 15:00:00+00:00,St. Mary's,84.0,6539,98.0,364,,0,,,364,6539,6903
4897,4897,4897,4897,4897,4897,4897,4897,4898,2021-01-20 15:00:00+00:00,St. Mary's,202.0,6741,36.0,400,,0,,,400,6741,7141
4898,4898,4898,4898,4898,4898,4898,4898,4899,2021-01-21 15:00:00+00:00,St. Mary's,336.0,7077,10.0,410,,0,,,410,7077,7487
4899,4899,4899,4899,4899,4899,4899,4899,4900,2021-01-22 15:00:00+00:00,St. Mary's,466.0,7543,121.0,531,,0,,,531,7543,8074
4900,4900,4900,4900,4900,4900,4900,4900,4901,2021-01-23 15:00:00+00:00,St. Mary's,491.0,8034,7.0,538,,0,,,538,8034,8572
4901,4901,4901,4901,4901,4901,4901,4901,4902,2021-01-24 15:00:00+00:00,St. Mary's,2.0,8036,2.0,540,,0,,,540,8036,8576
4902,4902,4902,4902,4902,4902,4902,4902,4903,2021-01-25 15:00:00+00:00,St. Mary's,43.0,8079,58.0,598,,0,,,598,8079,8677
4903,4903,4903,4903,4903,4903,4903,4903,4904,2021-01-26 15:00:00+00:00,St. Mary's,482.0,8561,398.0,996,,0,,,996,8561,9557
4904,4904,4904,4904,4904,4904,4904,4904,4905,2021-01-27 15:00:00+00:00,St. Mary's,531.0,9092,468.0,1464,,0,,,1464,9092,10556
4905,4905,4905,4905,4905,4905,4905,4905,4906,2021-01-28 15:00:00+00:00,St. Mary's,1061.0,10153,273.0,1737,,0,,,1737,10153,11890
4906,4906,4906,4906,4906,4906,4906,4906,4907,2021-01-29 15:00:00+00:00,St. Mary's,451.0,10604,376.0,2113,,0,,,2113,10604,12717
4907,4907,4907,4907,4907,4907,4907,4907,4908,2021-01-30 15:00:00+00:00,St. Mary's,717.0,11321,172.0,2285,,0,,,2285,11321,13606
4908,4908,4908,4908,4908,4908,4908,4908,4909,2021-01-31 15:00:00+00:00,St. Mary's,2.0,11323,1.0,2286,,0,,,2286,11323,13609
4909,4909,4909,4909,4909,4909,4909,4909,4910,2021-02-01 15:00:00+00:00,St. Mary's,26.0,11349,133.0,2419,,0,,,2419,11349,13768
4910,4910,4910,4910,4910,4910,4910,4910,4911,2021-02-02 15:00:00+00:00,St. Mary's,33.0,11382,119.0,2538,,0,,,2538,11382,13920
4911,4911,4911,4911,4911,4911,4911,4911,4912,2021-02-03 15:00:00+00:00,St. Mary's,502.0,11884,542.0,3080,,0,,,3080,11884,14964
4912,4912,4912,4912,4912,4912,4912,4912,4913,2021-02-04 15:00:00+00:00,St. Mary's,560.0,12444,523.0,3603,,0,,,3603,12444,16047
4913,4913,4913,4913,4913,4913,4913,4913,4914,2021-02-05 15:00:00+00:00,St. Mary's,493.0,12937,572.0,4175,,0,,,4175,12937,17112
4914,4914,4914,4914,4914,4914,4914,4914,4915,2021-02-06 15:00:00+00:00,St. Mary's,36.0,12973,963.0,5138,,0,,,5138,12973,18111
4915,4915,4915,4915,4915,4915,4915,4915,4916,2021-02-07 15:00:00+00:00,St. Mary's,33.0,13006,143.0,5281,,0,,,5281,13006,18287
4916,4916,4916,4916,4916,4916,4916,4916,4917,2021-02-08 15:00:00+00:00,St. Mary's,21.0,13027,35.0,5316,,0,,,5316,13027,18343
4917,4917,4917,4917,4917,4917,4917,4917,4918,2021-02-09 15:00:00+00:00,St. Mary's,406.0,13433,821.0,6137,,0,,,6137,13433,19570
4918,4918,4918,4918,4918,4918,4918,4918,4919,2021-02-10 15:00:00+00:00,St. Mary's,410.0,13843,965.0,7102,,0,,,7102,13843,20945
4919,4919,4919,4919,4919,4919,4919,4919,4920,2021-02-11 15:00:00+00:00,St. Mary's,99.0,13942,38.0,7140,,0,,,7140,13942,21082
4920,4920,4920,4920,4920,4920,4920,4920,4921,2021-02-12 15:00:00+00:00,St. Mary's,56.0,13998,103.0,7243,,0,,,7243,13998,21241
4921,4921,4921,4921,4921,4921,4921,4921,4922,2021-02-13 15:00:00+00:00,St. Mary's,23.0,14021,4.0,7247,,0,,,7247,14021,21268
4922,4922,4922,4922,4922,4922,4922,4922,4923,2021-02-14 15:00:00+00:00,St. Mary's,27.0,14048,3.0,7250,,0,,,7250,14048,21298
4923,4923,4923,4923,4923,4923,4923,4923,4924,2021-02-15 15:00:00+00:00,St. Mary's,216.0,14264,12.0,7262,,0,,,7262,14264,21526
4924,4924,4924,4924,4924,4924,4924,4924,4925,2021-02-16 15:00:00+00:00,St. Mary's,44.0,14308,571.0,7833,,0,,,7833,14308,22141
4925,4925,4925,4925,4925,4925,4925,4925,4926,2021-02-17 15:00:00+00:00,St. Mary's,59.0,14367,665.0,8498,,0,,,8498,14367,22865
4926,4926,4926,4926,4926,4926,4926,4926,4927,2021-02-18 15:00:00+00:00,St. Mary's,9.0,14376,35.0,8533,,0,,,8533,14376,22909
4927,4927,4927,4927,4927,4927,4927,4927,4928,2021-02-19 15:00:00+00:00,St. Mary's,7.0,14383,35.0,8568,,0,,,8568,14383,22951
4928,4928,4928,4928,4928,4928,4928,4928,4929,2021-02-20 15:00:00+00:00,St. Mary's,23.0,14406,1132.0,9700,,0,,,9700,14406,24106
4929,4929,4929,4929,4929,4929,4929,4929,4930,2021-02-21 15:00:00+00:00,St. Mary's,11.0,14417,4.0,9704,,0,,,9704,14417,24121
4930,4930,4930,4930,4930,4930,4930,4930,4931,2021-02-22 15:00:00+00:00,St. Mary's,646.0,15063,76.0,9780,,0,,,9780,15063,24843
4931,4931,4931,4931,4931,4931,4931,4931,4932,2021-02-23 15:00:00+00:00,St. Mary's,41.0,15104,1016.0,10796,,0,,,10796,15104,25900
4932,4932,4932,4932,4932,4932,4932,4932,4933,2021-02-24 15:00:00+00:00,St. Mary's,410.0,15514,493.0,11289,,0,,,11289,15514,26803
4933,4933,4933,4933,4933,4933,4933,4933,4934,2021-02-25 15:00:00+00:00,St. Mary's,363.0,15877,508.0,11797,,0,,,11797,15877,27674
4934,4934,4934,4934,4934,4934,4934,4934,4935,2021-02-26 15:00:00+00:00,St. Mary's,680.0,16557,142.0,11939,,0,,,11939,16557,28496
4935,4935,4935,4935,4935,4935,4935,4935,4936,2021-02-27 15:00:00+00:00,St. Mary's,40.0,16597,24.0,11963,,0,,,11963,16597,28560
4936,4936,4936,4936,4936,4936,4936,4936,4937,2021-02-28 15:00:00+00:00,St. Mary's,41.0,16638,3.0,11966,,0,,,11966,16638,28604
4937,4937,4937,4937,4937,4937,4937,4937,4938,2021-03-01 15:00:00+00:00,St. Mary's,68.0,16706,34.0,12000,,0,,,12000,16706,28706
4938,4938,4938,4938,4938,4938,4938,4938,4939,2021-03-02 15:00:00+00:00,St. Mary's,43.0,16749,26.0,12026,,0,,,12026,16749,28775
4939,4939,4939,4939,4939,4939,4939,4939,4940,2021-03-03 15:00:00+00:00,St. Mary's,627.0,17376,121.0,12147,1.0,1,628.0,122.0,12148,17377,29523
4940,4940,4940,4940,4940,4940,4940,4940,4941,2021-09-09 15:00:00+00:00,Frederick,160.0,153565,191.0,142547,21.0,16531,181.0,212.0,159078,170096,296112
4941,4941,4941,4941,4941,4941,4941,4941,4942,2021-09-10 15:00:00+00:00,Frederick,164.0,153729,232.0,142779,18.0,16549,182.0,250.0,159328,170278,296508
4942,4942,4942,4942,4942,4942,4942,4942,4943,2021-09-11 15:00:00+00:00,Frederick,129.0,153858,155.0,142934,17.0,16566,146.0,172.0,159500,170424,296792
4943,4943,4943,4943,4943,4943,4943,4943,4944,2021-09-12 15:00:00+00:00,Frederick,61.0,153919,94.0,143028,1.0,16567,62.0,95.0,159595,170486,296947
4944,4944,4944,4944,4944,4944,4944,4944,4945,2021-09-13 15:00:00+00:00,Frederick,169.0,154088,185.0,143213,13.0,16580,182.0,198.0,159793,170668,297301
4945,4945,4945,4945,4945,4945,4945,4945,4946,2021-09-14 15:00:00+00:00,Frederick,127.0,154215,155.0,143368,7.0,16587,134.0,162.0,159955,170802,297583
4946,4946,4946,4946,4946,4946,4946,4946,4947,2021-09-15 15:00:00+00:00,Frederick,153.0,154368,209.0,143577,14.0,16601,167.0,223.0,160178,170969,297945
4947,4947,4947,4947,4947,4947,4947,4947,4948,2021-09-16 15:00:00+00:00,Frederick,136.0,154504,211.0,143788,8.0,16609,144.0,219.0,160397,171113,298292
4948,4948,4948,4948,4948,4948,4948,4948,4949,2021-09-17 15:00:00+00:00,Frederick,146.0,154650,253.0,144041,18.0,16627,164.0,271.0,160668,171277,298691
4949,4949,4949,4949,4949,4949,4949,4949,4950,2021-09-18 15:00:00+00:00,Frederick,108.0,154758,188.0,144229,9.0,16636,117.0,197.0,160865,171394,298987
4950,4950,4950,4950,4950,4950,4950,4950,4951,2021-09-19 15:00:00+00:00,Frederick,56.0,154814,82.0,144311,5.0,16641,61.0,87.0,160952,171455,299125
4951,4951,4951,4951,4951,4951,4951,4951,4952,2021-09-20 15:00:00+00:00,Frederick,109.0,154923,231.0,144542,27.0,16668,136.0,258.0,161210,171591,299465
4952,4952,4952,4952,4952,4952,4952,4952,4953,2021-09-21 15:00:00+00:00,Frederick,132.0,155055,164.0,144706,7.0,16675,139.0,171.0,161381,171730,299761
4953,4953,4953,4953,4953,4953,4953,4953,4954,2021-09-22 15:00:00+00:00,Frederick,109.0,155164,166.0,144872,12.0,16687,121.0,178.0,161559,171851,300036
4954,4954,4954,4954,4954,4954,4954,4954,4955,2021-09-23 15:00:00+00:00,Frederick,108.0,155272,127.0,144999,23.0,16710,131.0,150.0,161709,171982,300271
4955,4955,4955,4955,4955,4955,4955,4955,4956,2021-09-24 15:00:00+00:00,Frederick,121.0,155393,152.0,145151,15.0,16725,136.0,167.0,161876,172118,300544
4956,4956,4956,4956,4956,4956,4956,4956,4957,2021-09-25 15:00:00+00:00,Frederick,84.0,155477,138.0,145289,5.0,16730,89.0,143.0,162019,172207,300766
4957,4957,4957,4957,4957,4957,4957,4957,4958,2021-09-26 15:00:00+00:00,Frederick,39.0,155516,65.0,145354,,16730,,,162084,172246,300870
4958,4958,4958,4958,4958,4958,4958,4958,4959,2021-09-27 15:00:00+00:00,Frederick,138.0,155654,83.0,145437,22.0,16752,160.0,105.0,162189,172406,301091
4959,4959,4959,4959,4959,4959,4959,4959,4960,2021-09-28 15:00:00+00:00,Frederick,116.0,155770,127.0,145564,5.0,16757,121.0,132.0,162321,172527,301334
4960,4960,4960,4960,4960,4960,4960,4960,4961,2021-09-29 15:00:00+00:00,Frederick,131.0,155901,138.0,145702,16.0,16773,147.0,154.0,162475,172674,301603
4961,4961,4961,4961,4961,4961,4961,4961,4962,2021-09-30 15:00:00+00:00,Frederick,138.0,156039,121.0,145823,8.0,16781,146.0,129.0,162604,172820,301862
4962,4962,4962,4962,4962,4962,4962,4962,4963,2021-10-01 15:00:00+00:00,Frederick,142.0,156181,185.0,146008,10.0,16791,152.0,195.0,162799,172972,302189
4963,4963,4963,4963,4963,4963,4963,4963,4964,2021-10-02 15:00:00+00:00,Frederick,81.0,156262,100.0,146108,12.0,16803,93.0,112.0,162911,173065,302370
4964,4964,4964,4964,4964,4964,4964,4964,4965,2021-10-03 15:00:00+00:00,Frederick,56.0,156318,49.0,146157,2.0,16805,58.0,51.0,162962,173123,302475
4965,4965,4965,4965,4965,4965,4965,4965,4966,2021-10-04 15:00:00+00:00,Frederick,128.0,156446,119.0,146276,21.0,16826,149.0,140.0,163102,173272,302722
4966,4966,4966,4966,4966,4966,4966,4966,4967,2021-10-05 15:00:00+00:00,Frederick,90.0,156536,104.0,146380,10.0,16836,100.0,114.0,163216,173372,302916
4967,4967,4967,4967,4967,4967,4967,4967,4968,2021-10-06 15:00:00+00:00,Frederick,122.0,156658,141.0,146521,18.0,16854,140.0,159.0,163375,173512,303179
4968,4968,4968,4968,4968,4968,4968,4968,4969,2021-10-07 15:00:00+00:00,Frederick,134.0,156792,117.0,146638,10.0,16864,144.0,127.0,163502,173656,303430
4969,4969,4969,4969,4969,4969,4969,4969,4970,2021-10-08 15:00:00+00:00,Frederick,132.0,156924,115.0,146753,22.0,16886,154.0,137.0,163639,173810,303677
4970,4970,4970,4970,4970,4970,4970,4970,4971,2021-10-09 15:00:00+00:00,Frederick,65.0,156989,82.0,146835,5.0,16891,70.0,87.0,163726,173880,303824
4971,4971,4971,4971,4971,4971,4971,4971,4972,2021-10-10 15:00:00+00:00,Frederick,45.0,157034,57.0,146892,,16891,,,163783,173925,303926
4972,4972,4972,4972,4972,4972,4972,4972,4973,2021-10-11 15:00:00+00:00,Frederick,152.0,157186,107.0,146999,20.0,16911,172.0,127.0,163910,174097,304185
4973,4973,4973,4973,4973,4973,4973,4973,4974,2021-10-12 15:00:00+00:00,Frederick,75.0,157261,92.0,147091,9.0,16920,84.0,101.0,164011,174181,304352
4974,4974,4974,4974,4974,4974,4974,4974,4975,2021-10-13 15:00:00+00:00,Frederick,109.0,157370,116.0,147207,10.0,16930,119.0,126.0,164137,174300,304577
4975,4975,4975,4975,4975,4975,4975,4975,4976,2021-10-14 15:00:00+00:00,Frederick,103.0,157473,106.0,147313,17.0,16947,120.0,123.0,164260,174420,304786
4976,4976,4976,4976,4976,4976,4976,4976,4977,2021-10-15 15:00:00+00:00,Frederick,100.0,157573,121.0,147434,24.0,16971,124.0,145.0,164405,174544,305007
4977,4977,4977,4977,4977,4977,4977,4977,4978,2021-10-16 15:00:00+00:00,Frederick,64.0,157637,77.0,147511,7.0,16978,71.0,84.0,164489,174615,305148
4978,4978,4978,4978,4978,4978,4978,4978,4979,2021-10-17 15:00:00+00:00,Frederick,39.0,157676,44.0,147555,,16978,,,164533,174654,305231
4979,4979,4979,4979,4979,4979,4979,4979,4980,2021-10-18 15:00:00+00:00,Frederick,115.0,157791,111.0,147666,16.0,16994,131.0,127.0,164660,174785,305457
4980,4980,4980,4980,4980,4980,4980,4980,4981,2021-10-19 15:00:00+00:00,Frederick,79.0,157870,108.0,147774,12.0,17006,91.0,120.0,164780,174876,305644
4981,4981,4981,4981,4981,4981,4981,4981,4982,2021-10-20 15:00:00+00:00,Frederick,100.0,157970,78.0,147852,19.0,17025,119.0,97.0,164877,174995,305822
4982,4982,4982,4982,4982,4982,4982,4982,4983,2021-10-21 15:00:00+00:00,Frederick,92.0,158062,91.0,147943,17.0,17042,109.0,108.0,164985,175104,306005
4983,4983,4983,4983,4983,4983,4983,4983,4984,2021-10-22 15:00:00+00:00,Frederick,122.0,158184,265.0,148208,14.0,17056,136.0,279.0,165264,175240,306392
4984,4984,4984,4984,4984,4984,4984,4984,4985,2021-10-23 15:00:00+00:00,Frederick,96.0,158280,191.0,148399,13.0,17069,109.0,204.0,165468,175349,306679
4985,4985,4985,4985,4985,4985,4985,4985,4986,2021-10-24 15:00:00+00:00,Frederick,45.0,158325,99.0,148498,3.0,17072,48.0,102.0,165570,175397,306823
4986,4986,4986,4986,4986,4986,4986,4986,4987,2021-10-25 15:00:00+00:00,Frederick,122.0,158447,277.0,148775,16.0,17088,138.0,293.0,165863,175535,307222
4987,4987,4987,4987,4987,4987,4987,4987,4988,2021-10-26 15:00:00+00:00,Frederick,100.0,158547,153.0,148928,8.0,17096,108.0,161.0,166024,175643,307475
4988,4988,4988,4988,4988,4988,4988,4988,4989,2021-10-27 15:00:00+00:00,Frederick,147.0,158694,319.0,149247,13.0,17109,160.0,332.0,166356,175803,307941
4989,4989,4989,4989,4989,4989,4989,4989,4990,2021-10-28 15:00:00+00:00,Frederick,142.0,158836,280.0,149527,17.0,17126,159.0,297.0,166653,175962,308363
4990,4990,4990,4990,4990,4990,4990,4990,4991,2021-10-29 15:00:00+00:00,Frederick,149.0,158985,291.0,149818,31.0,17157,180.0,322.0,166975,176142,308803
4991,4991,4991,4991,4991,4991,4991,4991,4992,2021-10-30 15:00:00+00:00,Frederick,78.0,159063,171.0,149989,11.0,17168,89.0,182.0,167157,176231,309052
4992,4992,4992,4992,4992,4992,4992,4992,4993,2021-10-31 15:00:00+00:00,Frederick,60.0,159123,78.0,150067,1.0,17169,61.0,79.0,167236,176292,309190
4993,4993,4993,4993,4993,4993,4993,4993,4994,2021-11-01 15:00:00+00:00,Frederick,141.0,159264,301.0,150368,18.0,17187,159.0,319.0,167555,176451,309632
4994,4994,4994,4994,4994,4994,4994,4994,4995,2021-11-02 15:00:00+00:00,Frederick,127.0,159391,220.0,150588,17.0,17204,144.0,237.0,167792,176595,309979
4995,4995,4995,4995,4995,4995,4995,4995,4996,2021-11-03 15:00:00+00:00,Frederick,168.0,159559,244.0,150832,17.0,17221,185.0,261.0,168053,176780,310391
4996,4996,4996,4996,4996,4996,4996,4996,4997,2021-03-04 15:00:00+00:00,St. Mary's,735.0,18111,86.0,12233,1.0,2,736.0,87.0,12235,18113,30344
4997,4997,4997,4997,4997,4997,4997,4997,4998,2021-03-05 15:00:00+00:00,St. Mary's,482.0,18593,472.0,12705,2.0,4,484.0,474.0,12709,18597,31298
4998,4998,4998,4998,4998,4998,4998,4998,4999,2021-03-06 15:00:00+00:00,St. Mary's,91.0,18684,8.0,12713,9.0,13,100.0,17.0,12726,18697,31397
4999,4999,4999,4999,4999,4999,4999,4999,5000,2021-03-07 15:00:00+00:00,St. Mary's,33.0,18717,1.0,12714,13.0,26,46.0,14.0,12740,18743,31431
5000,5000,5000,5000,5000,5000,5000,5000,5001,2021-03-08 15:00:00+00:00,St. Mary's,272.0,18989,28.0,12742,248.0,274,520.0,276.0,13016,19263,31731
5001,5001,5001,5001,5001,5001,5001,5001,5002,2021-03-09 15:00:00+00:00,St. Mary's,85.0,19074,856.0,13598,22.0,296,107.0,878.0,13894,19370,32672
5002,5002,5002,5002,5002,5002,5002,5002,5003,2021-03-10 15:00:00+00:00,St. Mary's,569.0,19643,54.0,13652,29.0,325,598.0,83.0,13977,19968,33295
5003,5003,5003,5003,5003,5003,5003,5003,5004,2021-03-11 15:00:00+00:00,St. Mary's,902.0,20545,76.0,13728,17.0,342,919.0,93.0,14070,20887,34273
5004,5004,5004,5004,5004,5004,5004,5004,5005,2021-03-12 15:00:00+00:00,St. Mary's,898.0,21443,46.0,13774,34.0,376,932.0,80.0,14150,21819,35217
5005,5005,5005,5005,5005,5005,5005,5005,5006,2021-03-13 15:00:00+00:00,St. Mary's,828.0,22271,36.0,13810,9.0,385,837.0,45.0,14195,22656,36081
5006,5006,5006,5006,5006,5006,5006,5006,5007,2021-03-14 15:00:00+00:00,St. Mary's,30.0,22301,27.0,13837,3.0,388,33.0,30.0,14225,22689,36138
5007,5007,5007,5007,5007,5007,5007,5007,5008,2021-03-15 15:00:00+00:00,St. Mary's,372.0,22673,37.0,13874,4.0,392,376.0,41.0,14266,23065,36547
5008,5008,5008,5008,5008,5008,5008,5008,5009,2021-03-16 15:00:00+00:00,St. Mary's,616.0,23289,50.0,13924,7.0,399,623.0,57.0,14323,23688,37213
5009,5009,5009,5009,5009,5009,5009,5009,5010,2021-03-17 15:00:00+00:00,St. Mary's,813.0,24102,29.0,13953,9.0,408,822.0,38.0,14361,24510,38055
5010,5010,5010,5010,5010,5010,5010,5010,5011,2021-03-18 15:00:00+00:00,St. Mary's,111.0,24213,1380.0,15333,2.0,410,113.0,1382.0,15743,24623,39546
5011,5011,5011,5011,5011,5011,5011,5011,5012,2021-03-19 15:00:00+00:00,St. Mary's,801.0,25014,27.0,15360,54.0,464,855.0,81.0,15824,25478,40374
5012,5012,5012,5012,5012,5012,5012,5012,5013,2021-03-20 15:00:00+00:00,St. Mary's,46.0,25060,45.0,15405,4.0,468,50.0,49.0,15873,25528,40465
5013,5013,5013,5013,5013,5013,5013,5013,5014,2021-03-21 15:00:00+00:00,St. Mary's,68.0,25128,21.0,15426,1.0,469,69.0,22.0,15895,25597,40554
5014,5014,5014,5014,5014,5014,5014,5014,5015,2021-03-22 15:00:00+00:00,St. Mary's,185.0,25313,19.0,15445,1.0,470,186.0,20.0,15915,25783,40758
5015,5015,5015,5015,5015,5015,5015,5015,5016,2021-03-23 15:00:00+00:00,St. Mary's,362.0,25675,23.0,15468,5.0,475,367.0,28.0,15943,26150,41143
5016,5016,5016,5016,5016,5016,5016,5016,5017,2021-03-24 15:00:00+00:00,St. Mary's,916.0,26591,40.0,15508,7.0,482,923.0,47.0,15990,27073,42099
5017,5017,5017,5017,5017,5017,5017,5017,5018,2021-03-25 15:00:00+00:00,St. Mary's,118.0,26709,545.0,16053,43.0,525,161.0,588.0,16578,27234,42762
5018,5018,5018,5018,5018,5018,5018,5018,5019,2021-03-26 15:00:00+00:00,St. Mary's,815.0,27524,113.0,16166,7.0,532,822.0,120.0,16698,28056,43690
5019,5019,5019,5019,5019,5019,5019,5019,5020,2021-03-27 15:00:00+00:00,St. Mary's,104.0,27628,27.0,16193,,532,,,16725,28160,43821
5020,5020,5020,5020,5020,5020,5020,5020,5021,2021-03-28 15:00:00+00:00,St. Mary's,201.0,27829,26.0,16219,1.0,533,202.0,27.0,16752,28362,44048
5021,5021,5021,5021,5021,5021,5021,5021,5022,2021-03-29 15:00:00+00:00,St. Mary's,1069.0,28898,59.0,16278,1.0,534,1070.0,60.0,16812,29432,45176
5022,5022,5022,5022,5022,5022,5022,5022,5023,2021-03-30 15:00:00+00:00,St. Mary's,1036.0,29934,46.0,16324,9.0,543,1045.0,55.0,16867,30477,46258
5023,5023,5023,5023,5023,5023,5023,5023,5024,2021-03-31 15:00:00+00:00,St. Mary's,326.0,30260,1210.0,17534,187.0,730,513.0,1397.0,18264,30990,47794
5024,5024,5024,5024,5024,5024,5024,5024,5025,2021-04-01 15:00:00+00:00,St. Mary's,249.0,30509,1088.0,18622,40.0,770,289.0,1128.0,19392,31279,49131
5025,5025,5025,5025,5025,5025,5025,5025,5026,2021-04-02 15:00:00+00:00,St. Mary's,189.0,30698,65.0,18687,62.0,832,251.0,127.0,19519,31530,49385
5026,5026,5026,5026,5026,5026,5026,5026,5027,2021-04-03 15:00:00+00:00,St. Mary's,40.0,30738,57.0,18744,28.0,860,68.0,85.0,19604,31598,49482
5027,5027,5027,5027,5027,5027,5027,5027,5028,2021-04-04 15:00:00+00:00,St. Mary's,75.0,30813,48.0,18792,5.0,865,80.0,53.0,19657,31678,49605
5028,5028,5028,5028,5028,5028,5028,5028,5029,2021-04-05 15:00:00+00:00,St. Mary's,241.0,31054,111.0,18903,31.0,896,272.0,142.0,19799,31950,49957
5029,5029,5029,5029,5029,5029,5029,5029,5030,2021-04-06 15:00:00+00:00,St. Mary's,902.0,31956,87.0,18990,87.0,983,989.0,174.0,19973,32939,50946
5030,5030,5030,5030,5030,5030,5030,5030,5031,2021-04-07 15:00:00+00:00,St. Mary's,167.0,32123,1458.0,20448,114.0,1097,281.0,1572.0,21545,33220,52571
5031,5031,5031,5031,5031,5031,5031,5031,5032,2021-04-08 15:00:00+00:00,St. Mary's,280.0,32403,1266.0,21714,94.0,1191,374.0,1360.0,22905,33594,54117
5032,5032,5032,5032,5032,5032,5032,5032,5033,2021-04-09 15:00:00+00:00,St. Mary's,831.0,33234,110.0,21824,307.0,1498,1138.0,417.0,23322,34732,55058
5033,5033,5033,5033,5033,5033,5033,5033,5034,2021-04-10 15:00:00+00:00,St. Mary's,71.0,33305,46.0,21870,128.0,1626,199.0,174.0,23496,34931,55175
5034,5034,5034,5034,5034,5034,5034,5034,5035,2021-04-11 15:00:00+00:00,St. Mary's,791.0,34096,29.0,21899,60.0,1686,851.0,89.0,23585,35782,55995
5035,5035,5035,5035,5035,5035,5035,5035,5036,2021-04-12 15:00:00+00:00,St. Mary's,230.0,34326,951.0,22850,154.0,1840,384.0,1105.0,24690,36166,57176
5036,5036,5036,5036,5036,5036,5036,5036,5037,2021-04-13 15:00:00+00:00,St. Mary's,1027.0,35353,74.0,22924,16.0,1856,1043.0,90.0,24780,37209,58277
5037,5037,5037,5037,5037,5037,5037,5037,5038,2021-04-14 15:00:00+00:00,St. Mary's,193.0,35546,1350.0,24274,,1856,,,26130,37402,59820
5038,5038,5038,5038,5038,5038,5038,5038,5039,2021-04-15 15:00:00+00:00,St. Mary's,971.0,36517,118.0,24392,,1856,,,26248,38373,60909
5039,5039,5039,5039,5039,5039,5039,5039,5040,2021-04-16 15:00:00+00:00,St. Mary's,1108.0,37625,128.0,24520,,1856,,,26376,39481,62145
5040,5040,5040,5040,5040,5040,5040,5040,5041,2021-04-17 15:00:00+00:00,St. Mary's,1243.0,38868,91.0,24611,,1856,,,26467,40724,63479
5041,5041,5041,5041,5041,5041,5041,5041,5042,2021-04-18 15:00:00+00:00,St. Mary's,1045.0,39913,154.0,24765,,1856,,,26621,41769,64678
5042,5042,5042,5042,5042,5042,5042,5042,5043,2021-04-19 15:00:00+00:00,St. Mary's,253.0,40166,1273.0,26038,,1856,,,27894,42022,66204
5043,5043,5043,5043,5043,5043,5043,5043,5044,2021-04-20 15:00:00+00:00,St. Mary's,259.0,40425,895.0,26933,,1856,,,28789,42281,67358
5044,5044,5044,5044,5044,5044,5044,5044,5045,2021-04-21 15:00:00+00:00,St. Mary's,615.0,41040,245.0,27178,,1856,,,29034,42896,68218
5045,5045,5045,5045,5045,5045,5045,5045,5046,2021-04-22 15:00:00+00:00,St. Mary's,459.0,41499,104.0,27282,,1856,,,29138,43355,68781
5046,5046,5046,5046,5046,5046,5046,5046,5047,2021-04-23 15:00:00+00:00,St. Mary's,557.0,42056,94.0,27376,,1856,,,29232,43912,69432
5047,5047,5047,5047,5047,5047,5047,5047,5048,2021-04-24 15:00:00+00:00,St. Mary's,143.0,42199,88.0,27464,,1856,,,29320,44055,69663
5048,5048,5048,5048,5048,5048,5048,5048,5049,2021-04-25 15:00:00+00:00,St. Mary's,81.0,42280,21.0,27485,,1856,,,29341,44136,69765
5049,5049,5049,5049,5049,5049,5049,5049,5050,2021-04-26 15:00:00+00:00,St. Mary's,178.0,42458,1753.0,29238,,1856,,,31094,44314,71696
5050,5050,5050,5050,5050,5050,5050,5050,5051,2021-04-27 15:00:00+00:00,St. Mary's,228.0,42686,141.0,29379,19.0,1875,247.0,160.0,31254,44561,72065
5051,5051,5051,5051,5051,5051,5051,5051,5052,2021-04-28 15:00:00+00:00,St. Mary's,309.0,42995,191.0,29570,23.0,1898,332.0,214.0,31468,44893,72565
5052,5052,5052,5052,5052,5052,5052,5052,5053,2021-04-29 15:00:00+00:00,St. Mary's,262.0,43257,171.0,29741,15.0,1913,277.0,186.0,31654,45170,72998
5053,5053,5053,5053,5053,5053,5053,5053,5054,2021-04-30 15:00:00+00:00,St. Mary's,246.0,43503,182.0,29923,21.0,1934,267.0,203.0,31857,45437,73426
5054,5054,5054,5054,5054,5054,5054,5054,5055,2021-05-01 15:00:00+00:00,St. Mary's,51.0,43554,110.0,30033,14.0,1948,65.0,124.0,31981,45502,73587
5055,5055,5055,5055,5055,5055,5055,5055,5056,2021-05-02 15:00:00+00:00,St. Mary's,171.0,43725,27.0,30060,22.0,1970,193.0,49.0,32030,45695,73785
5056,5056,5056,5056,5056,5056,5056,5056,5057,2021-05-03 15:00:00+00:00,St. Mary's,61.0,43786,1241.0,31301,27.0,1997,88.0,1268.0,33298,45783,75087
5057,5057,5057,5057,5057,5057,5057,5057,5058,2021-05-04 15:00:00+00:00,St. Mary's,54.0,43840,950.0,32251,40.0,2037,94.0,990.0,34288,45877,76091
5058,5058,5058,5058,5058,5058,5058,5058,5059,2021-05-05 15:00:00+00:00,St. Mary's,224.0,44064,231.0,32482,94.0,2131,318.0,325.0,34613,46195,76546
5059,5059,5059,5059,5059,5059,5059,5059,5060,2021-05-06 15:00:00+00:00,St. Mary's,327.0,44391,269.0,32751,28.0,2159,355.0,297.0,34910,46550,77142
5060,5060,5060,5060,5060,5060,5060,5060,5061,2021-05-07 15:00:00+00:00,St. Mary's,87.0,44478,1539.0,34290,31.0,2190,118.0,1570.0,36480,46668,78768
5061,5061,5061,5061,5061,5061,5061,5061,5062,2021-05-08 15:00:00+00:00,St. Mary's,61.0,44539,1812.0,36102,35.0,2225,96.0,1847.0,38327,46764,80641
5062,5062,5062,5062,5062,5062,5062,5062,5063,2021-05-09 15:00:00+00:00,St. Mary's,24.0,44563,53.0,36155,9.0,2234,33.0,62.0,38389,46797,80718
5063,5063,5063,5063,5063,5063,5063,5063,5064,2021-05-10 15:00:00+00:00,St. Mary's,77.0,44640,1498.0,37653,26.0,2260,103.0,1524.0,39913,46900,82293
5064,5064,5064,5064,5064,5064,5064,5064,5065,2021-05-11 15:00:00+00:00,St. Mary's,253.0,44893,666.0,38319,20.0,2280,273.0,686.0,40599,47173,83212
5065,5065,5065,5065,5065,5065,5065,5065,5066,2021-05-12 15:00:00+00:00,St. Mary's,407.0,45300,173.0,38492,19.0,2299,426.0,192.0,40791,47599,83792
5066,5066,5066,5066,5066,5066,5066,5066,5067,2021-05-13 15:00:00+00:00,St. Mary's,119.0,45419,709.0,39201,11.0,2310,130.0,720.0,41511,47729,84620
5067,5067,5067,5067,5067,5067,5067,5067,5068,2021-05-14 15:00:00+00:00,St. Mary's,413.0,45832,501.0,39702,25.0,2335,438.0,526.0,42037,48167,85534
5068,5068,5068,5068,5068,5068,5068,5068,5069,2021-05-15 15:00:00+00:00,St. Mary's,285.0,46117,44.0,39746,70.0,2405,355.0,114.0,42151,48522,85863
5069,5069,5069,5069,5069,5069,5069,5069,5070,2021-05-16 15:00:00+00:00,St. Mary's,43.0,46160,89.0,39835,53.0,2458,96.0,142.0,42293,48618,85995
5070,5070,5070,5070,5070,5070,5070,5070,5071,2021-05-17 15:00:00+00:00,St. Mary's,622.0,46782,232.0,40067,14.0,2472,636.0,246.0,42539,49254,86849
5071,5071,5071,5071,5071,5071,5071,5071,5072,2021-05-18 15:00:00+00:00,St. Mary's,350.0,47132,441.0,40508,17.0,2489,367.0,458.0,42997,49621,87640
5072,5072,5072,5072,5072,5072,5072,5072,5073,2021-05-19 15:00:00+00:00,St. Mary's,262.0,47394,440.0,40948,9.0,2498,271.0,449.0,43446,49892,88342
5073,5073,5073,5073,5073,5073,5073,5073,5074,2021-05-20 15:00:00+00:00,St. Mary's,447.0,47841,162.0,41110,104.0,2602,551.0,266.0,43712,50443,88951
5074,5074,5074,5074,5074,5074,5074,5074,5075,2021-05-21 15:00:00+00:00,St. Mary's,459.0,48300,287.0,41397,20.0,2622,479.0,307.0,44019,50922,89697
5075,5075,5075,5075,5075,5075,5075,5075,5076,2021-05-22 15:00:00+00:00,St. Mary's,84.0,48384,57.0,41454,7.0,2629,91.0,64.0,44083,51013,89838
5076,5076,5076,5076,5076,5076,5076,5076,5077,2021-05-23 15:00:00+00:00,St. Mary's,74.0,48458,185.0,41639,40.0,2669,114.0,225.0,44308,51127,90097
5077,5077,5077,5077,5077,5077,5077,5077,5078,2021-05-24 15:00:00+00:00,St. Mary's,134.0,48592,271.0,41910,9.0,2678,143.0,280.0,44588,51270,90502
5078,5078,5078,5078,5078,5078,5078,5078,5079,2021-05-25 15:00:00+00:00,St. Mary's,239.0,48831,316.0,42226,14.0,2692,253.0,330.0,44918,51523,91057
5079,5079,5079,5079,5079,5079,5079,5079,5080,2021-05-26 15:00:00+00:00,St. Mary's,134.0,48965,127.0,42353,9.0,2701,143.0,136.0,45054,51666,91318
5080,5080,5080,5080,5080,5080,5080,5080,5081,2021-05-27 15:00:00+00:00,St. Mary's,164.0,49129,112.0,42465,32.0,2733,196.0,144.0,45198,51862,91594
5081,5081,5081,5081,5081,5081,5081,5081,5082,2021-05-28 15:00:00+00:00,St. Mary's,178.0,49307,82.0,42547,42.0,2775,220.0,124.0,45322,52082,91854
5082,5082,5082,5082,5082,5082,5082,5082,5083,2021-05-29 15:00:00+00:00,St. Mary's,42.0,49349,34.0,42581,10.0,2785,52.0,44.0,45366,52134,91930
5083,5083,5083,5083,5083,5083,5083,5083,5084,2021-05-30 15:00:00+00:00,St. Mary's,31.0,49380,42.0,42623,5.0,2790,36.0,47.0,45413,52170,92003
5084,5084,5084,5084,5084,5084,5084,5084,5085,2021-05-31 15:00:00+00:00,St. Mary's,2.0,49382,10.0,42633,3.0,2793,5.0,13.0,45426,52175,92015
5085,5085,5085,5085,5085,5085,5085,5085,5086,2021-06-01 15:00:00+00:00,St. Mary's,129.0,49511,362.0,42995,10.0,2803,139.0,372.0,45798,52314,92506
5086,5086,5086,5086,5086,5086,5086,5086,5087,2021-06-02 15:00:00+00:00,St. Mary's,64.0,49575,889.0,43884,10.0,2813,74.0,899.0,46697,52388,93459
5087,5087,5087,5087,5087,5087,5087,5087,5088,2021-06-03 15:00:00+00:00,St. Mary's,142.0,49717,97.0,43981,11.0,2824,153.0,108.0,46805,52541,93698
5088,5088,5088,5088,5088,5088,5088,5088,5089,2021-06-04 15:00:00+00:00,St. Mary's,102.0,49819,97.0,44078,16.0,2840,118.0,113.0,46918,52659,93897
5089,5089,5089,5089,5089,5089,5089,5089,5090,2021-06-05 15:00:00+00:00,St. Mary's,33.0,49852,45.0,44123,5.0,2845,38.0,50.0,46968,52697,93975
5090,5090,5090,5090,5090,5090,5090,5090,5091,2021-06-06 15:00:00+00:00,St. Mary's,12.0,49864,31.0,44154,4.0,2849,16.0,35.0,47003,52713,94018
5091,5091,5091,5091,5091,5091,5091,5091,5092,2021-06-07 15:00:00+00:00,St. Mary's,58.0,49922,756.0,44910,10.0,2859,68.0,766.0,47769,52781,94832
5092,5092,5092,5092,5092,5092,5092,5092,5093,2021-06-08 15:00:00+00:00,St. Mary's,114.0,50036,726.0,45636,8.0,2867,122.0,734.0,48503,52903,95672
5093,5093,5093,5093,5093,5093,5093,5093,5094,2021-06-09 15:00:00+00:00,St. Mary's,34.0,50070,125.0,45761,11.0,2878,45.0,136.0,48639,52948,95831
5094,5094,5094,5094,5094,5094,5094,5094,5095,2021-06-10 15:00:00+00:00,St. Mary's,110.0,50180,131.0,45892,15.0,2893,125.0,146.0,48785,53073,96072
5095,5095,5095,5095,5095,5095,5095,5095,5096,2021-06-11 15:00:00+00:00,St. Mary's,137.0,50317,152.0,46044,42.0,2935,179.0,194.0,48979,53252,96361
5096,5096,5096,5096,5096,5096,5096,5096,5097,2021-06-12 15:00:00+00:00,St. Mary's,32.0,50349,87.0,46131,4.0,2939,36.0,91.0,49070,53288,96480
5097,5097,5097,5097,5097,5097,5097,5097,5098,2021-06-13 15:00:00+00:00,St. Mary's,17.0,50366,66.0,46197,6.0,2945,23.0,72.0,49142,53311,96563
5098,5098,5098,5098,5098,5098,5098,5098,5099,2021-06-14 15:00:00+00:00,St. Mary's,75.0,50441,196.0,46393,9.0,2954,84.0,205.0,49347,53395,96834
5099,5099,5099,5099,5099,5099,5099,5099,5100,2021-06-15 15:00:00+00:00,St. Mary's,68.0,50509,109.0,46502,19.0,2973,87.0,128.0,49475,53482,97011
5100,5100,5100,5100,5100,5100,5100,5100,5101,2021-06-16 15:00:00+00:00,St. Mary's,110.0,50619,170.0,46672,11.0,2984,121.0,181.0,49656,53603,97291
5101,5101,5101,5101,5101,5101,5101,5101,5102,2021-06-17 15:00:00+00:00,St. Mary's,75.0,50694,175.0,46847,10.0,2994,85.0,185.0,49841,53688,97541
5102,5102,5102,5102,5102,5102,5102,5102,5103,2021-06-18 15:00:00+00:00,St. Mary's,95.0,50789,285.0,47132,12.0,3006,107.0,297.0,50138,53795,97921
5103,5103,5103,5103,5103,5103,5103,5103,5104,2021-06-19 15:00:00+00:00,St. Mary's,36.0,50825,50.0,47182,6.0,3012,42.0,56.0,50194,53837,98007
5104,5104,5104,5104,5104,5104,5104,5104,5105,2021-06-20 15:00:00+00:00,St. Mary's,12.0,50837,24.0,47206,5.0,3017,17.0,29.0,50223,53854,98043
5105,5105,5105,5105,5105,5105,5105,5105,5106,2021-06-21 15:00:00+00:00,St. Mary's,67.0,50904,179.0,47385,8.0,3025,75.0,187.0,50410,53929,98289
5106,5106,5106,5106,5106,5106,5106,5106,5107,2021-06-22 15:00:00+00:00,St. Mary's,42.0,50946,49.0,47434,7.0,3032,49.0,56.0,50466,53978,98380
5107,5107,5107,5107,5107,5107,5107,5107,5108,2021-06-23 15:00:00+00:00,St. Mary's,70.0,51016,50.0,47484,4.0,3036,74.0,54.0,50520,54052,98500
5108,5108,5108,5108,5108,5108,5108,5108,5109,2021-06-24 15:00:00+00:00,St. Mary's,73.0,51089,66.0,47550,8.0,3044,81.0,74.0,50594,54133,98639
5109,5109,5109,5109,5109,5109,5109,5109,5110,2021-06-25 15:00:00+00:00,St. Mary's,62.0,51151,83.0,47633,8.0,3052,70.0,91.0,50685,54203,98784
5110,5110,5110,5110,5110,5110,5110,5110,5111,2021-06-26 15:00:00+00:00,St. Mary's,20.0,51171,34.0,47667,3.0,3055,23.0,37.0,50722,54226,98838
5111,5111,5111,5111,5111,5111,5111,5111,5112,2021-06-27 15:00:00+00:00,St. Mary's,12.0,51183,14.0,47681,3.0,3058,15.0,17.0,50739,54241,98864
5112,5112,5112,5112,5112,5112,5112,5112,5113,2021-06-28 15:00:00+00:00,St. Mary's,55.0,51238,97.0,47778,3.0,3061,58.0,100.0,50839,54299,99016
5113,5113,5113,5113,5113,5113,5113,5113,5114,2021-06-29 15:00:00+00:00,St. Mary's,52.0,51290,66.0,47844,2.0,3063,54.0,68.0,50907,54353,99134
5114,5114,5114,5114,5114,5114,5114,5114,5115,2021-06-30 15:00:00+00:00,St. Mary's,76.0,51366,42.0,47886,19.0,3082,95.0,61.0,50968,54448,99252
5115,5115,5115,5115,5115,5115,5115,5115,5116,2021-07-01 15:00:00+00:00,St. Mary's,69.0,51435,156.0,48042,4.0,3086,73.0,160.0,51128,54521,99477
5116,5116,5116,5116,5116,5116,5116,5116,5117,2021-07-02 15:00:00+00:00,St. Mary's,44.0,51479,40.0,48082,1.0,3087,45.0,41.0,51169,54566,99561
5117,5117,5117,5117,5117,5117,5117,5117,5118,2021-07-03 15:00:00+00:00,St. Mary's,22.0,51501,22.0,48104,2.0,3089,24.0,24.0,51193,54590,99605
5118,5118,5118,5118,5118,5118,5118,5118,5119,2021-07-04 15:00:00+00:00,St. Mary's,1.0,51502,2.0,48106,2.0,3091,3.0,4.0,51197,54593,99608
5119,5119,5119,5119,5119,5119,5119,5119,5120,2021-07-05 15:00:00+00:00,St. Mary's,35.0,51537,43.0,48149,2.0,3093,37.0,45.0,51242,54630,99686
5120,5120,5120,5120,5120,5120,5120,5120,5121,2021-07-06 15:00:00+00:00,St. Mary's,69.0,51606,142.0,48291,2.0,3095,71.0,144.0,51386,54701,99897
5121,5121,5121,5121,5121,5121,5121,5121,5122,2021-07-07 15:00:00+00:00,St. Mary's,54.0,51660,75.0,48366,1.0,3096,55.0,76.0,51462,54756,100026
5122,5122,5122,5122,5122,5122,5122,5122,5123,2021-07-08 15:00:00+00:00,St. Mary's,68.0,51728,60.0,48426,1.0,3097,69.0,61.0,51523,54825,100154
5123,5123,5123,5123,5123,5123,5123,5123,5124,2021-07-09 15:00:00+00:00,St. Mary's,82.0,51810,95.0,48521,7.0,3104,89.0,102.0,51625,54914,100331
5124,5124,5124,5124,5124,5124,5124,5124,5125,2021-07-10 15:00:00+00:00,St. Mary's,24.0,51834,24.0,48545,4.0,3108,28.0,28.0,51653,54942,100379
5125,5125,5125,5125,5125,5125,5125,5125,5126,2021-07-11 15:00:00+00:00,St. Mary's,11.0,51845,21.0,48566,1.0,3109,12.0,22.0,51675,54954,100411
5126,5126,5126,5126,5126,5126,5126,5126,5127,2021-07-12 15:00:00+00:00,St. Mary's,46.0,51891,50.0,48616,,3109,,,51725,55000,100507
5127,5127,5127,5127,5127,5127,5127,5127,5128,2021-07-13 15:00:00+00:00,St. Mary's,95.0,51986,38.0,48654,8.0,3117,103.0,46.0,51771,55103,100640
5128,5128,5128,5128,5128,5128,5128,5128,5129,2021-07-14 15:00:00+00:00,St. Mary's,32.0,52018,74.0,48728,5.0,3122,37.0,79.0,51850,55140,100746
5129,5129,5129,5129,5129,5129,5129,5129,5130,2021-07-15 15:00:00+00:00,St. Mary's,55.0,52073,88.0,48816,5.0,3127,60.0,93.0,51943,55200,100889
5130,5130,5130,5130,5130,5130,5130,5130,5131,2021-07-16 15:00:00+00:00,St. Mary's,58.0,52131,50.0,48866,8.0,3135,66.0,58.0,52001,55266,100997
5131,5131,5131,5131,5131,5131,5131,5131,5132,2021-07-17 15:00:00+00:00,St. Mary's,33.0,52164,26.0,48892,3.0,3138,36.0,29.0,52030,55302,101056
5132,5132,5132,5132,5132,5132,5132,5132,5133,2021-07-18 15:00:00+00:00,St. Mary's,24.0,52188,11.0,48903,,3138,,,52041,55326,101091
5133,5133,5133,5133,5133,5133,5133,5133,5134,2021-07-19 15:00:00+00:00,St. Mary's,76.0,52264,55.0,48958,3.0,3141,79.0,58.0,52099,55405,101222
5134,5134,5134,5134,5134,5134,5134,5134,5135,2021-07-20 15:00:00+00:00,St. Mary's,66.0,52330,95.0,49053,,3141,,,52194,55471,101383
5135,5135,5135,5135,5135,5135,5135,5135,5136,2021-07-21 15:00:00+00:00,St. Mary's,66.0,52396,41.0,49094,8.0,3149,74.0,49.0,52243,55545,101490
5136,5136,5136,5136,5136,5136,5136,5136,5137,2021-07-22 15:00:00+00:00,St. Mary's,120.0,52516,53.0,49147,3.0,3152,123.0,56.0,52299,55668,101663
5137,5137,5137,5137,5137,5137,5137,5137,5138,2021-07-23 15:00:00+00:00,St. Mary's,116.0,52632,50.0,49197,2.0,3154,118.0,52.0,52351,55786,101829
5138,5138,5138,5138,5138,5138,5138,5138,5139,2021-07-24 15:00:00+00:00,St. Mary's,55.0,52687,23.0,49220,1.0,3155,56.0,24.0,52375,55842,101907
5139,5139,5139,5139,5139,5139,5139,5139,5140,2021-07-25 15:00:00+00:00,St. Mary's,32.0,52719,15.0,49235,,3155,,,52390,55874,101954
5140,5140,5140,5140,5140,5140,5140,5140,5141,2021-07-26 15:00:00+00:00,St. Mary's,124.0,52843,32.0,49267,17.0,3172,141.0,49.0,52439,56015,102110
5141,5141,5141,5141,5141,5141,5141,5141,5142,2021-07-27 15:00:00+00:00,St. Mary's,94.0,52937,43.0,49310,5.0,3177,99.0,48.0,52487,56114,102247
5142,5142,5142,5142,5142,5142,5142,5142,5143,2021-07-28 15:00:00+00:00,St. Mary's,125.0,53062,66.0,49376,9.0,3186,134.0,75.0,52562,56248,102438
5143,5143,5143,5143,5143,5143,5143,5143,5144,2021-07-29 15:00:00+00:00,St. Mary's,147.0,53209,88.0,49464,9.0,3195,156.0,97.0,52659,56404,102673
5144,5144,5144,5144,5144,5144,5144,5144,5145,2021-07-30 15:00:00+00:00,St. Mary's,149.0,53358,47.0,49511,11.0,3206,160.0,58.0,52717,56564,102869
5145,5145,5145,5145,5145,5145,5145,5145,5146,2021-07-31 15:00:00+00:00,St. Mary's,61.0,53419,20.0,49531,3.0,3209,64.0,23.0,52740,56628,102950
5146,5146,5146,5146,5146,5146,5146,5146,5147,2021-08-01 15:00:00+00:00,St. Mary's,35.0,53454,11.0,49542,4.0,3213,39.0,15.0,52755,56667,102996
5147,5147,5147,5147,5147,5147,5147,5147,5148,2021-08-02 15:00:00+00:00,St. Mary's,129.0,53583,39.0,49581,7.0,3220,136.0,46.0,52801,56803,103164
5148,5148,5148,5148,5148,5148,5148,5148,5149,2021-08-03 15:00:00+00:00,St. Mary's,119.0,53702,76.0,49657,7.0,3227,126.0,83.0,52884,56929,103359
5149,5149,5149,5149,5149,5149,5149,5149,5150,2021-08-04 15:00:00+00:00,St. Mary's,115.0,53817,60.0,49717,10.0,3237,125.0,70.0,52954,57054,103534
5150,5150,5150,5150,5150,5150,5150,5150,5151,2021-08-05 15:00:00+00:00,St. Mary's,115.0,53932,38.0,49755,2.0,3239,117.0,40.0,52994,57171,103687
5151,5151,5151,5151,5151,5151,5151,5151,5152,2021-08-06 15:00:00+00:00,St. Mary's,139.0,54071,53.0,49808,5.0,3244,144.0,58.0,53052,57315,103879
5152,5152,5152,5152,5152,5152,5152,5152,5153,2021-08-07 15:00:00+00:00,St. Mary's,61.0,54132,28.0,49836,1.0,3245,62.0,29.0,53081,57377,103968
5153,5153,5153,5153,5153,5153,5153,5153,5154,2021-08-08 15:00:00+00:00,St. Mary's,42.0,54174,22.0,49858,1.0,3246,43.0,23.0,53104,57420,104032
5154,5154,5154,5154,5154,5154,5154,5154,5155,2021-08-09 15:00:00+00:00,St. Mary's,125.0,54299,63.0,49921,12.0,3258,137.0,75.0,53179,57557,104220
5155,5155,5155,5155,5155,5155,5155,5155,5156,2021-08-10 15:00:00+00:00,St. Mary's,114.0,54413,106.0,50027,9.0,3267,123.0,115.0,53294,57680,104440
5156,5156,5156,5156,5156,5156,5156,5156,5157,2021-08-11 15:00:00+00:00,St. Mary's,77.0,54490,44.0,50071,3.0,3270,80.0,47.0,53341,57760,104561
5157,5157,5157,5157,5157,5157,5157,5157,5158,2021-08-12 15:00:00+00:00,St. Mary's,128.0,54618,111.0,50182,2.0,3272,130.0,113.0,53454,57890,104800
5158,5158,5158,5158,5158,5158,5158,5158,5159,2021-08-13 15:00:00+00:00,St. Mary's,159.0,54777,73.0,50255,8.0,3280,167.0,81.0,53535,58057,105032
5159,5159,5159,5159,5159,5159,5159,5159,5160,2021-08-14 15:00:00+00:00,St. Mary's,66.0,54843,55.0,50310,,3280,,,53590,58123,105153
5160,5160,5160,5160,5160,5160,5160,5160,5161,2021-08-15 15:00:00+00:00,St. Mary's,38.0,54881,34.0,50344,1.0,3281,39.0,35.0,53625,58162,105225
5161,5161,5161,5161,5161,5161,5161,5161,5162,2021-08-16 15:00:00+00:00,St. Mary's,93.0,54974,72.0,50416,1.0,3282,94.0,73.0,53698,58256,105390
5162,5162,5162,5162,5162,5162,5162,5162,5163,2021-08-17 15:00:00+00:00,St. Mary's,109.0,55083,76.0,50492,2.0,3284,111.0,78.0,53776,58367,105575
5163,5163,5163,5163,5163,5163,5163,5163,5164,2021-08-18 15:00:00+00:00,St. Mary's,72.0,55155,121.0,50613,2.0,3286,74.0,123.0,53899,58441,105768
5164,5164,5164,5164,5164,5164,5164,5164,5165,2021-08-19 15:00:00+00:00,St. Mary's,102.0,55257,77.0,50690,2.0,3288,104.0,79.0,53978,58545,105947
5165,5165,5165,5165,5165,5165,5165,5165,5166,2021-08-20 15:00:00+00:00,St. Mary's,86.0,55343,96.0,50786,2.0,3290,88.0,98.0,54076,58633,106129
5166,5166,5166,5166,5166,5166,5166,5166,5167,2021-08-21 15:00:00+00:00,St. Mary's,70.0,55413,61.0,50847,3.0,3293,73.0,64.0,54140,58706,106260
5167,5167,5167,5167,5167,5167,5167,5167,5168,2021-08-22 15:00:00+00:00,St. Mary's,50.0,55463,30.0,50877,,3293,,,54170,58756,106340
5168,5168,5168,5168,5168,5168,5168,5168,5169,2021-08-23 15:00:00+00:00,St. Mary's,96.0,55559,120.0,50997,2.0,3295,98.0,122.0,54292,58854,106556
5169,5169,5169,5169,5169,5169,5169,5169,5170,2021-08-24 15:00:00+00:00,St. Mary's,104.0,55663,81.0,51078,46.0,3341,150.0,127.0,54419,59004,106741
5170,5170,5170,5170,5170,5170,5170,5170,5171,2021-08-25 15:00:00+00:00,St. Mary's,81.0,55744,100.0,51178,5.0,3346,86.0,105.0,54524,59090,106922
5171,5171,5171,5171,5171,5171,5171,5171,5172,2021-08-26 15:00:00+00:00,St. Mary's,191.0,55935,148.0,51326,9.0,3355,200.0,157.0,54681,59290,107261
5172,5172,5172,5172,5172,5172,5172,5172,5173,2021-08-27 15:00:00+00:00,St. Mary's,130.0,56065,95.0,51421,2.0,3357,132.0,97.0,54778,59422,107486
5173,5173,5173,5173,5173,5173,5173,5173,5174,2021-08-28 15:00:00+00:00,St. Mary's,56.0,56121,63.0,51484,3.0,3360,59.0,66.0,54844,59481,107605
5174,5174,5174,5174,5174,5174,5174,5174,5175,2021-08-29 15:00:00+00:00,St. Mary's,32.0,56153,46.0,51530,,3360,,,54890,59513,107683
5175,5175,5175,5175,5175,5175,5175,5175,5176,2021-08-30 15:00:00+00:00,St. Mary's,85.0,56238,149.0,51679,3.0,3363,88.0,152.0,55042,59601,107917
5176,5176,5176,5176,5176,5176,5176,5176,5177,2021-08-31 15:00:00+00:00,St. Mary's,92.0,56330,115.0,51794,4.0,3367,96.0,119.0,55161,59697,108124
5177,5177,5177,5177,5177,5177,5177,5177,5178,2021-09-01 15:00:00+00:00,St. Mary's,91.0,56421,57.0,51851,5.0,3372,96.0,62.0,55223,59793,108272
5178,5178,5178,5178,5178,5178,5178,5178,5179,2021-09-02 15:00:00+00:00,St. Mary's,101.0,56522,89.0,51940,21.0,3393,122.0,110.0,55333,59915,108462
5179,5179,5179,5179,5179,5179,5179,5179,5180,2021-09-03 15:00:00+00:00,St. Mary's,92.0,56614,118.0,52058,3.0,3396,95.0,121.0,55454,60010,108672
5180,5180,5180,5180,5180,5180,5180,5180,5181,2021-09-04 15:00:00+00:00,St. Mary's,41.0,56655,48.0,52106,1.0,3397,42.0,49.0,55503,60052,108761
5181,5181,5181,5181,5181,5181,5181,5181,5182,2021-09-05 15:00:00+00:00,St. Mary's,31.0,56686,34.0,52140,,3397,,,55537,60083,108826
5182,5182,5182,5182,5182,5182,5182,5182,5183,2021-09-06 15:00:00+00:00,St. Mary's,14.0,56700,15.0,52155,2.0,3399,16.0,17.0,55554,60099,108855
5183,5183,5183,5183,5183,5183,5183,5183,5184,2021-09-07 15:00:00+00:00,St. Mary's,72.0,56772,136.0,52291,,3399,,,55690,60171,109063
5184,5184,5184,5184,5184,5184,5184,5184,5185,2021-09-08 15:00:00+00:00,St. Mary's,67.0,56839,68.0,52359,3.0,3402,70.0,71.0,55761,60241,109198
5185,5185,5185,5185,5185,5185,5185,5185,5186,2021-09-09 15:00:00+00:00,St. Mary's,112.0,56951,87.0,52446,14.0,3416,126.0,101.0,55862,60367,109397
5186,5186,5186,5186,5186,5186,5186,5186,5187,2021-09-10 15:00:00+00:00,St. Mary's,135.0,57086,93.0,52539,9.0,3425,144.0,102.0,55964,60511,109625
5187,5187,5187,5187,5187,5187,5187,5187,5188,2021-09-11 15:00:00+00:00,St. Mary's,52.0,57138,66.0,52605,2.0,3427,54.0,68.0,56032,60565,109743
5188,5188,5188,5188,5188,5188,5188,5188,5189,2021-09-12 15:00:00+00:00,St. Mary's,36.0,57174,30.0,52635,,3427,,,56062,60601,109809
5189,5189,5189,5189,5189,5189,5189,5189,5190,2021-09-13 15:00:00+00:00,St. Mary's,99.0,57273,75.0,52710,9.0,3436,108.0,84.0,56146,60709,109983
5190,5190,5190,5190,5190,5190,5190,5190,5191,2021-09-14 15:00:00+00:00,St. Mary's,90.0,57363,71.0,52781,7.0,3443,97.0,78.0,56224,60806,110144
5191,5191,5191,5191,5191,5191,5191,5191,5192,2021-09-15 15:00:00+00:00,St. Mary's,91.0,57454,84.0,52865,5.0,3448,96.0,89.0,56313,60902,110319
5192,5192,5192,5192,5192,5192,5192,5192,5193,2021-09-16 15:00:00+00:00,St. Mary's,84.0,57538,132.0,52997,6.0,3454,90.0,138.0,56451,60992,110535
5193,5193,5193,5193,5193,5193,5193,5193,5194,2021-09-17 15:00:00+00:00,St. Mary's,108.0,57646,139.0,53136,16.0,3470,124.0,155.0,56606,61116,110782
5194,5194,5194,5194,5194,5194,5194,5194,5195,2021-09-18 15:00:00+00:00,St. Mary's,48.0,57694,51.0,53187,3.0,3473,51.0,54.0,56660,61167,110881
5195,5195,5195,5195,5195,5195,5195,5195,5196,2021-09-19 15:00:00+00:00,St. Mary's,26.0,57720,22.0,53209,3.0,3476,29.0,25.0,56685,61196,110929
5196,5196,5196,5196,5196,5196,5196,5196,5197,2021-09-20 15:00:00+00:00,St. Mary's,70.0,57790,80.0,53289,5.0,3481,75.0,85.0,56770,61271,111079
5197,5197,5197,5197,5197,5197,5197,5197,5198,2021-09-21 15:00:00+00:00,St. Mary's,46.0,57836,85.0,53374,4.0,3485,50.0,89.0,56859,61321,111210
5198,5198,5198,5198,5198,5198,5198,5198,5199,2021-09-22 15:00:00+00:00,St. Mary's,70.0,57906,88.0,53462,7.0,3492,77.0,95.0,56954,61398,111368
5199,5199,5199,5199,5199,5199,5199,5199,5200,2021-09-23 15:00:00+00:00,St. Mary's,78.0,57984,103.0,53565,4.0,3496,82.0,107.0,57061,61480,111549
5200,5200,5200,5200,5200,5200,5200,5200,5201,2021-09-24 15:00:00+00:00,St. Mary's,111.0,58095,96.0,53661,1.0,3497,112.0,97.0,57158,61592,111756
5201,5201,5201,5201,5201,5201,5201,5201,5202,2021-09-25 15:00:00+00:00,St. Mary's,53.0,58148,48.0,53709,,3497,,,57206,61645,111857
5202,5202,5202,5202,5202,5202,5202,5202,5203,2021-09-26 15:00:00+00:00,St. Mary's,23.0,58171,27.0,53736,,3497,,,57233,61668,111907
5203,5203,5203,5203,5203,5203,5203,5203,5204,2021-09-27 15:00:00+00:00,St. Mary's,79.0,58250,35.0,53771,,3497,,,57268,61747,112021
5204,5204,5204,5204,5204,5204,5204,5204,5205,2021-09-28 15:00:00+00:00,St. Mary's,64.0,58314,66.0,53837,3.0,3500,67.0,69.0,57337,61814,112151
5205,5205,5205,5205,5205,5205,5205,5205,5206,2021-09-29 15:00:00+00:00,St. Mary's,77.0,58391,79.0,53916,1.0,3501,78.0,80.0,57417,61892,112307
5206,5206,5206,5206,5206,5206,5206,5206,5207,2021-09-30 15:00:00+00:00,St. Mary's,88.0,58479,93.0,54009,8.0,3509,96.0,101.0,57518,61988,112488
5207,5207,5207,5207,5207,5207,5207,5207,5208,2021-10-01 15:00:00+00:00,St. Mary's,98.0,58577,96.0,54105,14.0,3523,112.0,110.0,57628,62100,112682
5208,5208,5208,5208,5208,5208,5208,5208,5209,2021-10-02 15:00:00+00:00,St. Mary's,58.0,58635,46.0,54151,,3523,,,57674,62158,112786
5209,5209,5209,5209,5209,5209,5209,5209,5210,2021-10-03 15:00:00+00:00,St. Mary's,18.0,58653,41.0,54192,,3523,,,57715,62176,112845
5210,5210,5210,5210,5210,5210,5210,5210,5211,2021-10-04 15:00:00+00:00,St. Mary's,70.0,58723,80.0,54272,40.0,3563,110.0,120.0,57835,62286,112995
5211,5211,5211,5211,5211,5211,5211,5211,5212,2021-10-05 15:00:00+00:00,St. Mary's,79.0,58802,73.0,54345,25.0,3588,104.0,98.0,57933,62390,113147
5212,5212,5212,5212,5212,5212,5212,5212,5213,2021-10-06 15:00:00+00:00,St. Mary's,91.0,58893,70.0,54415,9.0,3597,100.0,79.0,58012,62490,113308
5213,5213,5213,5213,5213,5213,5213,5213,5214,2021-10-07 15:00:00+00:00,St. Mary's,115.0,59008,90.0,54505,12.0,3609,127.0,102.0,58114,62617,113513
5214,5214,5214,5214,5214,5214,5214,5214,5215,2021-10-08 15:00:00+00:00,St. Mary's,146.0,59154,113.0,54618,18.0,3627,164.0,131.0,58245,62781,113772
5215,5215,5215,5215,5215,5215,5215,5215,5216,2021-10-09 15:00:00+00:00,St. Mary's,47.0,59201,38.0,54656,4.0,3631,51.0,42.0,58287,62832,113857
5216,5216,5216,5216,5216,5216,5216,5216,5217,2021-10-10 15:00:00+00:00,St. Mary's,29.0,59230,27.0,54683,,3631,,,58314,62861,113913
5217,5217,5217,5217,5217,5217,5217,5217,5218,2021-10-11 15:00:00+00:00,St. Mary's,113.0,59343,70.0,54753,5.0,3636,118.0,75.0,58389,62979,114096
5218,5218,5218,5218,5218,5218,5218,5218,5219,2021-10-12 15:00:00+00:00,St. Mary's,104.0,59447,57.0,54810,18.0,3654,122.0,75.0,58464,63101,114257
5219,5219,5219,5219,5219,5219,5219,5219,5220,2021-10-13 15:00:00+00:00,St. Mary's,139.0,59586,105.0,54915,13.0,3667,152.0,118.0,58582,63253,114501
5220,5220,5220,5220,5220,5220,5220,5220,5221,2021-10-14 15:00:00+00:00,St. Mary's,110.0,59696,69.0,54984,21.0,3688,131.0,90.0,58672,63384,114680
5221,5221,5221,5221,5221,5221,5221,5221,5222,2021-10-15 15:00:00+00:00,St. Mary's,153.0,59849,72.0,55056,19.0,3707,172.0,91.0,58763,63556,114905
5222,5222,5222,5222,5222,5222,5222,5222,5223,2021-10-16 15:00:00+00:00,St. Mary's,75.0,59924,34.0,55090,17.0,3724,92.0,51.0,58814,63648,115014
5223,5223,5223,5223,5223,5223,5223,5223,5224,2021-10-17 15:00:00+00:00,St. Mary's,25.0,59949,32.0,55122,2.0,3726,27.0,34.0,58848,63675,115071
5224,5224,5224,5224,5224,5224,5224,5224,5225,2021-10-18 15:00:00+00:00,St. Mary's,156.0,60105,66.0,55188,8.0,3734,164.0,74.0,58922,63839,115293
5225,5225,5225,5225,5225,5225,5225,5225,5226,2021-10-19 15:00:00+00:00,St. Mary's,67.0,60172,58.0,55246,46.0,3780,113.0,104.0,59026,63952,115418
5226,5226,5226,5226,5226,5226,5226,5226,5227,2021-10-20 15:00:00+00:00,St. Mary's,75.0,60247,82.0,55328,7.0,3787,82.0,89.0,59115,64034,115575
5227,5227,5227,5227,5227,5227,5227,5227,5228,2021-10-21 15:00:00+00:00,St. Mary's,62.0,60309,91.0,55419,28.0,3815,90.0,119.0,59234,64124,115728
5228,5228,5228,5228,5228,5228,5228,5228,5229,2021-10-22 15:00:00+00:00,St. Mary's,101.0,60410,88.0,55507,17.0,3832,118.0,105.0,59339,64242,115917
5229,5229,5229,5229,5229,5229,5229,5229,5230,2021-10-23 15:00:00+00:00,St. Mary's,25.0,60435,33.0,55540,5.0,3837,30.0,38.0,59377,64272,115975
5230,5230,5230,5230,5230,5230,5230,5230,5231,2021-10-24 15:00:00+00:00,St. Mary's,16.0,60451,15.0,55555,,3837,,,59392,64288,116006
5231,5231,5231,5231,5231,5231,5231,5231,5232,2021-10-25 15:00:00+00:00,St. Mary's,96.0,60547,70.0,55625,14.0,3851,110.0,84.0,59476,64398,116172
5232,5232,5232,5232,5232,5232,5232,5232,5233,2021-10-26 15:00:00+00:00,St. Mary's,88.0,60635,82.0,55707,40.0,3891,128.0,122.0,59598,64526,116342
5233,5233,5233,5233,5233,5233,5233,5233,5234,2021-10-27 15:00:00+00:00,St. Mary's,72.0,60707,130.0,55837,19.0,3910,91.0,149.0,59747,64617,116544
5234,5234,5234,5234,5234,5234,5234,5234,5235,2021-10-28 15:00:00+00:00,St. Mary's,95.0,60802,93.0,55930,22.0,3932,117.0,115.0,59862,64734,116732
5235,5235,5235,5235,5235,5235,5235,5235,5236,2021-10-29 15:00:00+00:00,St. Mary's,64.0,60866,114.0,56044,13.0,3945,77.0,127.0,59989,64811,116910
5236,5236,5236,5236,5236,5236,5236,5236,5237,2021-10-30 15:00:00+00:00,St. Mary's,33.0,60899,36.0,56080,7.0,3952,40.0,43.0,60032,64851,116979
5237,5237,5237,5237,5237,5237,5237,5237,5238,2021-10-31 15:00:00+00:00,St. Mary's,25.0,60924,32.0,56112,,3952,,,60064,64876,117036
5238,5238,5238,5238,5238,5238,5238,5238,5239,2021-11-01 15:00:00+00:00,St. Mary's,97.0,61021,176.0,56288,18.0,3970,115.0,194.0,60258,64991,117309
5239,5239,5239,5239,5239,5239,5239,5239,5240,2021-11-02 15:00:00+00:00,St. Mary's,54.0,61075,93.0,56381,63.0,4033,117.0,156.0,60414,65108,117456
5240,5240,5240,5240,5240,5240,5240,5240,5241,2021-11-03 15:00:00+00:00,St. Mary's,94.0,61169,138.0,56519,19.0,4052,113.0,157.0,60571,65221,117688
5241,5241,5241,5241,5241,5241,5241,5241,5242,2021-11-04 15:00:00+00:00,St. Mary's,59.0,61228,129.0,56648,17.0,4069,76.0,146.0,60717,65297,117876
5242,5242,5242,5242,5242,5242,5242,5242,5243,2021-11-05 15:00:00+00:00,St. Mary's,77.0,61305,149.0,56797,14.0,4083,91.0,163.0,60880,65388,118102
5243,5243,5243,5243,5243,5243,5243,5243,5244,2021-11-06 15:00:00+00:00,St. Mary's,3.0,61308,20.0,56817,3.0,4086,6.0,23.0,60903,65394,118125
5244,5244,5244,5244,5244,5244,5244,5244,5245,2020-12-16 15:00:00+00:00,Talbot,6.0,6,,0,,0,,,0,6,6
5245,5245,5245,5245,5245,5245,5245,5245,5246,2020-12-17 15:00:00+00:00,Talbot,13.0,19,,0,,0,,,0,19,19
5246,5246,5246,5246,5246,5246,5246,5246,5247,2020-12-18 15:00:00+00:00,Talbot,14.0,33,,0,,0,,,0,33,33
5247,5247,5247,5247,5247,5247,5247,5247,5248,2020-12-19 15:00:00+00:00,Talbot,2.0,35,,0,,0,,,0,35,35
5248,5248,5248,5248,5248,5248,5248,5248,5249,2021-11-04 15:00:00+00:00,Frederick,116.0,159675,230.0,151062,29.0,17250,145.0,259.0,168312,176925,310737
5249,5249,5249,5249,5249,5249,5249,5249,5250,2021-11-05 15:00:00+00:00,Frederick,147.0,159822,285.0,151347,24.0,17274,171.0,309.0,168621,177096,311169
5250,5250,5250,5250,5250,5250,5250,5250,5251,2021-11-06 15:00:00+00:00,Frederick,41.0,159863,90.0,151437,17.0,17291,58.0,107.0,168728,177154,311300
5251,5251,5251,5251,5251,5251,5251,5251,5252,2020-12-21 15:00:00+00:00,Garrett,2.0,2,,0,,0,,,0,2,2
5252,5252,5252,5252,5252,5252,5252,5252,5253,2020-12-22 15:00:00+00:00,Garrett,1.0,3,,0,,0,,,0,3,3
5253,5253,5253,5253,5253,5253,5253,5253,5254,2020-12-23 15:00:00+00:00,Garrett,46.0,49,,0,,0,,,0,49,49
5254,5254,5254,5254,5254,5254,5254,5254,5255,2020-12-24 15:00:00+00:00,Garrett,1.0,50,,0,,0,,,0,50,50
5255,5255,5255,5255,5255,5255,5255,5255,5256,2020-12-28 15:00:00+00:00,Garrett,93.0,143,,0,,0,,,0,143,143
5256,5256,5256,5256,5256,5256,5256,5256,5257,2020-12-29 15:00:00+00:00,Garrett,54.0,197,,0,,0,,,0,197,197
5257,5257,5257,5257,5257,5257,5257,5257,5258,2020-12-30 15:00:00+00:00,Garrett,139.0,336,,0,,0,,,0,336,336
5258,5258,5258,5258,5258,5258,5258,5258,5259,2021-01-01 15:00:00+00:00,Garrett,2.0,338,,0,,0,,,0,338,338
5259,5259,5259,5259,5259,5259,5259,5259,5260,2021-01-04 15:00:00+00:00,Garrett,121.0,459,,0,,0,,,0,459,459
5260,5260,5260,5260,5260,5260,5260,5260,5261,2021-01-05 15:00:00+00:00,Garrett,165.0,624,1.0,1,,0,,,1,624,625
5261,5261,5261,5261,5261,5261,5261,5261,5262,2021-01-06 15:00:00+00:00,Garrett,164.0,788,,1,,0,,,1,788,789
5262,5262,5262,5262,5262,5262,5262,5262,5263,2021-01-07 15:00:00+00:00,Garrett,127.0,915,,1,,0,,,1,915,916
5263,5263,5263,5263,5263,5263,5263,5263,5264,2021-01-08 15:00:00+00:00,Garrett,318.0,1233,2.0,3,,0,,,3,1233,1236
5264,5264,5264,5264,5264,5264,5264,5264,5265,2021-01-09 15:00:00+00:00,Garrett,10.0,1243,,3,,0,,,3,1243,1246
5265,5265,5265,5265,5265,5265,5265,5265,5266,2021-01-11 15:00:00+00:00,Garrett,200.0,1443,4.0,7,,0,,,7,1443,1450
5266,5266,5266,5266,5266,5266,5266,5266,5267,2021-01-12 15:00:00+00:00,Garrett,21.0,1464,,7,,0,,,7,1464,1471
5267,5267,5267,5267,5267,5267,5267,5267,5268,2021-01-13 15:00:00+00:00,Garrett,238.0,1702,1.0,8,,0,,,8,1702,1710
5268,5268,5268,5268,5268,5268,5268,5268,5269,2021-01-14 15:00:00+00:00,Garrett,13.0,1715,,8,,0,,,8,1715,1723
5269,5269,5269,5269,5269,5269,5269,5269,5270,2021-01-15 15:00:00+00:00,Garrett,202.0,1917,1.0,9,,0,,,9,1917,1926
5270,5270,5270,5270,5270,5270,5270,5270,5271,2021-01-16 15:00:00+00:00,Garrett,74.0,1991,,9,,0,,,9,1991,2000
5271,5271,5271,5271,5271,5271,5271,5271,5272,2021-01-19 15:00:00+00:00,Garrett,66.0,2057,15.0,24,,0,,,24,2057,2081
5272,5272,5272,5272,5272,5272,5272,5272,5273,2021-01-20 15:00:00+00:00,Garrett,8.0,2065,16.0,40,,0,,,40,2065,2105
5273,5273,5273,5273,5273,5273,5273,5273,5274,2021-01-21 15:00:00+00:00,Garrett,23.0,2088,10.0,50,,0,,,50,2088,2138
5274,5274,5274,5274,5274,5274,5274,5274,5275,2021-01-22 15:00:00+00:00,Garrett,396.0,2484,13.0,63,,0,,,63,2484,2547
5275,5275,5275,5275,5275,5275,5275,5275,5276,2021-01-23 15:00:00+00:00,Garrett,7.0,2491,,63,,0,,,63,2491,2554
5276,5276,5276,5276,5276,5276,5276,5276,5277,2021-01-24 15:00:00+00:00,Garrett,6.0,2497,1.0,64,,0,,,64,2497,2561
5277,5277,5277,5277,5277,5277,5277,5277,5278,2021-01-25 15:00:00+00:00,Garrett,116.0,2613,88.0,152,,0,,,152,2613,2765
5278,5278,5278,5278,5278,5278,5278,5278,5279,2021-01-26 15:00:00+00:00,Garrett,47.0,2660,5.0,157,,0,,,157,2660,2817
5279,5279,5279,5279,5279,5279,5279,5279,5280,2021-01-27 15:00:00+00:00,Garrett,88.0,2748,241.0,398,,0,,,398,2748,3146
5280,5280,5280,5280,5280,5280,5280,5280,5281,2021-01-28 15:00:00+00:00,Garrett,80.0,2828,48.0,446,,0,,,446,2828,3274
5281,5281,5281,5281,5281,5281,5281,5281,5282,2021-01-29 15:00:00+00:00,Garrett,395.0,3223,80.0,526,,0,,,526,3223,3749
5282,5282,5282,5282,5282,5282,5282,5282,5283,2021-01-30 15:00:00+00:00,Garrett,109.0,3332,,526,,0,,,526,3332,3858
5283,5283,5283,5283,5283,5283,5283,5283,5284,2021-01-31 15:00:00+00:00,Garrett,20.0,3352,1.0,527,,0,,,527,3352,3879
5284,5284,5284,5284,5284,5284,5284,5284,5285,2021-02-01 15:00:00+00:00,Garrett,35.0,3387,50.0,577,,0,,,577,3387,3964
5285,5285,5285,5285,5285,5285,5285,5285,5286,2021-02-02 15:00:00+00:00,Garrett,40.0,3427,45.0,622,,0,,,622,3427,4049
5286,5286,5286,5286,5286,5286,5286,5286,5287,2021-02-03 15:00:00+00:00,Garrett,86.0,3513,219.0,841,,0,,,841,3513,4354
5287,5287,5287,5287,5287,5287,5287,5287,5288,2021-02-04 15:00:00+00:00,Garrett,33.0,3546,38.0,879,,0,,,879,3546,4425
5288,5288,5288,5288,5288,5288,5288,5288,5289,2021-02-05 15:00:00+00:00,Garrett,178.0,3724,339.0,1218,,0,,,1218,3724,4942
5289,5289,5289,5289,5289,5289,5289,5289,5290,2021-02-06 15:00:00+00:00,Garrett,13.0,3737,1.0,1219,,0,,,1219,3737,4956
5290,5290,5290,5290,5290,5290,5290,5290,5291,2021-02-07 15:00:00+00:00,Garrett,19.0,3756,,1219,,0,,,1219,3756,4975
5291,5291,5291,5291,5291,5291,5291,5291,5292,2021-02-08 15:00:00+00:00,Garrett,172.0,3928,197.0,1416,,0,,,1416,3928,5344
5292,5292,5292,5292,5292,5292,5292,5292,5293,2021-02-09 15:00:00+00:00,Garrett,160.0,4088,5.0,1421,,0,,,1421,4088,5509
5293,5293,5293,5293,5293,5293,5293,5293,5294,2021-02-10 15:00:00+00:00,Garrett,189.0,4277,160.0,1581,,0,,,1581,4277,5858
5294,5294,5294,5294,5294,5294,5294,5294,5295,2021-02-11 15:00:00+00:00,Garrett,39.0,4316,6.0,1587,,0,,,1587,4316,5903
5295,5295,5295,5295,5295,5295,5295,5295,5296,2021-02-12 15:00:00+00:00,Garrett,150.0,4466,217.0,1804,,0,,,1804,4466,6270
5296,5296,5296,5296,5296,5296,5296,5296,5297,2021-02-13 15:00:00+00:00,Garrett,29.0,4495,79.0,1883,,0,,,1883,4495,6378
5297,5297,5297,5297,5297,5297,5297,5297,5298,2021-02-14 15:00:00+00:00,Garrett,14.0,4509,,1883,,0,,,1883,4509,6392
5298,5298,5298,5298,5298,5298,5298,5298,5299,2021-02-15 15:00:00+00:00,Garrett,3.0,4512,6.0,1889,,0,,,1889,4512,6401
5299,5299,5299,5299,5299,5299,5299,5299,5300,2021-02-16 15:00:00+00:00,Garrett,41.0,4553,82.0,1971,,0,,,1971,4553,6524
5300,5300,5300,5300,5300,5300,5300,5300,5301,2021-02-17 15:00:00+00:00,Garrett,244.0,4797,30.0,2001,,0,,,2001,4797,6798
5301,5301,5301,5301,5301,5301,5301,5301,5302,2021-02-18 15:00:00+00:00,Garrett,19.0,4816,20.0,2021,,0,,,2021,4816,6837
5302,5302,5302,5302,5302,5302,5302,5302,5303,2021-02-19 15:00:00+00:00,Garrett,12.0,4828,62.0,2083,,0,,,2083,4828,6911
5303,5303,5303,5303,5303,5303,5303,5303,5304,2021-02-20 15:00:00+00:00,Garrett,4.0,4832,1.0,2084,,0,,,2084,4832,6916
5304,5304,5304,5304,5304,5304,5304,5304,5305,2020-12-21 15:00:00+00:00,Talbot,16.0,51,,0,,0,,,0,51,51
5305,5305,5305,5305,5305,5305,5305,5305,5306,2020-12-22 15:00:00+00:00,Talbot,32.0,83,,0,,0,,,0,83,83
5306,5306,5306,5306,5306,5306,5306,5306,5307,2020-12-23 15:00:00+00:00,Talbot,48.0,131,,0,,0,,,0,131,131
5307,5307,5307,5307,5307,5307,5307,5307,5308,2020-12-24 15:00:00+00:00,Talbot,9.0,140,,0,,0,,,0,140,140
5308,5308,5308,5308,5308,5308,5308,5308,5309,2020-12-25 15:00:00+00:00,Talbot,5.0,145,,0,,0,,,0,145,145
5309,5309,5309,5309,5309,5309,5309,5309,5310,2020-12-26 15:00:00+00:00,Talbot,10.0,155,,0,,0,,,0,155,155
5310,5310,5310,5310,5310,5310,5310,5310,5311,2020-12-27 15:00:00+00:00,Talbot,17.0,172,,0,,0,,,0,172,172
5311,5311,5311,5311,5311,5311,5311,5311,5312,2020-12-28 15:00:00+00:00,Talbot,101.0,273,,0,,0,,,0,273,273
5312,5312,5312,5312,5312,5312,5312,5312,5313,2020-12-29 15:00:00+00:00,Talbot,59.0,332,,0,,0,,,0,332,332
5313,5313,5313,5313,5313,5313,5313,5313,5314,2020-12-30 15:00:00+00:00,Talbot,152.0,484,,0,,0,,,0,484,484
5314,5314,5314,5314,5314,5314,5314,5314,5315,2020-12-31 15:00:00+00:00,Talbot,71.0,555,,0,,0,,,0,555,555
5315,5315,5315,5315,5315,5315,5315,5315,5316,2021-01-01 15:00:00+00:00,Talbot,4.0,559,,0,,0,,,0,559,559
5316,5316,5316,5316,5316,5316,5316,5316,5317,2021-01-02 15:00:00+00:00,Talbot,59.0,618,,0,,0,,,0,618,618
5317,5317,5317,5317,5317,5317,5317,5317,5318,2021-01-03 15:00:00+00:00,Talbot,12.0,630,1.0,1,,0,,,1,630,631
5318,5318,5318,5318,5318,5318,5318,5318,5319,2021-01-04 15:00:00+00:00,Talbot,116.0,746,,1,,0,,,1,746,747
5319,5319,5319,5319,5319,5319,5319,5319,5320,2021-01-05 15:00:00+00:00,Talbot,131.0,877,1.0,2,,0,,,2,877,879
5320,5320,5320,5320,5320,5320,5320,5320,5321,2021-01-06 15:00:00+00:00,Talbot,173.0,1050,4.0,6,,0,,,6,1050,1056
5321,5321,5321,5321,5321,5321,5321,5321,5322,2021-01-07 15:00:00+00:00,Talbot,99.0,1149,7.0,13,,0,,,13,1149,1162
5322,5322,5322,5322,5322,5322,5322,5322,5323,2021-01-08 15:00:00+00:00,Talbot,315.0,1464,18.0,31,,0,,,31,1464,1495
5323,5323,5323,5323,5323,5323,5323,5323,5324,2021-01-09 15:00:00+00:00,Talbot,5.0,1469,1.0,32,,0,,,32,1469,1501
5324,5324,5324,5324,5324,5324,5324,5324,5325,2021-01-11 15:00:00+00:00,Talbot,163.0,1632,15.0,47,,0,,,47,1632,1679
5325,5325,5325,5325,5325,5325,5325,5325,5326,2021-01-12 15:00:00+00:00,Talbot,119.0,1751,29.0,76,,0,,,76,1751,1827
5326,5326,5326,5326,5326,5326,5326,5326,5327,2021-01-13 15:00:00+00:00,Talbot,114.0,1865,20.0,96,,0,,,96,1865,1961
5327,5327,5327,5327,5327,5327,5327,5327,5328,2021-01-14 15:00:00+00:00,Talbot,185.0,2050,10.0,106,,0,,,106,2050,2156
5328,5328,5328,5328,5328,5328,5328,5328,5329,2021-01-15 15:00:00+00:00,Talbot,407.0,2457,1.0,107,,0,,,107,2457,2564
5329,5329,5329,5329,5329,5329,5329,5329,5330,2021-01-16 15:00:00+00:00,Talbot,12.0,2469,4.0,111,,0,,,111,2469,2580
5330,5330,5330,5330,5330,5330,5330,5330,5331,2021-01-17 15:00:00+00:00,Talbot,1.0,2470,4.0,115,,0,,,115,2470,2585
5331,5331,5331,5331,5331,5331,5331,5331,5332,2021-01-18 15:00:00+00:00,Talbot,53.0,2523,50.0,165,,0,,,165,2523,2688
5332,5332,5332,5332,5332,5332,5332,5332,5333,2021-01-19 15:00:00+00:00,Talbot,125.0,2648,13.0,178,,0,,,178,2648,2826
5333,5333,5333,5333,5333,5333,5333,5333,5334,2021-01-20 15:00:00+00:00,Talbot,258.0,2906,27.0,205,,0,,,205,2906,3111
5334,5334,5334,5334,5334,5334,5334,5334,5335,2021-01-21 15:00:00+00:00,Talbot,200.0,3106,13.0,218,,0,,,218,3106,3324
5335,5335,5335,5335,5335,5335,5335,5335,5336,2021-01-22 15:00:00+00:00,Talbot,786.0,3892,25.0,243,,0,,,243,3892,4135
5336,5336,5336,5336,5336,5336,5336,5336,5337,2021-01-23 15:00:00+00:00,Talbot,67.0,3959,57.0,300,,0,,,300,3959,4259
5337,5337,5337,5337,5337,5337,5337,5337,5338,2021-01-24 15:00:00+00:00,Talbot,2.0,3961,2.0,302,,0,,,302,3961,4263
5338,5338,5338,5338,5338,5338,5338,5338,5339,2021-01-25 15:00:00+00:00,Talbot,137.0,4098,56.0,358,,0,,,358,4098,4456
5339,5339,5339,5339,5339,5339,5339,5339,5340,2021-01-26 15:00:00+00:00,Talbot,151.0,4249,59.0,417,,0,,,417,4249,4666
5340,5340,5340,5340,5340,5340,5340,5340,5341,2021-01-27 15:00:00+00:00,Talbot,104.0,4353,90.0,507,,0,,,507,4353,4860
5341,5341,5341,5341,5341,5341,5341,5341,5342,2021-01-28 15:00:00+00:00,Talbot,91.0,4444,65.0,572,,0,,,572,4444,5016
5342,5342,5342,5342,5342,5342,5342,5342,5343,2021-01-29 15:00:00+00:00,Talbot,360.0,4804,54.0,626,,0,,,626,4804,5430
5343,5343,5343,5343,5343,5343,5343,5343,5344,2021-01-30 15:00:00+00:00,Talbot,13.0,4817,5.0,631,,0,,,631,4817,5448
5344,5344,5344,5344,5344,5344,5344,5344,5345,2021-01-31 15:00:00+00:00,Talbot,32.0,4849,,631,,0,,,631,4849,5480
5345,5345,5345,5345,5345,5345,5345,5345,5346,2021-02-01 15:00:00+00:00,Talbot,43.0,4892,36.0,667,,0,,,667,4892,5559
5346,5346,5346,5346,5346,5346,5346,5346,5347,2021-02-02 15:00:00+00:00,Talbot,113.0,5005,81.0,748,,0,,,748,5005,5753
5347,5347,5347,5347,5347,5347,5347,5347,5348,2021-02-03 15:00:00+00:00,Talbot,99.0,5104,200.0,948,,0,,,948,5104,6052
5348,5348,5348,5348,5348,5348,5348,5348,5349,2021-02-04 15:00:00+00:00,Talbot,143.0,5247,109.0,1057,,0,,,1057,5247,6304
5349,5349,5349,5349,5349,5349,5349,5349,5350,2021-02-05 15:00:00+00:00,Talbot,356.0,5603,329.0,1386,,0,,,1386,5603,6989
5350,5350,5350,5350,5350,5350,5350,5350,5351,2021-02-06 15:00:00+00:00,Talbot,27.0,5630,11.0,1397,,0,,,1397,5630,7027
5351,5351,5351,5351,5351,5351,5351,5351,5352,2021-02-07 15:00:00+00:00,Talbot,13.0,5643,2.0,1399,,0,,,1399,5643,7042
5352,5352,5352,5352,5352,5352,5352,5352,5353,2021-02-08 15:00:00+00:00,Talbot,63.0,5706,173.0,1572,,0,,,1572,5706,7278
5353,5353,5353,5353,5353,5353,5353,5353,5354,2021-02-09 15:00:00+00:00,Talbot,147.0,5853,138.0,1710,,0,,,1710,5853,7563
5354,5354,5354,5354,5354,5354,5354,5354,5355,2021-02-10 15:00:00+00:00,Talbot,179.0,6032,245.0,1955,,0,,,1955,6032,7987
5355,5355,5355,5355,5355,5355,5355,5355,5356,2021-02-11 15:00:00+00:00,Talbot,214.0,6246,75.0,2030,,0,,,2030,6246,8276
5356,5356,5356,5356,5356,5356,5356,5356,5357,2021-02-12 15:00:00+00:00,Talbot,130.0,6376,155.0,2185,,0,,,2185,6376,8561
5357,5357,5357,5357,5357,5357,5357,5357,5358,2021-02-13 15:00:00+00:00,Talbot,21.0,6397,9.0,2194,,0,,,2194,6397,8591
5358,5358,5358,5358,5358,5358,5358,5358,5359,2021-02-14 15:00:00+00:00,Talbot,17.0,6414,60.0,2254,,0,,,2254,6414,8668
5359,5359,5359,5359,5359,5359,5359,5359,5360,2021-02-15 15:00:00+00:00,Talbot,33.0,6447,82.0,2336,,0,,,2336,6447,8783
5360,5360,5360,5360,5360,5360,5360,5360,5361,2021-02-16 15:00:00+00:00,Talbot,84.0,6531,138.0,2474,,0,,,2474,6531,9005
5361,5361,5361,5361,5361,5361,5361,5361,5362,2021-02-17 15:00:00+00:00,Talbot,325.0,6856,192.0,2666,,0,,,2666,6856,9522
5362,5362,5362,5362,5362,5362,5362,5362,5363,2021-02-18 15:00:00+00:00,Talbot,55.0,6911,103.0,2769,,0,,,2769,6911,9680
5363,5363,5363,5363,5363,5363,5363,5363,5364,2021-02-19 15:00:00+00:00,Talbot,90.0,7001,634.0,3403,,0,,,3403,7001,10404
5364,5364,5364,5364,5364,5364,5364,5364,5365,2021-02-20 15:00:00+00:00,Talbot,21.0,7022,28.0,3431,,0,,,3431,7022,10453
5365,5365,5365,5365,5365,5365,5365,5365,5366,2021-02-21 15:00:00+00:00,Talbot,16.0,7038,9.0,3440,,0,,,3440,7038,10478
5366,5366,5366,5366,5366,5366,5366,5366,5367,2021-02-22 15:00:00+00:00,Talbot,36.0,7074,163.0,3603,,0,,,3603,7074,10677
5367,5367,5367,5367,5367,5367,5367,5367,5368,2021-02-23 15:00:00+00:00,Talbot,38.0,7112,89.0,3692,,0,,,3692,7112,10804
5368,5368,5368,5368,5368,5368,5368,5368,5369,2021-02-24 15:00:00+00:00,Talbot,123.0,7235,406.0,4098,,0,,,4098,7235,11333
5369,5369,5369,5369,5369,5369,5369,5369,5370,2021-02-25 15:00:00+00:00,Talbot,102.0,7337,201.0,4299,,0,,,4299,7337,11636
5370,5370,5370,5370,5370,5370,5370,5370,5371,2021-02-26 15:00:00+00:00,Talbot,364.0,7701,386.0,4685,,0,,,4685,7701,12386
5371,5371,5371,5371,5371,5371,5371,5371,5372,2021-02-27 15:00:00+00:00,Talbot,63.0,7764,7.0,4692,,0,,,4692,7764,12456
5372,5372,5372,5372,5372,5372,5372,5372,5373,2021-02-28 15:00:00+00:00,Talbot,98.0,7862,4.0,4696,,0,,,4696,7862,12558
5373,5373,5373,5373,5373,5373,5373,5373,5374,2021-03-01 15:00:00+00:00,Talbot,163.0,8025,51.0,4747,,0,,,4747,8025,12772
5374,5374,5374,5374,5374,5374,5374,5374,5375,2021-03-02 15:00:00+00:00,Talbot,161.0,8186,109.0,4856,,0,,,4856,8186,13042
5375,5375,5375,5375,5375,5375,5375,5375,5376,2021-03-03 15:00:00+00:00,Talbot,348.0,8534,38.0,4894,4.0,4,352.0,42.0,4898,8538,13428
5376,5376,5376,5376,5376,5376,5376,5376,5377,2021-03-04 15:00:00+00:00,Talbot,282.0,8816,172.0,5066,12.0,16,294.0,184.0,5082,8832,13882
5377,5377,5377,5377,5377,5377,5377,5377,5378,2021-03-05 15:00:00+00:00,Talbot,308.0,9124,340.0,5406,7.0,23,315.0,347.0,5429,9147,14530
5378,5378,5378,5378,5378,5378,5378,5378,5379,2021-03-06 15:00:00+00:00,Talbot,97.0,9221,31.0,5437,181.0,204,278.0,212.0,5641,9425,14658
5379,5379,5379,5379,5379,5379,5379,5379,5380,2021-03-07 15:00:00+00:00,Talbot,102.0,9323,17.0,5454,55.0,259,157.0,72.0,5713,9582,14777
5380,5380,5380,5380,5380,5380,5380,5380,5381,2021-03-08 15:00:00+00:00,Talbot,168.0,9491,113.0,5567,28.0,287,196.0,141.0,5854,9778,15058
5381,5381,5381,5381,5381,5381,5381,5381,5382,2021-03-09 15:00:00+00:00,Talbot,176.0,9667,110.0,5677,30.0,317,206.0,140.0,5994,9984,15344
5382,5382,5382,5382,5382,5382,5382,5382,5383,2021-03-10 15:00:00+00:00,Talbot,424.0,10091,58.0,5735,17.0,334,441.0,75.0,6069,10425,15826
5383,5383,5383,5383,5383,5383,5383,5383,5384,2021-03-11 15:00:00+00:00,Talbot,253.0,10344,197.0,5932,17.0,351,270.0,214.0,6283,10695,16276
5384,5384,5384,5384,5384,5384,5384,5384,5385,2021-03-12 15:00:00+00:00,Talbot,251.0,10595,128.0,6060,132.0,483,383.0,260.0,6543,11078,16655
5385,5385,5385,5385,5385,5385,5385,5385,5386,2021-03-13 15:00:00+00:00,Talbot,74.0,10669,110.0,6170,111.0,594,185.0,221.0,6764,11263,16839
5386,5386,5386,5386,5386,5386,5386,5386,5387,2021-03-14 15:00:00+00:00,Talbot,77.0,10746,14.0,6184,89.0,683,166.0,103.0,6867,11429,16930
5387,5387,5387,5387,5387,5387,5387,5387,5388,2021-03-15 15:00:00+00:00,Talbot,98.0,10844,63.0,6247,4.0,687,102.0,67.0,6934,11531,17091
5388,5388,5388,5388,5388,5388,5388,5388,5389,2021-03-16 15:00:00+00:00,Talbot,202.0,11046,108.0,6355,2.0,689,204.0,110.0,7044,11735,17401
5389,5389,5389,5389,5389,5389,5389,5389,5390,2021-03-17 15:00:00+00:00,Talbot,117.0,11163,303.0,6658,3.0,692,120.0,306.0,7350,11855,17821
5390,5390,5390,5390,5390,5390,5390,5390,5391,2021-03-18 15:00:00+00:00,Talbot,163.0,11326,125.0,6783,31.0,723,194.0,156.0,7506,12049,18109
5391,5391,5391,5391,5391,5391,5391,5391,5392,2021-03-19 15:00:00+00:00,Talbot,491.0,11817,117.0,6900,29.0,752,520.0,146.0,7652,12569,18717
5392,5392,5392,5392,5392,5392,5392,5392,5393,2021-03-20 15:00:00+00:00,Talbot,153.0,11970,31.0,6931,6.0,758,159.0,37.0,7689,12728,18901
5393,5393,5393,5393,5393,5393,5393,5393,5394,2021-03-21 15:00:00+00:00,Talbot,132.0,12102,31.0,6962,17.0,775,149.0,48.0,7737,12877,19064
5394,5394,5394,5394,5394,5394,5394,5394,5395,2021-03-22 15:00:00+00:00,Talbot,184.0,12286,61.0,7023,23.0,798,207.0,84.0,7821,13084,19309
5395,5395,5395,5395,5395,5395,5395,5395,5396,2021-03-23 15:00:00+00:00,Talbot,259.0,12545,65.0,7088,29.0,827,288.0,94.0,7915,13372,19633
5396,5396,5396,5396,5396,5396,5396,5396,5397,2021-03-24 15:00:00+00:00,Talbot,326.0,12871,111.0,7199,14.0,841,340.0,125.0,8040,13712,20070
5397,5397,5397,5397,5397,5397,5397,5397,5398,2021-03-25 15:00:00+00:00,Talbot,255.0,13126,111.0,7310,7.0,848,262.0,118.0,8158,13974,20436
5398,5398,5398,5398,5398,5398,5398,5398,5399,2021-03-26 15:00:00+00:00,Talbot,486.0,13612,415.0,7725,28.0,876,514.0,443.0,8601,14488,21337
5399,5399,5399,5399,5399,5399,5399,5399,5400,2021-03-27 15:00:00+00:00,Talbot,67.0,13679,78.0,7803,19.0,895,86.0,97.0,8698,14574,21482
5400,5400,5400,5400,5400,5400,5400,5400,5401,2021-03-28 15:00:00+00:00,Talbot,73.0,13752,81.0,7884,1.0,896,74.0,82.0,8780,14648,21636
5401,5401,5401,5401,5401,5401,5401,5401,5402,2021-03-29 15:00:00+00:00,Talbot,159.0,13911,138.0,8022,34.0,930,193.0,172.0,8952,14841,21933
5402,5402,5402,5402,5402,5402,5402,5402,5403,2021-03-30 15:00:00+00:00,Talbot,166.0,14077,183.0,8205,30.0,960,196.0,213.0,9165,15037,22282
5403,5403,5403,5403,5403,5403,5403,5403,5404,2021-03-31 15:00:00+00:00,Talbot,197.0,14274,367.0,8572,124.0,1084,321.0,491.0,9656,15358,22846
5404,5404,5404,5404,5404,5404,5404,5404,5405,2021-04-01 15:00:00+00:00,Talbot,120.0,14394,317.0,8889,97.0,1181,217.0,414.0,10070,15575,23283
5405,5405,5405,5405,5405,5405,5405,5405,5406,2021-04-02 15:00:00+00:00,Talbot,343.0,14737,319.0,9208,56.0,1237,399.0,375.0,10445,15974,23945
5406,5406,5406,5406,5406,5406,5406,5406,5407,2021-04-03 15:00:00+00:00,Talbot,163.0,14900,67.0,9275,47.0,1284,210.0,114.0,10559,16184,24175
5407,5407,5407,5407,5407,5407,5407,5407,5408,2021-04-04 15:00:00+00:00,Talbot,22.0,14922,74.0,9349,2.0,1286,24.0,76.0,10635,16208,24271
5408,5408,5408,5408,5408,5408,5408,5408,5409,2021-04-05 15:00:00+00:00,Talbot,61.0,14983,133.0,9482,86.0,1372,147.0,219.0,10854,16355,24465
5409,5409,5409,5409,5409,5409,5409,5409,5410,2021-04-06 15:00:00+00:00,Talbot,125.0,15108,186.0,9668,56.0,1428,181.0,242.0,11096,16536,24776
5410,5410,5410,5410,5410,5410,5410,5410,5411,2021-04-07 15:00:00+00:00,Talbot,91.0,15199,231.0,9899,119.0,1547,210.0,350.0,11446,16746,25098
5411,5411,5411,5411,5411,5411,5411,5411,5412,2021-04-08 15:00:00+00:00,Talbot,89.0,15288,256.0,10155,175.0,1722,264.0,431.0,11877,17010,25443
5412,5412,5412,5412,5412,5412,5412,5412,5413,2021-04-09 15:00:00+00:00,Talbot,121.0,15409,373.0,10528,306.0,2028,427.0,679.0,12556,17437,25937
5413,5413,5413,5413,5413,5413,5413,5413,5414,2021-04-10 15:00:00+00:00,Talbot,187.0,15596,110.0,10638,60.0,2088,247.0,170.0,12726,17684,26234
5414,5414,5414,5414,5414,5414,5414,5414,5415,2021-04-11 15:00:00+00:00,Talbot,45.0,15641,80.0,10718,22.0,2110,67.0,102.0,12828,17751,26359
5415,5415,5415,5415,5415,5415,5415,5415,5416,2021-04-12 15:00:00+00:00,Talbot,42.0,15683,150.0,10868,63.0,2173,105.0,213.0,13041,17856,26551
5416,5416,5416,5416,5416,5416,5416,5416,5417,2021-04-13 15:00:00+00:00,Talbot,115.0,15798,249.0,11117,1.0,2174,116.0,250.0,13291,17972,26915
5417,5417,5417,5417,5417,5417,5417,5417,5418,2021-04-14 15:00:00+00:00,Talbot,186.0,15984,115.0,11232,,2174,,,13406,18158,27216
5418,5418,5418,5418,5418,5418,5418,5418,5419,2021-04-15 15:00:00+00:00,Talbot,169.0,16153,223.0,11455,7.0,2181,176.0,230.0,13636,18334,27608
5419,5419,5419,5419,5419,5419,5419,5419,5420,2021-04-16 15:00:00+00:00,Talbot,378.0,16531,509.0,11964,,2181,,,14145,18712,28495
5420,5420,5420,5420,5420,5420,5420,5420,5421,2021-04-17 15:00:00+00:00,Talbot,39.0,16570,52.0,12016,,2181,,,14197,18751,28586
5421,5421,5421,5421,5421,5421,5421,5421,5422,2021-04-18 15:00:00+00:00,Talbot,21.0,16591,78.0,12094,,2181,,,14275,18772,28685
5422,5422,5422,5422,5422,5422,5422,5422,5423,2021-04-19 15:00:00+00:00,Talbot,66.0,16657,172.0,12266,,2181,,,14447,18838,28923
5423,5423,5423,5423,5423,5423,5423,5423,5424,2021-04-20 15:00:00+00:00,Talbot,113.0,16770,293.0,12559,,2181,,,14740,18951,29329
5424,5424,5424,5424,5424,5424,5424,5424,5425,2021-04-21 15:00:00+00:00,Talbot,187.0,16957,350.0,12909,,2181,,,15090,19138,29866
5425,5425,5425,5425,5425,5425,5425,5425,5426,2021-04-22 15:00:00+00:00,Talbot,177.0,17134,269.0,13178,,2181,,,15359,19315,30312
5426,5426,5426,5426,5426,5426,5426,5426,5427,2021-04-23 15:00:00+00:00,Talbot,220.0,17354,407.0,13585,,2181,,,15766,19535,30939
5427,5427,5427,5427,5427,5427,5427,5427,5428,2021-04-24 15:00:00+00:00,Talbot,83.0,17437,169.0,13754,,2181,,,15935,19618,31191
5428,5428,5428,5428,5428,5428,5428,5428,5429,2021-04-25 15:00:00+00:00,Talbot,54.0,17491,16.0,13770,,2181,,,15951,19672,31261
5429,5429,5429,5429,5429,5429,5429,5429,5430,2021-04-26 15:00:00+00:00,Talbot,36.0,17527,118.0,13888,9.0,2190,45.0,127.0,16078,19717,31415
5430,5430,5430,5430,5430,5430,5430,5430,5431,2021-04-27 15:00:00+00:00,Talbot,68.0,17595,149.0,14037,11.0,2201,79.0,160.0,16238,19796,31632
5431,5431,5431,5431,5431,5431,5431,5431,5432,2021-04-28 15:00:00+00:00,Talbot,94.0,17689,154.0,14191,15.0,2216,109.0,169.0,16407,19905,31880
5432,5432,5432,5432,5432,5432,5432,5432,5433,2021-04-29 15:00:00+00:00,Talbot,43.0,17732,127.0,14318,31.0,2247,74.0,158.0,16565,19979,32050
5433,5433,5433,5433,5433,5433,5433,5433,5434,2021-04-30 15:00:00+00:00,Talbot,69.0,17801,254.0,14572,37.0,2284,106.0,291.0,16856,20085,32373
5434,5434,5434,5434,5434,5434,5434,5434,5435,2021-05-01 15:00:00+00:00,Talbot,82.0,17883,75.0,14647,2.0,2286,84.0,77.0,16933,20169,32530
5435,5435,5435,5435,5435,5435,5435,5435,5436,2021-05-02 15:00:00+00:00,Talbot,8.0,17891,28.0,14675,,2286,,,16961,20177,32566
5436,5436,5436,5436,5436,5436,5436,5436,5437,2021-05-03 15:00:00+00:00,Talbot,22.0,17913,41.0,14716,1.0,2287,23.0,42.0,17003,20200,32629
5437,5437,5437,5437,5437,5437,5437,5437,5438,2021-05-04 15:00:00+00:00,Talbot,41.0,17954,115.0,14831,20.0,2307,61.0,135.0,17138,20261,32785
5438,5438,5438,5438,5438,5438,5438,5438,5439,2021-05-05 15:00:00+00:00,Talbot,60.0,18014,158.0,14989,6.0,2313,66.0,164.0,17302,20327,33003
5439,5439,5439,5439,5439,5439,5439,5439,5440,2021-05-06 15:00:00+00:00,Talbot,70.0,18084,132.0,15121,14.0,2327,84.0,146.0,17448,20411,33205
5440,5440,5440,5440,5440,5440,5440,5440,5441,2021-05-07 15:00:00+00:00,Talbot,38.0,18122,90.0,15211,4.0,2331,42.0,94.0,17542,20453,33333
5441,5441,5441,5441,5441,5441,5441,5441,5442,2021-05-08 15:00:00+00:00,Talbot,22.0,18144,134.0,15345,9.0,2340,31.0,143.0,17685,20484,33489
5442,5442,5442,5442,5442,5442,5442,5442,5443,2021-05-09 15:00:00+00:00,Talbot,4.0,18148,21.0,15366,1.0,2341,5.0,22.0,17707,20489,33514
5443,5443,5443,5443,5443,5443,5443,5443,5444,2021-05-10 15:00:00+00:00,Talbot,37.0,18185,70.0,15436,2.0,2343,39.0,72.0,17779,20528,33621
5444,5444,5444,5444,5444,5444,5444,5444,5445,2021-05-11 15:00:00+00:00,Talbot,41.0,18226,80.0,15516,19.0,2362,60.0,99.0,17878,20588,33742
5445,5445,5445,5445,5445,5445,5445,5445,5446,2021-05-12 15:00:00+00:00,Talbot,44.0,18270,106.0,15622,29.0,2391,73.0,135.0,18013,20661,33892
5446,5446,5446,5446,5446,5446,5446,5446,5447,2021-05-13 15:00:00+00:00,Talbot,51.0,18321,101.0,15723,28.0,2419,79.0,129.0,18142,20740,34044
5447,5447,5447,5447,5447,5447,5447,5447,5448,2021-05-14 15:00:00+00:00,Talbot,111.0,18432,341.0,16064,38.0,2457,149.0,379.0,18521,20889,34496
5448,5448,5448,5448,5448,5448,5448,5448,5449,2021-05-15 15:00:00+00:00,Talbot,44.0,18476,45.0,16109,6.0,2463,50.0,51.0,18572,20939,34585
5449,5449,5449,5449,5449,5449,5449,5449,5450,2021-05-16 15:00:00+00:00,Talbot,25.0,18501,21.0,16130,31.0,2494,56.0,52.0,18624,20995,34631
5450,5450,5450,5450,5450,5450,5450,5450,5451,2021-05-17 15:00:00+00:00,Talbot,58.0,18559,36.0,16166,17.0,2511,75.0,53.0,18677,21070,34725
5451,5451,5451,5451,5451,5451,5451,5451,5452,2021-05-18 15:00:00+00:00,Talbot,96.0,18655,143.0,16309,4.0,2515,100.0,147.0,18824,21170,34964
5452,5452,5452,5452,5452,5452,5452,5452,5453,2021-05-19 15:00:00+00:00,Talbot,123.0,18778,150.0,16459,15.0,2530,138.0,165.0,18989,21308,35237
5453,5453,5453,5453,5453,5453,5453,5453,5454,2021-05-20 15:00:00+00:00,Talbot,83.0,18861,115.0,16574,4.0,2534,87.0,119.0,19108,21395,35435
5454,5454,5454,5454,5454,5454,5454,5454,5455,2021-05-21 15:00:00+00:00,Talbot,123.0,18984,202.0,16776,4.0,2538,127.0,206.0,19314,21522,35760
5455,5455,5455,5455,5455,5455,5455,5455,5456,2021-05-22 15:00:00+00:00,Talbot,58.0,19042,73.0,16849,12.0,2550,70.0,85.0,19399,21592,35891
5456,5456,5456,5456,5456,5456,5456,5456,5457,2021-05-23 15:00:00+00:00,Talbot,29.0,19071,48.0,16897,1.0,2551,30.0,49.0,19448,21622,35968
5457,5457,5457,5457,5457,5457,5457,5457,5458,2021-05-24 15:00:00+00:00,Talbot,56.0,19127,23.0,16920,6.0,2557,62.0,29.0,19477,21684,36047
5458,5458,5458,5458,5458,5458,5458,5458,5459,2021-05-25 15:00:00+00:00,Talbot,36.0,19163,54.0,16974,3.0,2560,39.0,57.0,19534,21723,36137
5459,5459,5459,5459,5459,5459,5459,5459,5460,2021-05-26 15:00:00+00:00,Talbot,49.0,19212,78.0,17052,5.0,2565,54.0,83.0,19617,21777,36264
5460,5460,5460,5460,5460,5460,5460,5460,5461,2021-05-27 15:00:00+00:00,Talbot,41.0,19253,36.0,17088,2.0,2567,43.0,38.0,19655,21820,36341
5461,5461,5461,5461,5461,5461,5461,5461,5462,2021-05-28 15:00:00+00:00,Talbot,37.0,19290,61.0,17149,9.0,2576,46.0,70.0,19725,21866,36439
5462,5462,5462,5462,5462,5462,5462,5462,5463,2021-05-29 15:00:00+00:00,Talbot,24.0,19314,17.0,17166,6.0,2582,30.0,23.0,19748,21896,36480
5463,5463,5463,5463,5463,5463,5463,5463,5464,2021-05-30 15:00:00+00:00,Talbot,12.0,19326,6.0,17172,1.0,2583,13.0,7.0,19755,21909,36498
5464,5464,5464,5464,5464,5464,5464,5464,5465,2021-05-31 15:00:00+00:00,Talbot,4.0,19330,8.0,17180,,2583,,,19763,21913,36510
5465,5465,5465,5465,5465,5465,5465,5465,5466,2021-06-01 15:00:00+00:00,Talbot,35.0,19365,95.0,17275,28.0,2611,63.0,123.0,19886,21976,36640
5466,5466,5466,5466,5466,5466,5466,5466,5467,2021-06-02 15:00:00+00:00,Talbot,27.0,19392,42.0,17317,6.0,2617,33.0,48.0,19934,22009,36709
5467,5467,5467,5467,5467,5467,5467,5467,5468,2021-06-03 15:00:00+00:00,Talbot,43.0,19435,91.0,17408,5.0,2622,48.0,96.0,20030,22057,36843
5468,5468,5468,5468,5468,5468,5468,5468,5469,2021-06-04 15:00:00+00:00,Talbot,48.0,19483,77.0,17485,20.0,2642,68.0,97.0,20127,22125,36968
5469,5469,5469,5469,5469,5469,5469,5469,5470,2021-06-05 15:00:00+00:00,Talbot,9.0,19492,40.0,17525,4.0,2646,13.0,44.0,20171,22138,37017
5470,5470,5470,5470,5470,5470,5470,5470,5471,2021-06-06 15:00:00+00:00,Talbot,5.0,19497,23.0,17548,2.0,2648,7.0,25.0,20196,22145,37045
5471,5471,5471,5471,5471,5471,5471,5471,5472,2021-06-07 15:00:00+00:00,Talbot,20.0,19517,35.0,17583,1.0,2649,21.0,36.0,20232,22166,37100
5472,5472,5472,5472,5472,5472,5472,5472,5473,2021-06-08 15:00:00+00:00,Talbot,22.0,19539,114.0,17697,3.0,2652,25.0,117.0,20349,22191,37236
5473,5473,5473,5473,5473,5473,5473,5473,5474,2021-06-09 15:00:00+00:00,Talbot,25.0,19564,64.0,17761,2.0,2654,27.0,66.0,20415,22218,37325
5474,5474,5474,5474,5474,5474,5474,5474,5475,2021-06-10 15:00:00+00:00,Talbot,17.0,19581,80.0,17841,4.0,2658,21.0,84.0,20499,22239,37422
5475,5475,5475,5475,5475,5475,5475,5475,5476,2021-06-11 15:00:00+00:00,Talbot,23.0,19604,110.0,17951,10.0,2668,33.0,120.0,20619,22272,37555
5476,5476,5476,5476,5476,5476,5476,5476,5477,2021-06-12 15:00:00+00:00,Talbot,15.0,19619,27.0,17978,10.0,2678,25.0,37.0,20656,22297,37597
5477,5477,5477,5477,5477,5477,5477,5477,5478,2021-06-13 15:00:00+00:00,Talbot,10.0,19629,20.0,17998,,2678,,,20676,22307,37627
5478,5478,5478,5478,5478,5478,5478,5478,5479,2021-06-14 15:00:00+00:00,Talbot,19.0,19648,67.0,18065,7.0,2685,26.0,74.0,20750,22333,37713
5479,5479,5479,5479,5479,5479,5479,5479,5480,2021-06-15 15:00:00+00:00,Talbot,37.0,19685,84.0,18149,5.0,2690,42.0,89.0,20839,22375,37834
5480,5480,5480,5480,5480,5480,5480,5480,5481,2021-06-16 15:00:00+00:00,Talbot,40.0,19725,66.0,18215,7.0,2697,47.0,73.0,20912,22422,37940
5481,5481,5481,5481,5481,5481,5481,5481,5482,2021-06-17 15:00:00+00:00,Talbot,13.0,19738,31.0,18246,1.0,2698,14.0,32.0,20944,22436,37984
5482,5482,5482,5482,5482,5482,5482,5482,5483,2021-06-18 15:00:00+00:00,Talbot,33.0,19771,52.0,18298,4.0,2702,37.0,56.0,21000,22473,38069
5483,5483,5483,5483,5483,5483,5483,5483,5484,2021-06-19 15:00:00+00:00,Talbot,16.0,19787,29.0,18327,2.0,2704,18.0,31.0,21031,22491,38114
5484,5484,5484,5484,5484,5484,5484,5484,5485,2021-06-20 15:00:00+00:00,Talbot,7.0,19794,14.0,18341,3.0,2707,10.0,17.0,21048,22501,38135
5485,5485,5485,5485,5485,5485,5485,5485,5486,2021-06-21 15:00:00+00:00,Talbot,18.0,19812,26.0,18367,8.0,2715,26.0,34.0,21082,22527,38179
5486,5486,5486,5486,5486,5486,5486,5486,5487,2021-06-22 15:00:00+00:00,Talbot,10.0,19822,36.0,18403,1.0,2716,11.0,37.0,21119,22538,38225
5487,5487,5487,5487,5487,5487,5487,5487,5488,2021-06-23 15:00:00+00:00,Talbot,19.0,19841,29.0,18432,5.0,2721,24.0,34.0,21153,22562,38273
5488,5488,5488,5488,5488,5488,5488,5488,5489,2021-06-24 15:00:00+00:00,Talbot,30.0,19871,64.0,18496,3.0,2724,33.0,67.0,21220,22595,38367
5489,5489,5489,5489,5489,5489,5489,5489,5490,2021-06-25 15:00:00+00:00,Talbot,21.0,19892,27.0,18523,11.0,2735,32.0,38.0,21258,22627,38415
5490,5490,5490,5490,5490,5490,5490,5490,5491,2021-06-26 15:00:00+00:00,Talbot,18.0,19910,13.0,18536,,2735,,,21271,22645,38446
5491,5491,5491,5491,5491,5491,5491,5491,5492,2021-06-27 15:00:00+00:00,Talbot,11.0,19921,8.0,18544,,2735,,,21279,22656,38465
5492,5492,5492,5492,5492,5492,5492,5492,5493,2021-06-28 15:00:00+00:00,Talbot,23.0,19944,18.0,18562,5.0,2740,28.0,23.0,21302,22684,38506
5493,5493,5493,5493,5493,5493,5493,5493,5494,2021-06-29 15:00:00+00:00,Talbot,10.0,19954,14.0,18576,2.0,2742,12.0,16.0,21318,22696,38530
5494,5494,5494,5494,5494,5494,5494,5494,5495,2021-06-30 15:00:00+00:00,Talbot,28.0,19982,22.0,18598,3.0,2745,31.0,25.0,21343,22727,38580
5495,5495,5495,5495,5495,5495,5495,5495,5496,2021-07-01 15:00:00+00:00,Talbot,19.0,20001,13.0,18611,,2745,,,21356,22746,38612
5496,5496,5496,5496,5496,5496,5496,5496,5497,2021-07-02 15:00:00+00:00,Talbot,13.0,20014,19.0,18630,7.0,2752,20.0,26.0,21382,22766,38644
5497,5497,5497,5497,5497,5497,5497,5497,5498,2021-07-03 15:00:00+00:00,Talbot,10.0,20024,6.0,18636,,2752,,,21388,22776,38660
5498,5498,5498,5498,5498,5498,5498,5498,5499,2021-07-04 15:00:00+00:00,Talbot,,20024,1.0,18637,,2752,,,21389,22776,38661
5499,5499,5499,5499,5499,5499,5499,5499,5500,2021-07-05 15:00:00+00:00,Talbot,11.0,20035,17.0,18654,,2752,,,21406,22787,38689
5500,5500,5500,5500,5500,5500,5500,5500,5501,2021-07-06 15:00:00+00:00,Talbot,12.0,20047,29.0,18683,1.0,2753,13.0,30.0,21436,22800,38730
5501,5501,5501,5501,5501,5501,5501,5501,5502,2021-07-07 15:00:00+00:00,Talbot,14.0,20061,30.0,18713,4.0,2757,18.0,34.0,21470,22818,38774
5502,5502,5502,5502,5502,5502,5502,5502,5503,2021-07-08 15:00:00+00:00,Talbot,14.0,20075,11.0,18724,,2757,,,21481,22832,38799
5503,5503,5503,5503,5503,5503,5503,5503,5504,2021-07-09 15:00:00+00:00,Talbot,26.0,20101,38.0,18762,5.0,2762,31.0,43.0,21524,22863,38863
5504,5504,5504,5504,5504,5504,5504,5504,5505,2021-07-10 15:00:00+00:00,Talbot,7.0,20108,9.0,18771,3.0,2765,10.0,12.0,21536,22873,38879
5505,5505,5505,5505,5505,5505,5505,5505,5506,2021-07-11 15:00:00+00:00,Talbot,12.0,20120,11.0,18782,2.0,2767,14.0,13.0,21549,22887,38902
5506,5506,5506,5506,5506,5506,5506,5506,5507,2021-07-12 15:00:00+00:00,Talbot,21.0,20141,22.0,18804,2.0,2769,23.0,24.0,21573,22910,38945
5507,5507,5507,5507,5507,5507,5507,5507,5508,2021-07-13 15:00:00+00:00,Talbot,18.0,20159,15.0,18819,5.0,2774,23.0,20.0,21593,22933,38978
5508,5508,5508,5508,5508,5508,5508,5508,5509,2021-07-14 15:00:00+00:00,Talbot,28.0,20187,28.0,18847,,2774,,,21621,22961,39034
5509,5509,5509,5509,5509,5509,5509,5509,5510,2021-07-15 15:00:00+00:00,Talbot,25.0,20212,18.0,18865,,2774,,,21639,22986,39077
5510,5510,5510,5510,5510,5510,5510,5510,5511,2021-07-16 15:00:00+00:00,Talbot,36.0,20248,23.0,18888,2.0,2776,38.0,25.0,21664,23024,39136
5511,5511,5511,5511,5511,5511,5511,5511,5512,2021-07-17 15:00:00+00:00,Talbot,10.0,20258,15.0,18903,,2776,,,21679,23034,39161
5512,5512,5512,5512,5512,5512,5512,5512,5513,2021-07-18 15:00:00+00:00,Talbot,11.0,20269,5.0,18908,,2776,,,21684,23045,39177
5513,5513,5513,5513,5513,5513,5513,5513,5514,2021-07-19 15:00:00+00:00,Talbot,20.0,20289,12.0,18920,3.0,2779,23.0,15.0,21699,23068,39209
5514,5514,5514,5514,5514,5514,5514,5514,5515,2021-07-20 15:00:00+00:00,Talbot,17.0,20306,20.0,18940,2.0,2781,19.0,22.0,21721,23087,39246
5515,5515,5515,5515,5515,5515,5515,5515,5516,2021-07-21 15:00:00+00:00,Talbot,37.0,20343,40.0,18980,5.0,2786,42.0,45.0,21766,23129,39323
5516,5516,5516,5516,5516,5516,5516,5516,5517,2021-07-22 15:00:00+00:00,Talbot,27.0,20370,12.0,18992,3.0,2789,30.0,15.0,21781,23159,39362
5517,5517,5517,5517,5517,5517,5517,5517,5518,2021-07-23 15:00:00+00:00,Talbot,41.0,20411,20.0,19012,11.0,2800,52.0,31.0,21812,23211,39423
5518,5518,5518,5518,5518,5518,5518,5518,5519,2021-07-24 15:00:00+00:00,Talbot,14.0,20425,13.0,19025,,2800,,,21825,23225,39450
5519,5519,5519,5519,5519,5519,5519,5519,5520,2021-07-25 15:00:00+00:00,Talbot,20.0,20445,6.0,19031,,2800,,,21831,23245,39476
5520,5520,5520,5520,5520,5520,5520,5520,5521,2021-07-26 15:00:00+00:00,Talbot,33.0,20478,7.0,19038,,2800,,,21838,23278,39516
5521,5521,5521,5521,5521,5521,5521,5521,5522,2021-07-27 15:00:00+00:00,Talbot,34.0,20512,13.0,19051,1.0,2801,35.0,14.0,21852,23313,39563
5522,5522,5522,5522,5522,5522,5522,5522,5523,2021-07-28 15:00:00+00:00,Talbot,53.0,20565,16.0,19067,11.0,2812,64.0,27.0,21879,23377,39632
5523,5523,5523,5523,5523,5523,5523,5523,5524,2021-07-29 15:00:00+00:00,Talbot,38.0,20603,21.0,19088,3.0,2815,41.0,24.0,21903,23418,39691
5524,5524,5524,5524,5524,5524,5524,5524,5525,2021-07-30 15:00:00+00:00,Talbot,61.0,20664,21.0,19109,15.0,2830,76.0,36.0,21939,23494,39773
5525,5525,5525,5525,5525,5525,5525,5525,5526,2021-07-31 15:00:00+00:00,Talbot,12.0,20676,8.0,19117,,2830,,,21947,23506,39793
5526,5526,5526,5526,5526,5526,5526,5526,5527,2021-08-01 15:00:00+00:00,Talbot,9.0,20685,10.0,19127,,2830,,,21957,23515,39812
5527,5527,5527,5527,5527,5527,5527,5527,5528,2021-08-02 15:00:00+00:00,Talbot,34.0,20719,13.0,19140,1.0,2831,35.0,14.0,21971,23550,39859
5528,5528,5528,5528,5528,5528,5528,5528,5529,2021-08-03 15:00:00+00:00,Talbot,34.0,20753,20.0,19160,2.0,2833,36.0,22.0,21993,23586,39913
5529,5529,5529,5529,5529,5529,5529,5529,5530,2021-08-04 15:00:00+00:00,Talbot,63.0,20816,24.0,19184,11.0,2844,74.0,35.0,22028,23660,40000
5530,5530,5530,5530,5530,5530,5530,5530,5531,2021-08-05 15:00:00+00:00,Talbot,44.0,20860,28.0,19212,2.0,2846,46.0,30.0,22058,23706,40072
5531,5531,5531,5531,5531,5531,5531,5531,5532,2021-08-06 15:00:00+00:00,Talbot,62.0,20922,33.0,19245,7.0,2853,69.0,40.0,22098,23775,40167
5532,5532,5532,5532,5532,5532,5532,5532,5533,2021-08-07 15:00:00+00:00,Talbot,16.0,20938,10.0,19255,,2853,,,22108,23791,40193
5533,5533,5533,5533,5533,5533,5533,5533,5534,2021-08-08 15:00:00+00:00,Talbot,14.0,20952,17.0,19272,,2853,,,22125,23805,40224
5534,5534,5534,5534,5534,5534,5534,5534,5535,2021-08-09 15:00:00+00:00,Talbot,33.0,20985,20.0,19292,4.0,2857,37.0,24.0,22149,23842,40277
5535,5535,5535,5535,5535,5535,5535,5535,5536,2021-08-10 15:00:00+00:00,Talbot,32.0,21017,9.0,19301,1.0,2858,33.0,10.0,22159,23875,40318
5536,5536,5536,5536,5536,5536,5536,5536,5537,2021-08-11 15:00:00+00:00,Talbot,64.0,21081,31.0,19332,8.0,2866,72.0,39.0,22198,23947,40413
5537,5537,5537,5537,5537,5537,5537,5537,5538,2021-08-12 15:00:00+00:00,Talbot,31.0,21112,16.0,19348,6.0,2872,37.0,22.0,22220,23984,40460
5538,5538,5538,5538,5538,5538,5538,5538,5539,2021-08-13 15:00:00+00:00,Talbot,69.0,21181,35.0,19383,,2872,,,22255,24053,40564
5539,5539,5539,5539,5539,5539,5539,5539,5540,2021-08-14 15:00:00+00:00,Talbot,28.0,21209,9.0,19392,,2872,,,22264,24081,40601
5540,5540,5540,5540,5540,5540,5540,5540,5541,2021-08-15 15:00:00+00:00,Talbot,20.0,21229,14.0,19406,,2872,,,22278,24101,40635
5541,5541,5541,5541,5541,5541,5541,5541,5542,2021-08-16 15:00:00+00:00,Talbot,31.0,21260,28.0,19434,3.0,2875,34.0,31.0,22309,24135,40694
5542,5542,5542,5542,5542,5542,5542,5542,5543,2021-08-17 15:00:00+00:00,Talbot,33.0,21293,28.0,19462,1.0,2876,34.0,29.0,22338,24169,40755
5543,5543,5543,5543,5543,5543,5543,5543,5544,2021-08-18 15:00:00+00:00,Talbot,51.0,21344,46.0,19508,8.0,2884,59.0,54.0,22392,24228,40852
5544,5544,5544,5544,5544,5544,5544,5544,5545,2021-08-19 15:00:00+00:00,Talbot,43.0,21387,23.0,19531,14.0,2898,57.0,37.0,22429,24285,40918
5545,5545,5545,5545,5545,5545,5545,5545,5546,2021-08-20 15:00:00+00:00,Talbot,53.0,21440,40.0,19571,5.0,2903,58.0,45.0,22474,24343,41011
5546,5546,5546,5546,5546,5546,5546,5546,5547,2021-08-21 15:00:00+00:00,Talbot,5.0,21445,12.0,19583,4.0,2907,9.0,16.0,22490,24352,41028
5547,5547,5547,5547,5547,5547,5547,5547,5548,2021-08-22 15:00:00+00:00,Talbot,13.0,21458,13.0,19596,1.0,2908,14.0,14.0,22504,24366,41054
5548,5548,5548,5548,5548,5548,5548,5548,5549,2021-08-23 15:00:00+00:00,Talbot,28.0,21486,19.0,19615,6.0,2914,34.0,25.0,22529,24400,41101
5549,5549,5549,5549,5549,5549,5549,5549,5550,2021-08-24 15:00:00+00:00,Talbot,14.0,21500,26.0,19641,3.0,2917,17.0,29.0,22558,24417,41141
5550,5550,5550,5550,5550,5550,5550,5550,5551,2021-08-25 15:00:00+00:00,Talbot,28.0,21528,51.0,19692,7.0,2924,35.0,58.0,22616,24452,41220
5551,5551,5551,5551,5551,5551,5551,5551,5552,2021-08-26 15:00:00+00:00,Talbot,38.0,21566,43.0,19735,4.0,2928,42.0,47.0,22663,24494,41301
5552,5552,5552,5552,5552,5552,5552,5552,5553,2021-08-27 15:00:00+00:00,Talbot,45.0,21611,80.0,19815,,2928,,,22743,24539,41426
5553,5553,5553,5553,5553,5553,5553,5553,5554,2021-08-28 15:00:00+00:00,Talbot,13.0,21624,19.0,19834,1.0,2929,14.0,20.0,22763,24553,41458
5554,5554,5554,5554,5554,5554,5554,5554,5555,2021-08-29 15:00:00+00:00,Talbot,8.0,21632,11.0,19845,,2929,,,22774,24561,41477
5555,5555,5555,5555,5555,5555,5555,5555,5556,2021-08-30 15:00:00+00:00,Talbot,19.0,21651,29.0,19874,1.0,2930,20.0,30.0,22804,24581,41525
5556,5556,5556,5556,5556,5556,5556,5556,5557,2021-08-31 15:00:00+00:00,Talbot,35.0,21686,20.0,19894,1.0,2931,36.0,21.0,22825,24617,41580
5557,5557,5557,5557,5557,5557,5557,5557,5558,2021-09-01 15:00:00+00:00,Talbot,20.0,21706,38.0,19932,3.0,2934,23.0,41.0,22866,24640,41638
5558,5558,5558,5558,5558,5558,5558,5558,5559,2021-09-02 15:00:00+00:00,Talbot,29.0,21735,24.0,19956,,2934,,,22890,24669,41691
5559,5559,5559,5559,5559,5559,5559,5559,5560,2021-09-03 15:00:00+00:00,Talbot,23.0,21758,64.0,20020,8.0,2942,31.0,72.0,22962,24700,41778
5560,5560,5560,5560,5560,5560,5560,5560,5561,2021-09-04 15:00:00+00:00,Talbot,14.0,21772,19.0,20039,,2942,,,22981,24714,41811
5561,5561,5561,5561,5561,5561,5561,5561,5562,2021-09-05 15:00:00+00:00,Talbot,9.0,21781,24.0,20063,1.0,2943,10.0,25.0,23006,24724,41844
5562,5562,5562,5562,5562,5562,5562,5562,5563,2021-09-06 15:00:00+00:00,Talbot,14.0,21795,9.0,20072,,2943,,,23015,24738,41867
5563,5563,5563,5563,5563,5563,5563,5563,5564,2021-09-07 15:00:00+00:00,Talbot,21.0,21816,27.0,20099,,2943,,,23042,24759,41915
5564,5564,5564,5564,5564,5564,5564,5564,5565,2021-09-08 15:00:00+00:00,Talbot,20.0,21836,39.0,20138,7.0,2950,27.0,46.0,23088,24786,41974
5565,5565,5565,5565,5565,5565,5565,5565,5566,2021-09-09 15:00:00+00:00,Talbot,31.0,21867,26.0,20164,3.0,2953,34.0,29.0,23117,24820,42031
5566,5566,5566,5566,5566,5566,5566,5566,5567,2021-09-10 15:00:00+00:00,Talbot,31.0,21898,54.0,20218,3.0,2956,34.0,57.0,23174,24854,42116
5567,5567,5567,5567,5567,5567,5567,5567,5568,2021-09-11 15:00:00+00:00,Talbot,17.0,21915,20.0,20238,,2956,,,23194,24871,42153
5568,5568,5568,5568,5568,5568,5568,5568,5569,2021-09-12 15:00:00+00:00,Talbot,6.0,21921,14.0,20252,,2956,,,23208,24877,42173
5569,5569,5569,5569,5569,5569,5569,5569,5570,2021-09-13 15:00:00+00:00,Talbot,21.0,21942,22.0,20274,,2956,,,23230,24898,42216
5570,5570,5570,5570,5570,5570,5570,5570,5571,2021-09-14 15:00:00+00:00,Talbot,8.0,21950,22.0,20296,5.0,2961,13.0,27.0,23257,24911,42246
5571,5571,5571,5571,5571,5571,5571,5571,5572,2021-09-15 15:00:00+00:00,Talbot,32.0,21982,39.0,20335,4.0,2965,36.0,43.0,23300,24947,42317
5572,5572,5572,5572,5572,5572,5572,5572,5573,2021-09-16 15:00:00+00:00,Talbot,8.0,21990,28.0,20363,,2965,,,23328,24955,42353
5573,5573,5573,5573,5573,5573,5573,5573,5574,2021-09-17 15:00:00+00:00,Talbot,38.0,22028,36.0,20399,4.0,2969,42.0,40.0,23368,24997,42427
5574,5574,5574,5574,5574,5574,5574,5574,5575,2021-09-18 15:00:00+00:00,Talbot,10.0,22038,14.0,20413,,2969,,,23382,25007,42451
5575,5575,5575,5575,5575,5575,5575,5575,5576,2021-09-19 15:00:00+00:00,Talbot,11.0,22049,13.0,20426,,2969,,,23395,25018,42475
5576,5576,5576,5576,5576,5576,5576,5576,5577,2021-09-20 15:00:00+00:00,Talbot,11.0,22060,21.0,20447,2.0,2971,13.0,23.0,23418,25031,42507
5577,5577,5577,5577,5577,5577,5577,5577,5578,2021-09-21 15:00:00+00:00,Talbot,15.0,22075,24.0,20471,,2971,,,23442,25046,42546
5578,5578,5578,5578,5578,5578,5578,5578,5579,2021-09-22 15:00:00+00:00,Talbot,17.0,22092,29.0,20500,3.0,2974,20.0,32.0,23474,25066,42592
5579,5579,5579,5579,5579,5579,5579,5579,5580,2021-09-23 15:00:00+00:00,Talbot,17.0,22109,18.0,20518,1.0,2975,18.0,19.0,23493,25084,42627
5580,5580,5580,5580,5580,5580,5580,5580,5581,2021-09-24 15:00:00+00:00,Talbot,24.0,22133,34.0,20552,2.0,2977,26.0,36.0,23529,25110,42685
5581,5581,5581,5581,5581,5581,5581,5581,5582,2021-09-25 15:00:00+00:00,Talbot,17.0,22150,8.0,20560,,2977,,,23537,25127,42710
5582,5582,5582,5582,5582,5582,5582,5582,5583,2021-09-26 15:00:00+00:00,Talbot,7.0,22157,4.0,20564,,2977,,,23541,25134,42721
5583,5583,5583,5583,5583,5583,5583,5583,5584,2021-09-27 15:00:00+00:00,Talbot,21.0,22178,6.0,20570,,2977,,,23547,25155,42748
5584,5584,5584,5584,5584,5584,5584,5584,5585,2021-02-21 15:00:00+00:00,Garrett,3.0,4835,,2084,,0,,,2084,4835,6919
5585,5585,5585,5585,5585,5585,5585,5585,5586,2021-02-22 15:00:00+00:00,Garrett,2.0,4837,7.0,2091,,0,,,2091,4837,6928
5586,5586,5586,5586,5586,5586,5586,5586,5587,2021-02-23 15:00:00+00:00,Garrett,12.0,4849,25.0,2116,,0,,,2116,4849,6965
5587,5587,5587,5587,5587,5587,5587,5587,5588,2021-02-24 15:00:00+00:00,Garrett,233.0,5082,54.0,2170,,0,,,2170,5082,7252
5588,5588,5588,5588,5588,5588,5588,5588,5589,2021-02-25 15:00:00+00:00,Garrett,26.0,5108,119.0,2289,,0,,,2289,5108,7397
5589,5589,5589,5589,5589,5589,5589,5589,5590,2021-02-26 15:00:00+00:00,Garrett,78.0,5186,412.0,2701,,0,,,2701,5186,7887
5590,5590,5590,5590,5590,5590,5590,5590,5591,2021-02-27 15:00:00+00:00,Garrett,13.0,5199,101.0,2802,,0,,,2802,5199,8001
5591,5591,5591,5591,5591,5591,5591,5591,5592,2021-02-28 15:00:00+00:00,Garrett,14.0,5213,3.0,2805,,0,,,2805,5213,8018
5592,5592,5592,5592,5592,5592,5592,5592,5593,2021-03-01 15:00:00+00:00,Garrett,85.0,5298,49.0,2854,,0,,,2854,5298,8152
5593,5593,5593,5593,5593,5593,5593,5593,5594,2021-03-02 15:00:00+00:00,Garrett,29.0,5327,48.0,2902,,0,,,2902,5327,8229
5594,5594,5594,5594,5594,5594,5594,5594,5595,2021-03-03 15:00:00+00:00,Garrett,28.0,5355,336.0,3238,,0,,,3238,5355,8593
5595,5595,5595,5595,5595,5595,5595,5595,5596,2021-03-04 15:00:00+00:00,Garrett,58.0,5413,32.0,3270,,0,,,3270,5413,8683
5596,5596,5596,5596,5596,5596,5596,5596,5597,2021-03-05 15:00:00+00:00,Garrett,157.0,5570,227.0,3497,16.0,16,173.0,243.0,3513,5586,9067
5597,5597,5597,5597,5597,5597,5597,5597,5598,2021-03-06 15:00:00+00:00,Garrett,86.0,5656,10.0,3507,2.0,18,88.0,12.0,3525,5674,9163
5598,5598,5598,5598,5598,5598,5598,5598,5599,2021-03-07 15:00:00+00:00,Garrett,9.0,5665,13.0,3520,,18,,,3538,5683,9185
5599,5599,5599,5599,5599,5599,5599,5599,5600,2021-03-08 15:00:00+00:00,Garrett,279.0,5944,87.0,3607,,18,,,3625,5962,9551
5600,5600,5600,5600,5600,5600,5600,5600,5601,2021-03-09 15:00:00+00:00,Garrett,38.0,5982,119.0,3726,14.0,32,52.0,133.0,3758,6014,9708
5601,5601,5601,5601,5601,5601,5601,5601,5602,2021-03-10 15:00:00+00:00,Garrett,44.0,6026,132.0,3858,1.0,33,45.0,133.0,3891,6059,9884
5602,5602,5602,5602,5602,5602,5602,5602,5603,2021-03-11 15:00:00+00:00,Garrett,41.0,6067,67.0,3925,,33,,,3958,6100,9992
5603,5603,5603,5603,5603,5603,5603,5603,5604,2021-03-12 15:00:00+00:00,Garrett,161.0,6228,341.0,4266,12.0,45,173.0,353.0,4311,6273,10494
5604,5604,5604,5604,5604,5604,5604,5604,5605,2021-03-13 15:00:00+00:00,Garrett,18.0,6246,12.0,4278,,45,,,4323,6291,10524
5605,5605,5605,5605,5605,5605,5605,5605,5606,2021-03-14 15:00:00+00:00,Garrett,10.0,6256,1.0,4279,,45,,,4324,6301,10535
5606,5606,5606,5606,5606,5606,5606,5606,5607,2021-03-15 15:00:00+00:00,Garrett,56.0,6312,20.0,4299,,45,,,4344,6357,10611
5607,5607,5607,5607,5607,5607,5607,5607,5608,2021-03-16 15:00:00+00:00,Garrett,107.0,6419,43.0,4342,61.0,106,168.0,104.0,4448,6525,10761
5608,5608,5608,5608,5608,5608,5608,5608,5609,2021-03-17 15:00:00+00:00,Garrett,43.0,6462,9.0,4351,,106,,,4457,6568,10813
5609,5609,5609,5609,5609,5609,5609,5609,5610,2021-03-18 15:00:00+00:00,Garrett,53.0,6515,19.0,4370,1.0,107,54.0,20.0,4477,6622,10885
5610,5610,5610,5610,5610,5610,5610,5610,5611,2021-03-19 15:00:00+00:00,Garrett,151.0,6666,239.0,4609,30.0,137,181.0,269.0,4746,6803,11275
5611,5611,5611,5611,5611,5611,5611,5611,5612,2021-03-20 15:00:00+00:00,Garrett,17.0,6683,3.0,4612,,137,,,4749,6820,11295
5612,5612,5612,5612,5612,5612,5612,5612,5613,2021-03-21 15:00:00+00:00,Garrett,32.0,6715,2.0,4614,,137,,,4751,6852,11329
5613,5613,5613,5613,5613,5613,5613,5613,5614,2021-03-22 15:00:00+00:00,Garrett,55.0,6770,16.0,4630,,137,,,4767,6907,11400
5614,5614,5614,5614,5614,5614,5614,5614,5615,2021-03-23 15:00:00+00:00,Garrett,47.0,6817,35.0,4665,10.0,147,57.0,45.0,4812,6964,11482
5615,5615,5615,5615,5615,5615,5615,5615,5616,2021-03-24 15:00:00+00:00,Garrett,128.0,6945,191.0,4856,7.0,154,135.0,198.0,5010,7099,11801
5616,5616,5616,5616,5616,5616,5616,5616,5617,2021-03-25 15:00:00+00:00,Garrett,63.0,7008,21.0,4877,3.0,157,66.0,24.0,5034,7165,11885
5617,5617,5617,5617,5617,5617,5617,5617,5618,2021-03-26 15:00:00+00:00,Garrett,258.0,7266,101.0,4978,5.0,162,263.0,106.0,5140,7428,12244
5618,5618,5618,5618,5618,5618,5618,5618,5619,2021-03-27 15:00:00+00:00,Garrett,8.0,7274,8.0,4986,3.0,165,11.0,11.0,5151,7439,12260
5619,5619,5619,5619,5619,5619,5619,5619,5620,2021-03-28 15:00:00+00:00,Garrett,31.0,7305,10.0,4996,1.0,166,32.0,11.0,5162,7471,12301
5620,5620,5620,5620,5620,5620,5620,5620,5621,2021-03-29 15:00:00+00:00,Garrett,76.0,7381,21.0,5017,,166,,,5183,7547,12398
5621,5621,5621,5621,5621,5621,5621,5621,5622,2021-03-30 15:00:00+00:00,Garrett,159.0,7540,45.0,5062,1.0,167,160.0,46.0,5229,7707,12602
5622,5622,5622,5622,5622,5622,5622,5622,5623,2021-03-31 15:00:00+00:00,Garrett,125.0,7665,81.0,5143,2.0,169,127.0,83.0,5312,7834,12808
5623,5623,5623,5623,5623,5623,5623,5623,5624,2021-04-01 15:00:00+00:00,Garrett,167.0,7832,62.0,5205,144.0,313,311.0,206.0,5518,8145,13037
5624,5624,5624,5624,5624,5624,5624,5624,5625,2021-04-02 15:00:00+00:00,Garrett,121.0,7953,23.0,5228,47.0,360,168.0,70.0,5588,8313,13181
5625,5625,5625,5625,5625,5625,5625,5625,5626,2021-04-03 15:00:00+00:00,Garrett,33.0,7986,72.0,5300,2.0,362,35.0,74.0,5662,8348,13286
5626,5626,5626,5626,5626,5626,5626,5626,5627,2021-04-04 15:00:00+00:00,Garrett,33.0,8019,9.0,5309,,362,,,5671,8381,13328
5627,5627,5627,5627,5627,5627,5627,5627,5628,2021-04-05 15:00:00+00:00,Garrett,58.0,8077,28.0,5337,17.0,379,75.0,45.0,5716,8456,13414
5628,5628,5628,5628,5628,5628,5628,5628,5629,2021-04-06 15:00:00+00:00,Garrett,57.0,8134,46.0,5383,36.0,415,93.0,82.0,5798,8549,13517
5629,5629,5629,5629,5629,5629,5629,5629,5630,2021-04-07 15:00:00+00:00,Garrett,69.0,8203,260.0,5643,5.0,420,74.0,265.0,6063,8623,13846
5630,5630,5630,5630,5630,5630,5630,5630,5631,2021-04-08 15:00:00+00:00,Garrett,58.0,8261,287.0,5930,7.0,427,65.0,294.0,6357,8688,14191
5631,5631,5631,5631,5631,5631,5631,5631,5632,2021-04-09 15:00:00+00:00,Garrett,55.0,8316,19.0,5949,72.0,499,127.0,91.0,6448,8815,14265
5632,5632,5632,5632,5632,5632,5632,5632,5633,2021-04-10 15:00:00+00:00,Garrett,18.0,8334,16.0,5965,6.0,505,24.0,22.0,6470,8839,14299
5633,5633,5633,5633,5633,5633,5633,5633,5634,2021-04-11 15:00:00+00:00,Garrett,8.0,8342,13.0,5978,13.0,518,21.0,26.0,6496,8860,14320
5634,5634,5634,5634,5634,5634,5634,5634,5635,2021-04-12 15:00:00+00:00,Garrett,27.0,8369,38.0,6016,4.0,522,31.0,42.0,6538,8891,14385
5635,5635,5635,5635,5635,5635,5635,5635,5636,2021-04-13 15:00:00+00:00,Garrett,219.0,8588,132.0,6148,,522,,,6670,9110,14736
5636,5636,5636,5636,5636,5636,5636,5636,5637,2021-04-14 15:00:00+00:00,Garrett,62.0,8650,34.0,6182,,522,,,6704,9172,14832
5637,5637,5637,5637,5637,5637,5637,5637,5638,2021-04-15 15:00:00+00:00,Garrett,222.0,8872,103.0,6285,,522,,,6807,9394,15157
5638,5638,5638,5638,5638,5638,5638,5638,5639,2021-04-16 15:00:00+00:00,Garrett,30.0,8902,54.0,6339,,522,,,6861,9424,15241
5639,5639,5639,5639,5639,5639,5639,5639,5640,2021-04-17 15:00:00+00:00,Garrett,12.0,8914,6.0,6345,,522,,,6867,9436,15259
5640,5640,5640,5640,5640,5640,5640,5640,5641,2021-03-14 15:00:00+00:00,Kent,39.0,5485,4.0,4160,2.0,48,41.0,6.0,4208,5533,9645
5641,5641,5641,5641,5641,5641,5641,5641,5642,2021-03-15 15:00:00+00:00,Kent,65.0,5550,15.0,4175,53.0,101,118.0,68.0,4276,5651,9725
5642,5642,5642,5642,5642,5642,5642,5642,5643,2021-03-16 15:00:00+00:00,Kent,76.0,5626,7.0,4182,,101,,,4283,5727,9808
5643,5643,5643,5643,5643,5643,5643,5643,5644,2021-03-17 15:00:00+00:00,Kent,475.0,6101,24.0,4206,2.0,103,477.0,26.0,4309,6204,10307
5644,5644,5644,5644,5644,5644,5644,5644,5645,2021-03-18 15:00:00+00:00,Kent,95.0,6196,234.0,4440,1.0,104,96.0,235.0,4544,6300,10636
5645,5645,5645,5645,5645,5645,5645,5645,5646,2021-03-19 15:00:00+00:00,Kent,57.0,6253,8.0,4448,7.0,111,64.0,15.0,4559,6364,10701
5646,5646,5646,5646,5646,5646,5646,5646,5647,2021-03-20 15:00:00+00:00,Kent,36.0,6289,7.0,4455,2.0,113,38.0,9.0,4568,6402,10744
5647,5647,5647,5647,5647,5647,5647,5647,5648,2021-03-21 15:00:00+00:00,Kent,60.0,6349,13.0,4468,,113,,,4581,6462,10817
5648,5648,5648,5648,5648,5648,5648,5648,5649,2021-03-22 15:00:00+00:00,Kent,67.0,6416,11.0,4479,,113,,,4592,6529,10895
5649,5649,5649,5649,5649,5649,5649,5649,5650,2021-03-23 15:00:00+00:00,Kent,97.0,6513,21.0,4500,3.0,116,100.0,24.0,4616,6629,11013
5650,5650,5650,5650,5650,5650,5650,5650,5651,2021-03-24 15:00:00+00:00,Kent,435.0,6948,52.0,4552,,116,,,4668,7064,11500
5651,5651,5651,5651,5651,5651,5651,5651,5652,2021-03-25 15:00:00+00:00,Kent,81.0,7029,75.0,4627,,116,,,4743,7145,11656
5652,5652,5652,5652,5652,5652,5652,5652,5653,2021-03-26 15:00:00+00:00,Kent,63.0,7092,23.0,4650,,116,,,4766,7208,11742
5653,5653,5653,5653,5653,5653,5653,5653,5654,2021-03-27 15:00:00+00:00,Kent,13.0,7105,17.0,4667,9.0,125,22.0,26.0,4792,7230,11772
5654,5654,5654,5654,5654,5654,5654,5654,5655,2021-03-28 15:00:00+00:00,Kent,25.0,7130,37.0,4704,,125,,,4829,7255,11834
5655,5655,5655,5655,5655,5655,5655,5655,5656,2021-03-29 15:00:00+00:00,Kent,295.0,7425,35.0,4739,7.0,132,302.0,42.0,4871,7557,12164
5656,5656,5656,5656,5656,5656,5656,5656,5657,2021-03-30 15:00:00+00:00,Kent,62.0,7487,54.0,4793,23.0,155,85.0,77.0,4948,7642,12280
5657,5657,5657,5657,5657,5657,5657,5657,5658,2021-03-31 15:00:00+00:00,Kent,172.0,7659,68.0,4861,18.0,173,190.0,86.0,5034,7832,12520
5658,5658,5658,5658,5658,5658,5658,5658,5659,2021-04-01 15:00:00+00:00,Kent,46.0,7705,48.0,4909,20.0,193,66.0,68.0,5102,7898,12614
5659,5659,5659,5659,5659,5659,5659,5659,5660,2021-04-02 15:00:00+00:00,Kent,44.0,7749,34.0,4943,25.0,218,69.0,59.0,5161,7967,12692
5660,5660,5660,5660,5660,5660,5660,5660,5661,2021-04-03 15:00:00+00:00,Kent,27.0,7776,20.0,4963,20.0,238,47.0,40.0,5201,8014,12739
5661,5661,5661,5661,5661,5661,5661,5661,5662,2021-04-04 15:00:00+00:00,Kent,35.0,7811,30.0,4993,,238,,,5231,8049,12804
5662,5662,5662,5662,5662,5662,5662,5662,5663,2021-04-05 15:00:00+00:00,Kent,34.0,7845,40.0,5033,23.0,261,57.0,63.0,5294,8106,12878
5663,5663,5663,5663,5663,5663,5663,5663,5664,2021-04-06 15:00:00+00:00,Kent,45.0,7890,105.0,5138,20.0,281,65.0,125.0,5419,8171,13028
5664,5664,5664,5664,5664,5664,5664,5664,5665,2021-04-07 15:00:00+00:00,Kent,315.0,8205,72.0,5210,21.0,302,336.0,93.0,5512,8507,13415
5665,5665,5665,5665,5665,5665,5665,5665,5666,2021-04-08 15:00:00+00:00,Kent,49.0,8254,51.0,5261,236.0,538,285.0,287.0,5799,8792,13515
5666,5666,5666,5666,5666,5666,5666,5666,5667,2021-04-09 15:00:00+00:00,Kent,66.0,8320,35.0,5296,18.0,556,84.0,53.0,5852,8876,13616
5667,5667,5667,5667,5667,5667,5667,5667,5668,2021-04-10 15:00:00+00:00,Kent,19.0,8339,51.0,5347,21.0,577,40.0,72.0,5924,8916,13686
5668,5668,5668,5668,5668,5668,5668,5668,5669,2021-03-03 15:00:00+00:00,Somerset,100.0,3540,121.0,2394,,0,,,2394,3540,5934
5669,5669,5669,5669,5669,5669,5669,5669,5670,2021-03-04 15:00:00+00:00,Somerset,124.0,3664,46.0,2440,,0,,,2440,3664,6104
5670,5670,5670,5670,5670,5670,5670,5670,5671,2021-03-05 15:00:00+00:00,Somerset,124.0,3788,105.0,2545,17.0,17,141.0,122.0,2562,3805,6333
5671,5671,5671,5671,5671,5671,5671,5671,5672,2021-03-06 15:00:00+00:00,Somerset,2.0,3790,9.0,2554,,17,,,2571,3807,6344
5672,5672,5672,5672,5672,5672,5672,5672,5673,2021-03-07 15:00:00+00:00,Somerset,1.0,3791,1.0,2555,1.0,18,2.0,2.0,2573,3809,6346
5673,5673,5673,5673,5673,5673,5673,5673,5674,2021-03-08 15:00:00+00:00,Somerset,110.0,3901,41.0,2596,1.0,19,111.0,42.0,2615,3920,6497
5674,5674,5674,5674,5674,5674,5674,5674,5675,2021-03-09 15:00:00+00:00,Somerset,34.0,3935,44.0,2640,1.0,20,35.0,45.0,2660,3955,6575
5675,5675,5675,5675,5675,5675,5675,5675,5676,2021-03-10 15:00:00+00:00,Somerset,63.0,3998,127.0,2767,1.0,21,64.0,128.0,2788,4019,6765
5676,5676,5676,5676,5676,5676,5676,5676,5677,2021-03-11 15:00:00+00:00,Somerset,111.0,4109,19.0,2786,,21,,,2807,4130,6895
5677,5677,5677,5677,5677,5677,5677,5677,5678,2021-03-12 15:00:00+00:00,Somerset,143.0,4252,34.0,2820,1.0,22,144.0,35.0,2842,4274,7072
5678,5678,5678,5678,5678,5678,5678,5678,5679,2021-03-13 15:00:00+00:00,Somerset,2.0,4254,22.0,2842,2.0,24,4.0,24.0,2866,4278,7096
5679,5679,5679,5679,5679,5679,5679,5679,5680,2021-03-14 15:00:00+00:00,Somerset,,4254,,2842,49.0,73,,,2915,4327,7096
5680,5680,5680,5680,5680,5680,5680,5680,5681,2021-03-15 15:00:00+00:00,Somerset,20.0,4274,5.0,2847,,73,,,2920,4347,7121
5681,5681,5681,5681,5681,5681,5681,5681,5682,2021-03-16 15:00:00+00:00,Somerset,38.0,4312,11.0,2858,,73,,,2931,4385,7170
5682,5682,5682,5682,5682,5682,5682,5682,5683,2021-03-17 15:00:00+00:00,Somerset,97.0,4409,30.0,2888,1.0,74,98.0,31.0,2962,4483,7297
5683,5683,5683,5683,5683,5683,5683,5683,5684,2021-03-18 15:00:00+00:00,Somerset,111.0,4520,9.0,2897,2.0,76,113.0,11.0,2973,4596,7417
5684,5684,5684,5684,5684,5684,5684,5684,5685,2021-03-19 15:00:00+00:00,Somerset,119.0,4639,94.0,2991,5.0,81,124.0,99.0,3072,4720,7630
5685,5685,5685,5685,5685,5685,5685,5685,5686,2021-03-20 15:00:00+00:00,Somerset,22.0,4661,,2991,1.0,82,23.0,,3073,4743,7652
5686,5686,5686,5686,5686,5686,5686,5686,5687,2021-03-21 15:00:00+00:00,Somerset,22.0,4683,2.0,2993,,82,,,3075,4765,7676
5687,5687,5687,5687,5687,5687,5687,5687,5688,2021-03-22 15:00:00+00:00,Somerset,43.0,4726,11.0,3004,22.0,104,65.0,33.0,3108,4830,7730
5688,5688,5688,5688,5688,5688,5688,5688,5689,2021-03-23 15:00:00+00:00,Somerset,116.0,4842,13.0,3017,21.0,125,137.0,34.0,3142,4967,7859
5689,5689,5689,5689,5689,5689,5689,5689,5690,2021-03-24 15:00:00+00:00,Somerset,132.0,4974,139.0,3156,2.0,127,134.0,141.0,3283,5101,8130
5690,5690,5690,5690,5690,5690,5690,5690,5691,2021-03-25 15:00:00+00:00,Somerset,117.0,5091,16.0,3172,3.0,130,120.0,19.0,3302,5221,8263
5691,5691,5691,5691,5691,5691,5691,5691,5692,2021-03-26 15:00:00+00:00,Somerset,88.0,5179,136.0,3308,29.0,159,117.0,165.0,3467,5338,8487
5692,5692,5692,5692,5692,5692,5692,5692,5693,2021-03-27 15:00:00+00:00,Somerset,17.0,5196,10.0,3318,,159,,,3477,5355,8514
5693,5693,5693,5693,5693,5693,5693,5693,5694,2021-03-28 15:00:00+00:00,Somerset,3.0,5199,1.0,3319,,159,,,3478,5358,8518
5694,5694,5694,5694,5694,5694,5694,5694,5695,2021-03-29 15:00:00+00:00,Somerset,192.0,5391,23.0,3342,6.0,165,198.0,29.0,3507,5556,8733
5695,5695,5695,5695,5695,5695,5695,5695,5696,2021-03-30 15:00:00+00:00,Somerset,135.0,5526,50.0,3392,78.0,243,213.0,128.0,3635,5769,8918
5696,5696,5696,5696,5696,5696,5696,5696,5697,2021-04-11 15:00:00+00:00,Kent,87.0,8426,17.0,5364,4.0,581,91.0,21.0,5945,9007,13790
5697,5697,5697,5697,5697,5697,5697,5697,5698,2021-04-12 15:00:00+00:00,Kent,63.0,8489,81.0,5445,22.0,603,85.0,103.0,6048,9092,13934
5698,5698,5698,5698,5698,5698,5698,5698,5699,2021-04-13 15:00:00+00:00,Kent,39.0,8528,83.0,5528,,603,,,6131,9131,14056
5699,5699,5699,5699,5699,5699,5699,5699,5700,2021-04-14 15:00:00+00:00,Kent,62.0,8590,98.0,5626,,603,,,6229,9193,14216
5700,5700,5700,5700,5700,5700,5700,5700,5701,2021-04-15 15:00:00+00:00,Kent,64.0,8654,434.0,6060,,603,,,6663,9257,14714
5701,5701,5701,5701,5701,5701,5701,5701,5702,2021-04-16 15:00:00+00:00,Kent,115.0,8769,93.0,6153,,603,,,6756,9372,14922
5702,5702,5702,5702,5702,5702,5702,5702,5703,2021-04-17 15:00:00+00:00,Kent,9.0,8778,19.0,6172,,603,,,6775,9381,14950
5703,5703,5703,5703,5703,5703,5703,5703,5704,2021-04-18 15:00:00+00:00,Kent,10.0,8788,14.0,6186,,603,,,6789,9391,14974
5704,5704,5704,5704,5704,5704,5704,5704,5705,2021-04-19 15:00:00+00:00,Kent,52.0,8840,76.0,6262,,603,,,6865,9443,15102
5705,5705,5705,5705,5705,5705,5705,5705,5706,2021-04-20 15:00:00+00:00,Kent,117.0,8957,93.0,6355,,603,,,6958,9560,15312
5706,5706,5706,5706,5706,5706,5706,5706,5707,2021-04-21 15:00:00+00:00,Kent,259.0,9216,90.0,6445,,603,,,7048,9819,15661
5707,5707,5707,5707,5707,5707,5707,5707,5708,2021-04-22 15:00:00+00:00,Kent,55.0,9271,430.0,6875,,603,,,7478,9874,16146
5708,5708,5708,5708,5708,5708,5708,5708,5709,2021-04-23 15:00:00+00:00,Kent,51.0,9322,59.0,6934,,603,,,7537,9925,16256
5709,5709,5709,5709,5709,5709,5709,5709,5710,2021-04-24 15:00:00+00:00,Kent,45.0,9367,33.0,6967,,603,,,7570,9970,16334
5710,5710,5710,5710,5710,5710,5710,5710,5711,2021-04-25 15:00:00+00:00,Kent,9.0,9376,4.0,6971,,603,,,7574,9979,16347
5711,5711,5711,5711,5711,5711,5711,5711,5712,2021-04-26 15:00:00+00:00,Kent,41.0,9417,45.0,7016,,603,,,7619,10020,16433
5712,5712,5712,5712,5712,5712,5712,5712,5713,2021-04-27 15:00:00+00:00,Kent,32.0,9449,255.0,7271,1.0,604,33.0,256.0,7875,10053,16720
5713,5713,5713,5713,5713,5713,5713,5713,5714,2021-04-28 15:00:00+00:00,Kent,98.0,9547,97.0,7368,15.0,619,113.0,112.0,7987,10166,16915
5714,5714,5714,5714,5714,5714,5714,5714,5715,2021-04-29 15:00:00+00:00,Kent,32.0,9579,136.0,7504,2.0,621,34.0,138.0,8125,10200,17083
5715,5715,5715,5715,5715,5715,5715,5715,5716,2021-04-30 15:00:00+00:00,Kent,47.0,9626,53.0,7557,4.0,625,51.0,57.0,8182,10251,17183
5716,5716,5716,5716,5716,5716,5716,5716,5717,2021-05-01 15:00:00+00:00,Kent,10.0,9636,39.0,7596,,625,,,8221,10261,17232
5717,5717,5717,5717,5717,5717,5717,5717,5718,2021-05-02 15:00:00+00:00,Kent,3.0,9639,79.0,7675,,625,,,8300,10264,17314
5718,5718,5718,5718,5718,5718,5718,5718,5719,2021-05-03 15:00:00+00:00,Kent,7.0,9646,41.0,7716,1.0,626,8.0,42.0,8342,10272,17362
5719,5719,5719,5719,5719,5719,5719,5719,5720,2021-05-04 15:00:00+00:00,Kent,45.0,9691,45.0,7761,3.0,629,48.0,48.0,8390,10320,17452
5720,5720,5720,5720,5720,5720,5720,5720,5721,2021-05-05 15:00:00+00:00,Kent,42.0,9733,52.0,7813,24.0,653,66.0,76.0,8466,10386,17546
5721,5721,5721,5721,5721,5721,5721,5721,5722,2021-05-06 15:00:00+00:00,Kent,45.0,9778,342.0,8155,8.0,661,53.0,350.0,8816,10439,17933
5722,5722,5722,5722,5722,5722,5722,5722,5723,2021-05-07 15:00:00+00:00,Kent,12.0,9790,68.0,8223,1.0,662,13.0,69.0,8885,10452,18013
5723,5723,5723,5723,5723,5723,5723,5723,5724,2021-05-08 15:00:00+00:00,Kent,4.0,9794,9.0,8232,,662,,,8894,10456,18026
5724,5724,5724,5724,5724,5724,5724,5724,5725,2021-03-31 15:00:00+00:00,Somerset,178.0,5704,119.0,3511,12.0,255,190.0,131.0,3766,5959,9215
5725,5725,5725,5725,5725,5725,5725,5725,5726,2021-04-01 15:00:00+00:00,Somerset,219.0,5923,132.0,3643,9.0,264,228.0,141.0,3907,6187,9566
5726,5726,5726,5726,5726,5726,5726,5726,5727,2021-04-02 15:00:00+00:00,Somerset,56.0,5979,58.0,3701,41.0,305,97.0,99.0,4006,6284,9680
5727,5727,5727,5727,5727,5727,5727,5727,5728,2021-04-03 15:00:00+00:00,Somerset,27.0,6006,1.0,3702,26.0,331,53.0,27.0,4033,6337,9708
5728,5728,5728,5728,5728,5728,5728,5728,5729,2021-04-04 15:00:00+00:00,Somerset,3.0,6009,,3702,,331,,,4033,6340,9711
5729,5729,5729,5729,5729,5729,5729,5729,5730,2021-04-05 15:00:00+00:00,Somerset,60.0,6069,151.0,3853,15.0,346,75.0,166.0,4199,6415,9922
5730,5730,5730,5730,5730,5730,5730,5730,5731,2021-04-06 15:00:00+00:00,Somerset,90.0,6159,34.0,3887,67.0,413,157.0,101.0,4300,6572,10046
5731,5731,5731,5731,5731,5731,5731,5731,5732,2021-04-07 15:00:00+00:00,Somerset,207.0,6366,73.0,3960,33.0,446,240.0,106.0,4406,6812,10326
5732,5732,5732,5732,5732,5732,5732,5732,5733,2021-04-08 15:00:00+00:00,Somerset,79.0,6445,40.0,4000,66.0,512,145.0,106.0,4512,6957,10445
5733,5733,5733,5733,5733,5733,5733,5733,5734,2021-04-09 15:00:00+00:00,Somerset,32.0,6477,190.0,4190,63.0,575,95.0,253.0,4765,7052,10667
5734,5734,5734,5734,5734,5734,5734,5734,5735,2021-04-10 15:00:00+00:00,Somerset,5.0,6482,15.0,4205,15.0,590,20.0,30.0,4795,7072,10687
5735,5735,5735,5735,5735,5735,5735,5735,5736,2021-04-11 15:00:00+00:00,Somerset,5.0,6487,16.0,4221,4.0,594,9.0,20.0,4815,7081,10708
5736,5736,5736,5736,5736,5736,5736,5736,5737,2021-04-12 15:00:00+00:00,Somerset,93.0,6580,37.0,4258,16.0,610,109.0,53.0,4868,7190,10838
5737,5737,5737,5737,5737,5737,5737,5737,5738,2021-04-13 15:00:00+00:00,Somerset,37.0,6617,27.0,4285,,610,,,4895,7227,10902
5738,5738,5738,5738,5738,5738,5738,5738,5739,2021-04-14 15:00:00+00:00,Somerset,97.0,6714,131.0,4416,,610,,,5026,7324,11130
5739,5739,5739,5739,5739,5739,5739,5739,5740,2021-04-15 15:00:00+00:00,Somerset,174.0,6888,102.0,4518,,610,,,5128,7498,11406
5740,5740,5740,5740,5740,5740,5740,5740,5741,2021-04-16 15:00:00+00:00,Somerset,89.0,6977,193.0,4711,,610,,,5321,7587,11688
5741,5741,5741,5741,5741,5741,5741,5741,5742,2021-04-17 15:00:00+00:00,Somerset,11.0,6988,12.0,4723,,610,,,5333,7598,11711
5742,5742,5742,5742,5742,5742,5742,5742,5743,2021-04-18 15:00:00+00:00,Somerset,10.0,6998,7.0,4730,,610,,,5340,7608,11728
5743,5743,5743,5743,5743,5743,5743,5743,5744,2021-04-19 15:00:00+00:00,Somerset,19.0,7017,63.0,4793,,610,,,5403,7627,11810
5744,5744,5744,5744,5744,5744,5744,5744,5745,2021-04-20 15:00:00+00:00,Somerset,33.0,7050,108.0,4901,,610,,,5511,7660,11951
5745,5745,5745,5745,5745,5745,5745,5745,5746,2021-04-21 15:00:00+00:00,Somerset,87.0,7137,258.0,5159,,610,,,5769,7747,12296
5746,5746,5746,5746,5746,5746,5746,5746,5747,2021-04-22 15:00:00+00:00,Somerset,104.0,7241,70.0,5229,,610,,,5839,7851,12470
5747,5747,5747,5747,5747,5747,5747,5747,5748,2021-04-23 15:00:00+00:00,Somerset,116.0,7357,76.0,5305,,610,,,5915,7967,12662
5748,5748,5748,5748,5748,5748,5748,5748,5749,2021-04-24 15:00:00+00:00,Somerset,74.0,7431,25.0,5330,,610,,,5940,8041,12761
5749,5749,5749,5749,5749,5749,5749,5749,5750,2021-04-25 15:00:00+00:00,Somerset,64.0,7495,6.0,5336,,610,,,5946,8105,12831
5750,5750,5750,5750,5750,5750,5750,5750,5751,2021-04-26 15:00:00+00:00,Somerset,51.0,7546,207.0,5543,2.0,612,53.0,209.0,6155,8158,13089
5751,5751,5751,5751,5751,5751,5751,5751,5752,2021-04-27 15:00:00+00:00,Somerset,32.0,7578,70.0,5613,21.0,633,53.0,91.0,6246,8211,13191
5752,5752,5752,5752,5752,5752,5752,5752,5753,2021-09-28 15:00:00+00:00,Talbot,14.0,22192,15.0,20585,,2977,,,23562,25169,42777
5753,5753,5753,5753,5753,5753,5753,5753,5754,2021-09-29 15:00:00+00:00,Talbot,22.0,22214,23.0,20608,3.0,2980,25.0,26.0,23588,25194,42822
5754,5754,5754,5754,5754,5754,5754,5754,5755,2021-09-30 15:00:00+00:00,Talbot,29.0,22243,23.0,20631,1.0,2981,30.0,24.0,23612,25224,42874
5755,5755,5755,5755,5755,5755,5755,5755,5756,2021-10-01 15:00:00+00:00,Talbot,24.0,22267,30.0,20661,4.0,2985,28.0,34.0,23646,25252,42928
5756,5756,5756,5756,5756,5756,5756,5756,5757,2021-10-02 15:00:00+00:00,Talbot,9.0,22276,16.0,20677,,2985,,,23662,25261,42953
5757,5757,5757,5757,5757,5757,5757,5757,5758,2021-10-03 15:00:00+00:00,Talbot,8.0,22284,4.0,20681,,2985,,,23666,25269,42965
5758,5758,5758,5758,5758,5758,5758,5758,5759,2021-10-04 15:00:00+00:00,Talbot,21.0,22305,7.0,20688,1.0,2986,22.0,8.0,23674,25291,42993
5759,5759,5759,5759,5759,5759,5759,5759,5760,2021-10-05 15:00:00+00:00,Talbot,27.0,22332,10.0,20698,4.0,2990,31.0,14.0,23688,25322,43030
5760,5760,5760,5760,5760,5760,5760,5760,5761,2021-10-06 15:00:00+00:00,Talbot,21.0,22353,19.0,20717,10.0,3000,31.0,29.0,23717,25353,43070
5761,5761,5761,5761,5761,5761,5761,5761,5762,2021-10-07 15:00:00+00:00,Talbot,12.0,22365,8.0,20725,1.0,3001,13.0,9.0,23726,25366,43090
5762,5762,5762,5762,5762,5762,5762,5762,5763,2021-10-08 15:00:00+00:00,Talbot,18.0,22383,33.0,20758,1.0,3002,19.0,34.0,23760,25385,43141
5763,5763,5763,5763,5763,5763,5763,5763,5764,2021-10-09 15:00:00+00:00,Talbot,8.0,22391,7.0,20765,,3002,,,23767,25393,43156
5764,5764,5764,5764,5764,5764,5764,5764,5765,2021-10-10 15:00:00+00:00,Talbot,6.0,22397,10.0,20775,,3002,,,23777,25399,43172
5765,5765,5765,5765,5765,5765,5765,5765,5766,2021-10-11 15:00:00+00:00,Talbot,1.0,22398,15.0,20790,5.0,3007,6.0,20.0,23797,25405,43188
5766,5766,5766,5766,5766,5766,5766,5766,5767,2021-10-12 15:00:00+00:00,Talbot,8.0,22406,12.0,20802,,3007,,,23809,25413,43208
5767,5767,5767,5767,5767,5767,5767,5767,5768,2021-10-13 15:00:00+00:00,Talbot,10.0,22416,11.0,20813,3.0,3010,13.0,14.0,23823,25426,43229
5768,5768,5768,5768,5768,5768,5768,5768,5769,2021-10-14 15:00:00+00:00,Talbot,10.0,22426,13.0,20826,3.0,3013,13.0,16.0,23839,25439,43252
5769,5769,5769,5769,5769,5769,5769,5769,5770,2021-10-15 15:00:00+00:00,Talbot,16.0,22442,25.0,20851,7.0,3020,23.0,32.0,23871,25462,43293
5770,5770,5770,5770,5770,5770,5770,5770,5771,2021-10-16 15:00:00+00:00,Talbot,5.0,22447,10.0,20861,,3020,,,23881,25467,43308
5771,5771,5771,5771,5771,5771,5771,5771,5772,2021-10-17 15:00:00+00:00,Talbot,4.0,22451,2.0,20863,,3020,,,23883,25471,43314
5772,5772,5772,5772,5772,5772,5772,5772,5773,2021-10-18 15:00:00+00:00,Talbot,16.0,22467,19.0,20882,1.0,3021,17.0,20.0,23903,25488,43349
5773,5773,5773,5773,5773,5773,5773,5773,5774,2021-10-19 15:00:00+00:00,Talbot,13.0,22480,21.0,20903,,3021,,,23924,25501,43383
5774,5774,5774,5774,5774,5774,5774,5774,5775,2021-10-20 15:00:00+00:00,Talbot,7.0,22487,11.0,20914,1.0,3022,8.0,12.0,23936,25509,43401
5775,5775,5775,5775,5775,5775,5775,5775,5776,2021-10-21 15:00:00+00:00,Talbot,10.0,22497,11.0,20925,1.0,3023,11.0,12.0,23948,25520,43422
5776,5776,5776,5776,5776,5776,5776,5776,5777,2021-10-22 15:00:00+00:00,Talbot,25.0,22522,49.0,20974,1.0,3024,26.0,50.0,23998,25546,43496
5777,5777,5777,5777,5777,5777,5777,5777,5778,2021-10-23 15:00:00+00:00,Talbot,9.0,22531,21.0,20995,,3024,,,24019,25555,43526
5778,5778,5778,5778,5778,5778,5778,5778,5779,2021-10-24 15:00:00+00:00,Talbot,6.0,22537,13.0,21008,,3024,,,24032,25561,43545
5779,5779,5779,5779,5779,5779,5779,5779,5780,2021-10-25 15:00:00+00:00,Talbot,41.0,22578,47.0,21055,3.0,3027,44.0,50.0,24082,25605,43633
5780,5780,5780,5780,5780,5780,5780,5780,5781,2021-05-09 15:00:00+00:00,Kent,6.0,9800,6.0,8238,,662,,,8900,10462,18038
5781,5781,5781,5781,5781,5781,5781,5781,5782,2021-05-10 15:00:00+00:00,Kent,9.0,9809,52.0,8290,4.0,666,13.0,56.0,8956,10475,18099
5782,5782,5782,5782,5782,5782,5782,5782,5783,2021-05-11 15:00:00+00:00,Kent,17.0,9826,42.0,8332,4.0,670,21.0,46.0,9002,10496,18158
5783,5783,5783,5783,5783,5783,5783,5783,5784,2021-05-12 15:00:00+00:00,Kent,46.0,9872,59.0,8391,13.0,683,59.0,72.0,9074,10555,18263
5784,5784,5784,5784,5784,5784,5784,5784,5785,2021-05-13 15:00:00+00:00,Kent,24.0,9896,41.0,8432,,683,,,9115,10579,18328
5785,5785,5785,5785,5785,5785,5785,5785,5786,2021-05-14 15:00:00+00:00,Kent,22.0,9918,25.0,8457,4.0,687,26.0,29.0,9144,10605,18375
5786,5786,5786,5786,5786,5786,5786,5786,5787,2021-05-15 15:00:00+00:00,Kent,23.0,9941,10.0,8467,5.0,692,28.0,15.0,9159,10633,18408
5787,5787,5787,5787,5787,5787,5787,5787,5788,2021-05-16 15:00:00+00:00,Kent,12.0,9953,5.0,8472,2.0,694,14.0,7.0,9166,10647,18425
5788,5788,5788,5788,5788,5788,5788,5788,5789,2021-05-17 15:00:00+00:00,Kent,28.0,9981,19.0,8491,26.0,720,54.0,45.0,9211,10701,18472
5789,5789,5789,5789,5789,5789,5789,5789,5790,2021-05-18 15:00:00+00:00,Kent,49.0,10030,76.0,8567,6.0,726,55.0,82.0,9293,10756,18597
5790,5790,5790,5790,5790,5790,5790,5790,5791,2021-05-19 15:00:00+00:00,Kent,51.0,10081,52.0,8619,4.0,730,55.0,56.0,9349,10811,18700
5791,5791,5791,5791,5791,5791,5791,5791,5792,2021-05-20 15:00:00+00:00,Kent,47.0,10128,221.0,8840,1.0,731,48.0,222.0,9571,10859,18968
5792,5792,5792,5792,5792,5792,5792,5792,5793,2021-05-21 15:00:00+00:00,Kent,32.0,10160,25.0,8865,1.0,732,33.0,26.0,9597,10892,19025
5793,5793,5793,5793,5793,5793,5793,5793,5794,2021-05-22 15:00:00+00:00,Kent,24.0,10184,27.0,8892,,732,,,9624,10916,19076
5794,5794,5794,5794,5794,5794,5794,5794,5795,2021-05-23 15:00:00+00:00,Kent,5.0,10189,6.0,8898,,732,,,9630,10921,19087
5795,5795,5795,5795,5795,5795,5795,5795,5796,2021-05-24 15:00:00+00:00,Kent,20.0,10209,17.0,8915,15.0,747,35.0,32.0,9662,10956,19124
5796,5796,5796,5796,5796,5796,5796,5796,5797,2021-05-25 15:00:00+00:00,Kent,78.0,10287,65.0,8980,5.0,752,83.0,70.0,9732,11039,19267
5797,5797,5797,5797,5797,5797,5797,5797,5798,2021-05-26 15:00:00+00:00,Kent,19.0,10306,45.0,9025,6.0,758,25.0,51.0,9783,11064,19331
5798,5798,5798,5798,5798,5798,5798,5798,5799,2021-05-27 15:00:00+00:00,Kent,24.0,10330,98.0,9123,7.0,765,31.0,105.0,9888,11095,19453
5799,5799,5799,5799,5799,5799,5799,5799,5800,2021-05-28 15:00:00+00:00,Kent,15.0,10345,56.0,9179,2.0,767,17.0,58.0,9946,11112,19524
5800,5800,5800,5800,5800,5800,5800,5800,5801,2021-05-29 15:00:00+00:00,Kent,9.0,10354,6.0,9185,,767,,,9952,11121,19539
5801,5801,5801,5801,5801,5801,5801,5801,5802,2021-05-30 15:00:00+00:00,Kent,4.0,10358,4.0,9189,,767,,,9956,11125,19547
5802,5802,5802,5802,5802,5802,5802,5802,5803,2021-05-31 15:00:00+00:00,Kent,,10358,1.0,9190,,767,,,9957,11125,19548
5803,5803,5803,5803,5803,5803,5803,5803,5804,2021-06-01 15:00:00+00:00,Kent,54.0,10412,18.0,9208,4.0,771,58.0,22.0,9979,11183,19620
5804,5804,5804,5804,5804,5804,5804,5804,5805,2021-06-02 15:00:00+00:00,Kent,24.0,10436,46.0,9254,2.0,773,26.0,48.0,10027,11209,19690
5805,5805,5805,5805,5805,5805,5805,5805,5806,2021-06-03 15:00:00+00:00,Kent,15.0,10451,41.0,9295,,773,,,10068,11224,19746
5806,5806,5806,5806,5806,5806,5806,5806,5807,2021-06-04 15:00:00+00:00,Kent,7.0,10458,11.0,9306,19.0,792,26.0,30.0,10098,11250,19764
5807,5807,5807,5807,5807,5807,5807,5807,5808,2021-06-05 15:00:00+00:00,Kent,4.0,10462,15.0,9321,,792,,,10113,11254,19783
5808,5808,5808,5808,5808,5808,5808,5808,5809,2021-10-26 15:00:00+00:00,Talbot,32.0,22610,68.0,21123,1.0,3028,33.0,69.0,24151,25638,43733
5809,5809,5809,5809,5809,5809,5809,5809,5810,2021-10-27 15:00:00+00:00,Talbot,43.0,22653,53.0,21176,2.0,3030,45.0,55.0,24206,25683,43829
5810,5810,5810,5810,5810,5810,5810,5810,5811,2021-10-28 15:00:00+00:00,Talbot,42.0,22695,43.0,21219,1.0,3031,43.0,44.0,24250,25726,43914
5811,5811,5811,5811,5811,5811,5811,5811,5812,2021-10-29 15:00:00+00:00,Talbot,34.0,22729,60.0,21279,4.0,3035,38.0,64.0,24314,25764,44008
5812,5812,5812,5812,5812,5812,5812,5812,5813,2021-10-30 15:00:00+00:00,Talbot,7.0,22736,15.0,21294,,3035,,,24329,25771,44030
5813,5813,5813,5813,5813,5813,5813,5813,5814,2021-10-31 15:00:00+00:00,Talbot,7.0,22743,9.0,21303,,3035,,,24338,25778,44046
5814,5814,5814,5814,5814,5814,5814,5814,5815,2021-11-01 15:00:00+00:00,Talbot,30.0,22773,45.0,21348,4.0,3039,34.0,49.0,24387,25812,44121
5815,5815,5815,5815,5815,5815,5815,5815,5816,2021-11-02 15:00:00+00:00,Talbot,34.0,22807,56.0,21404,1.0,3040,35.0,57.0,24444,25847,44211
5816,5816,5816,5816,5816,5816,5816,5816,5817,2021-11-03 15:00:00+00:00,Talbot,18.0,22825,32.0,21436,2.0,3042,20.0,34.0,24478,25867,44261
5817,5817,5817,5817,5817,5817,5817,5817,5818,2021-11-04 15:00:00+00:00,Talbot,9.0,22834,23.0,21459,,3042,,,24501,25876,44293
5818,5818,5818,5818,5818,5818,5818,5818,5819,2021-11-05 15:00:00+00:00,Talbot,29.0,22863,41.0,21500,2.0,3044,31.0,43.0,24544,25907,44363
5819,5819,5819,5819,5819,5819,5819,5819,5820,2021-11-06 15:00:00+00:00,Talbot,10.0,22873,2.0,21502,,3044,,,24546,25917,44375
5820,5820,5820,5820,5820,5820,5820,5820,5821,2020-12-14 15:00:00+00:00,Unknown,3.0,3,,0,,0,,,0,3,3
5821,5821,5821,5821,5821,5821,5821,5821,5822,2020-12-15 15:00:00+00:00,Unknown,9.0,12,,0,,0,,,0,12,12
5822,5822,5822,5822,5822,5822,5822,5822,5823,2020-12-16 15:00:00+00:00,Unknown,43.0,55,1.0,1,,0,,,1,55,56
5823,5823,5823,5823,5823,5823,5823,5823,5824,2020-12-17 15:00:00+00:00,Unknown,81.0,136,,1,,0,,,1,136,137
5824,5824,5824,5824,5824,5824,5824,5824,5825,2020-12-18 15:00:00+00:00,Unknown,314.0,450,1.0,2,,0,,,2,450,452
5825,5825,5825,5825,5825,5825,5825,5825,5826,2020-12-19 15:00:00+00:00,Unknown,100.0,550,,2,,0,,,2,550,552
5826,5826,5826,5826,5826,5826,5826,5826,5827,2020-12-20 15:00:00+00:00,Unknown,31.0,581,,2,,0,,,2,581,583
5827,5827,5827,5827,5827,5827,5827,5827,5828,2020-12-21 15:00:00+00:00,Unknown,367.0,948,1.0,3,,0,,,3,948,951
5828,5828,5828,5828,5828,5828,5828,5828,5829,2020-12-22 15:00:00+00:00,Unknown,501.0,1449,1.0,4,,0,,,4,1449,1453
5829,5829,5829,5829,5829,5829,5829,5829,5830,2020-12-23 15:00:00+00:00,Unknown,505.0,1954,2.0,6,,0,,,6,1954,1960
5830,5830,5830,5830,5830,5830,5830,5830,5831,2020-12-24 15:00:00+00:00,Unknown,189.0,2143,,6,,0,,,6,2143,2149
5831,5831,5831,5831,5831,5831,5831,5831,5832,2020-12-25 15:00:00+00:00,Unknown,35.0,2178,,6,,0,,,6,2178,2184
5832,5832,5832,5832,5832,5832,5832,5832,5833,2020-12-26 15:00:00+00:00,Unknown,75.0,2253,1.0,7,,0,,,7,2253,2260
5833,5833,5833,5833,5833,5833,5833,5833,5834,2020-12-27 15:00:00+00:00,Unknown,103.0,2356,,7,,0,,,7,2356,2363
5834,5834,5834,5834,5834,5834,5834,5834,5835,2020-12-28 15:00:00+00:00,Unknown,689.0,3045,1.0,8,,0,,,8,3045,3053
5835,5835,5835,5835,5835,5835,5835,5835,5836,2020-12-29 15:00:00+00:00,Unknown,782.0,3827,3.0,11,,0,,,11,3827,3838
5836,5836,5836,5836,5836,5836,5836,5836,5837,2020-12-30 15:00:00+00:00,Unknown,932.0,4759,1.0,12,,0,,,12,4759,4771
5837,5837,5837,5837,5837,5837,5837,5837,5838,2020-12-31 15:00:00+00:00,Unknown,518.0,5277,4.0,16,,0,,,16,5277,5293
5838,5838,5838,5838,5838,5838,5838,5838,5839,2021-01-01 15:00:00+00:00,Unknown,185.0,5462,9.0,25,,0,,,25,5462,5487
5839,5839,5839,5839,5839,5839,5839,5839,5840,2021-01-02 15:00:00+00:00,Unknown,162.0,5624,6.0,31,,0,,,31,5624,5655
5840,5840,5840,5840,5840,5840,5840,5840,5841,2021-01-03 15:00:00+00:00,Unknown,188.0,5812,6.0,37,,0,,,37,5812,5849
5841,5841,5841,5841,5841,5841,5841,5841,5842,2021-01-04 15:00:00+00:00,Unknown,850.0,6662,9.0,46,,0,,,46,6662,6708
5842,5842,5842,5842,5842,5842,5842,5842,5843,2021-01-05 15:00:00+00:00,Unknown,811.0,7473,49.0,95,,0,,,95,7473,7568
5843,5843,5843,5843,5843,5843,5843,5843,5844,2021-01-06 15:00:00+00:00,Unknown,1024.0,8497,63.0,158,,0,,,158,8497,8655
5844,5844,5844,5844,5844,5844,5844,5844,5845,2021-01-07 15:00:00+00:00,Unknown,1077.0,9574,137.0,295,,0,,,295,9574,9869
5845,5845,5845,5845,5845,5845,5845,5845,5846,2021-01-08 15:00:00+00:00,Unknown,792.0,10366,279.0,574,,0,,,574,10366,10940
5846,5846,5846,5846,5846,5846,5846,5846,5847,2021-01-09 15:00:00+00:00,Unknown,332.0,10698,74.0,648,,0,,,648,10698,11346
5847,5847,5847,5847,5847,5847,5847,5847,5848,2021-01-10 15:00:00+00:00,Unknown,164.0,10862,22.0,670,,0,,,670,10862,11532
5848,5848,5848,5848,5848,5848,5848,5848,5849,2021-01-11 15:00:00+00:00,Unknown,690.0,11552,271.0,941,,0,,,941,11552,12493
5849,5849,5849,5849,5849,5849,5849,5849,5850,2021-01-12 15:00:00+00:00,Unknown,942.0,12494,394.0,1335,,0,,,1335,12494,13829
5850,5850,5850,5850,5850,5850,5850,5850,5851,2021-01-13 15:00:00+00:00,Unknown,1134.0,13628,324.0,1659,,0,,,1659,13628,15287
5851,5851,5851,5851,5851,5851,5851,5851,5852,2021-01-14 15:00:00+00:00,Unknown,1029.0,14657,143.0,1802,,0,,,1802,14657,16459
5852,5852,5852,5852,5852,5852,5852,5852,5853,2021-01-15 15:00:00+00:00,Unknown,1089.0,15746,117.0,1919,,0,,,1919,15746,17665
5853,5853,5853,5853,5853,5853,5853,5853,5854,2021-01-16 15:00:00+00:00,Unknown,334.0,16080,60.0,1979,,0,,,1979,16080,18059
5854,5854,5854,5854,5854,5854,5854,5854,5855,2021-01-17 15:00:00+00:00,Unknown,149.0,16229,76.0,2055,,0,,,2055,16229,18284
5855,5855,5855,5855,5855,5855,5855,5855,5856,2021-01-18 15:00:00+00:00,Unknown,274.0,16503,259.0,2314,,0,,,2314,16503,18817
5856,5856,5856,5856,5856,5856,5856,5856,5857,2021-01-19 15:00:00+00:00,Unknown,634.0,17137,371.0,2685,,0,,,2685,17137,19822
5857,5857,5857,5857,5857,5857,5857,5857,5858,2021-01-20 15:00:00+00:00,Unknown,690.0,17827,412.0,3097,,0,,,3097,17827,20924
5858,5858,5858,5858,5858,5858,5858,5858,5859,2021-01-21 15:00:00+00:00,Unknown,1013.0,18840,237.0,3334,,0,,,3334,18840,22174
5859,5859,5859,5859,5859,5859,5859,5859,5860,2021-01-22 15:00:00+00:00,Unknown,1113.0,19953,190.0,3524,,0,,,3524,19953,23477
5860,5860,5860,5860,5860,5860,5860,5860,5861,2021-01-23 15:00:00+00:00,Unknown,565.0,20518,116.0,3640,,0,,,3640,20518,24158
5861,5861,5861,5861,5861,5861,5861,5861,5862,2021-01-24 15:00:00+00:00,Unknown,225.0,20743,92.0,3732,,0,,,3732,20743,24475
5862,5862,5862,5862,5862,5862,5862,5862,5863,2021-01-25 15:00:00+00:00,Unknown,806.0,21549,669.0,4401,,0,,,4401,21549,25950
5863,5863,5863,5863,5863,5863,5863,5863,5864,2021-01-26 15:00:00+00:00,Unknown,810.0,22359,548.0,4949,,0,,,4949,22359,27308
5864,5864,5864,5864,5864,5864,5864,5864,5865,2021-01-27 15:00:00+00:00,Unknown,773.0,23132,916.0,5865,,0,,,5865,23132,28997
5865,5865,5865,5865,5865,5865,5865,5865,5866,2021-01-28 15:00:00+00:00,Unknown,839.0,23971,630.0,6495,,0,,,6495,23971,30466
5866,5866,5866,5866,5866,5866,5866,5866,5867,2021-01-29 15:00:00+00:00,Unknown,1004.0,24975,529.0,7024,,0,,,7024,24975,31999
5867,5867,5867,5867,5867,5867,5867,5867,5868,2021-01-30 15:00:00+00:00,Unknown,549.0,25524,141.0,7165,,0,,,7165,25524,32689
5868,5868,5868,5868,5868,5868,5868,5868,5869,2021-01-31 15:00:00+00:00,Unknown,191.0,25715,57.0,7222,,0,,,7222,25715,32937
5869,5869,5869,5869,5869,5869,5869,5869,5870,2021-02-01 15:00:00+00:00,Unknown,492.0,26207,319.0,7541,,0,,,7541,26207,33748
5870,5870,5870,5870,5870,5870,5870,5870,5871,2021-02-02 15:00:00+00:00,Unknown,530.0,26737,834.0,8375,,0,,,8375,26737,35112
5871,5871,5871,5871,5871,5871,5871,5871,5872,2021-02-03 15:00:00+00:00,Unknown,802.0,27539,1010.0,9385,,0,,,9385,27539,36924
5872,5872,5872,5872,5872,5872,5872,5872,5873,2021-02-04 15:00:00+00:00,Unknown,888.0,28427,910.0,10295,,0,,,10295,28427,38722
5873,5873,5873,5873,5873,5873,5873,5873,5874,2021-02-05 15:00:00+00:00,Unknown,795.0,29222,853.0,11148,,0,,,11148,29222,40370
5874,5874,5874,5874,5874,5874,5874,5874,5875,2021-02-06 15:00:00+00:00,Unknown,448.0,29670,283.0,11431,,0,,,11431,29670,41101
5875,5875,5875,5875,5875,5875,5875,5875,5876,2021-02-07 15:00:00+00:00,Unknown,230.0,29900,97.0,11528,,0,,,11528,29900,41428
5876,5876,5876,5876,5876,5876,5876,5876,5877,2021-02-08 15:00:00+00:00,Unknown,545.0,30445,660.0,12188,,0,,,12188,30445,42633
5877,5877,5877,5877,5877,5877,5877,5877,5878,2021-02-09 15:00:00+00:00,Unknown,712.0,31157,705.0,12893,,0,,,12893,31157,44050
5878,5878,5878,5878,5878,5878,5878,5878,5879,2021-02-10 15:00:00+00:00,Unknown,787.0,31944,1020.0,13913,,0,,,13913,31944,45857
5879,5879,5879,5879,5879,5879,5879,5879,5880,2021-02-11 15:00:00+00:00,Unknown,850.0,32794,939.0,14852,,0,,,14852,32794,47646
5880,5880,5880,5880,5880,5880,5880,5880,5881,2021-02-12 15:00:00+00:00,Unknown,818.0,33612,1172.0,16024,,0,,,16024,33612,49636
5881,5881,5881,5881,5881,5881,5881,5881,5882,2021-02-13 15:00:00+00:00,Unknown,370.0,33982,282.0,16306,,0,,,16306,33982,50288
5882,5882,5882,5882,5882,5882,5882,5882,5883,2021-02-14 15:00:00+00:00,Unknown,415.0,34397,163.0,16469,,0,,,16469,34397,50866
5883,5883,5883,5883,5883,5883,5883,5883,5884,2021-02-15 15:00:00+00:00,Unknown,557.0,34954,627.0,17096,,0,,,17096,34954,52050
5884,5884,5884,5884,5884,5884,5884,5884,5885,2021-02-16 15:00:00+00:00,Unknown,773.0,35727,840.0,17936,,0,,,17936,35727,53663
5885,5885,5885,5885,5885,5885,5885,5885,5886,2021-02-17 15:00:00+00:00,Unknown,816.0,36543,940.0,18876,,0,,,18876,36543,55419
5886,5886,5886,5886,5886,5886,5886,5886,5887,2021-02-18 15:00:00+00:00,Unknown,276.0,36819,251.0,19127,,0,,,19127,36819,55946
5887,5887,5887,5887,5887,5887,5887,5887,5888,2021-02-19 15:00:00+00:00,Unknown,642.0,37461,924.0,20051,,0,,,20051,37461,57512
5888,5888,5888,5888,5888,5888,5888,5888,5889,2021-02-20 15:00:00+00:00,Unknown,614.0,38075,686.0,20737,,0,,,20737,38075,58812
5889,5889,5889,5889,5889,5889,5889,5889,5890,2021-02-21 15:00:00+00:00,Unknown,242.0,38317,316.0,21053,,0,,,21053,38317,59370
5890,5890,5890,5890,5890,5890,5890,5890,5891,2021-02-22 15:00:00+00:00,Unknown,363.0,38680,611.0,21664,,0,,,21664,38680,60344
5891,5891,5891,5891,5891,5891,5891,5891,5892,2021-02-23 15:00:00+00:00,Unknown,545.0,39225,627.0,22291,,0,,,22291,39225,61516
5892,5892,5892,5892,5892,5892,5892,5892,5893,2021-02-24 15:00:00+00:00,Unknown,824.0,40049,836.0,23127,,0,,,23127,40049,63176
5893,5893,5893,5893,5893,5893,5893,5893,5894,2021-02-25 15:00:00+00:00,Unknown,860.0,40909,927.0,24054,,0,,,24054,40909,64963
5894,5894,5894,5894,5894,5894,5894,5894,5895,2021-02-26 15:00:00+00:00,Unknown,1150.0,42059,1080.0,25134,,0,,,25134,42059,67193
5895,5895,5895,5895,5895,5895,5895,5895,5896,2021-02-27 15:00:00+00:00,Unknown,757.0,42816,384.0,25518,,0,,,25518,42816,68334
5896,5896,5896,5896,5896,5896,5896,5896,5897,2021-02-28 15:00:00+00:00,Unknown,655.0,43471,203.0,25721,,0,,,25721,43471,69192
5897,5897,5897,5897,5897,5897,5897,5897,5898,2021-03-01 15:00:00+00:00,Unknown,1400.0,44871,500.0,26221,,0,,,26221,44871,71092
5898,5898,5898,5898,5898,5898,5898,5898,5899,2021-03-02 15:00:00+00:00,Unknown,1311.0,46182,578.0,26799,1.0,1,1312.0,579.0,26800,46183,72981
5899,5899,5899,5899,5899,5899,5899,5899,5900,2021-03-03 15:00:00+00:00,Unknown,1507.0,47689,615.0,27414,27.0,28,1534.0,642.0,27442,47717,75103
5900,5900,5900,5900,5900,5900,5900,5900,5901,2021-03-04 15:00:00+00:00,Unknown,1476.0,49165,723.0,28137,139.0,167,1615.0,862.0,28304,49332,77302
5901,5901,5901,5901,5901,5901,5901,5901,5902,2021-03-05 15:00:00+00:00,Unknown,1573.0,50738,754.0,28891,190.0,357,1763.0,944.0,29248,51095,79629
5902,5902,5902,5902,5902,5902,5902,5902,5903,2021-03-06 15:00:00+00:00,Unknown,994.0,51732,325.0,29216,317.0,674,1311.0,642.0,29890,52406,80948
5903,5903,5903,5903,5903,5903,5903,5903,5904,2021-03-07 15:00:00+00:00,Unknown,693.0,52425,185.0,29401,276.0,950,969.0,461.0,30351,53375,81826
5904,5904,5904,5904,5904,5904,5904,5904,5905,2021-03-08 15:00:00+00:00,Unknown,1307.0,53732,358.0,29759,347.0,1297,1654.0,705.0,31056,55029,83491
5905,5905,5905,5905,5905,5905,5905,5905,5906,2021-03-09 15:00:00+00:00,Unknown,1265.0,54997,607.0,30366,320.0,1617,1585.0,927.0,31983,56614,85363
5906,5906,5906,5906,5906,5906,5906,5906,5907,2021-03-10 15:00:00+00:00,Unknown,1535.0,56532,573.0,30939,500.0,2117,2035.0,1073.0,33056,58649,87471
5907,5907,5907,5907,5907,5907,5907,5907,5908,2021-03-11 15:00:00+00:00,Unknown,1926.0,58458,564.0,31503,240.0,2357,2166.0,804.0,33860,60815,89961
5908,5908,5908,5908,5908,5908,5908,5908,5909,2021-03-12 15:00:00+00:00,Unknown,1931.0,60389,749.0,32252,198.0,2555,2129.0,947.0,34807,62944,92641
5909,5909,5909,5909,5909,5909,5909,5909,5910,2021-03-13 15:00:00+00:00,Unknown,1169.0,61558,415.0,32667,110.0,2665,1279.0,525.0,35332,64223,94225
5910,5910,5910,5910,5910,5910,5910,5910,5911,2021-03-14 15:00:00+00:00,Unknown,1029.0,62587,300.0,32967,77.0,2742,1106.0,377.0,35709,65329,95554
5911,5911,5911,5911,5911,5911,5911,5911,5912,2021-03-15 15:00:00+00:00,Unknown,1653.0,64240,515.0,33482,52.0,2794,1705.0,567.0,36276,67034,97722
5912,5912,5912,5912,5912,5912,5912,5912,5913,2021-03-16 15:00:00+00:00,Unknown,1801.0,66041,695.0,34177,36.0,2830,1837.0,731.0,37007,68871,100218
5913,5913,5913,5913,5913,5913,5913,5913,5914,2021-03-17 15:00:00+00:00,Unknown,1868.0,67909,766.0,34943,42.0,2872,1910.0,808.0,37815,70781,102852
5914,5914,5914,5914,5914,5914,5914,5914,5915,2021-03-18 15:00:00+00:00,Unknown,2129.0,70038,585.0,35528,92.0,2964,2221.0,677.0,38492,73002,105566
5915,5915,5915,5915,5915,5915,5915,5915,5916,2021-03-19 15:00:00+00:00,Unknown,2163.0,72201,679.0,36207,63.0,3027,2226.0,742.0,39234,75228,108408
5916,5916,5916,5916,5916,5916,5916,5916,5917,2021-03-20 15:00:00+00:00,Unknown,1600.0,73801,502.0,36709,81.0,3108,1681.0,583.0,39817,76909,110510
5917,5917,5917,5917,5917,5917,5917,5917,5918,2021-03-21 15:00:00+00:00,Unknown,1160.0,74961,388.0,37097,30.0,3138,1190.0,418.0,40235,78099,112058
5918,5918,5918,5918,5918,5918,5918,5918,5919,2021-03-22 15:00:00+00:00,Unknown,1968.0,76929,561.0,37658,80.0,3218,2048.0,641.0,40876,80147,114587
5919,5919,5919,5919,5919,5919,5919,5919,5920,2021-03-23 15:00:00+00:00,Unknown,2702.0,79631,688.0,38346,84.0,3302,2786.0,772.0,41648,82933,117977
5920,5920,5920,5920,5920,5920,5920,5920,5921,2021-04-18 15:00:00+00:00,Garrett,13.0,8927,21.0,6366,,522,,,6888,9449,15293
5921,5921,5921,5921,5921,5921,5921,5921,5922,2021-04-19 15:00:00+00:00,Garrett,40.0,8967,58.0,6424,,522,,,6946,9489,15391
5922,5922,5922,5922,5922,5922,5922,5922,5923,2021-04-20 15:00:00+00:00,Garrett,134.0,9101,101.0,6525,,522,,,7047,9623,15626
5923,5923,5923,5923,5923,5923,5923,5923,5924,2021-04-21 15:00:00+00:00,Garrett,39.0,9140,75.0,6600,,522,,,7122,9662,15740
5924,5924,5924,5924,5924,5924,5924,5924,5925,2021-04-22 15:00:00+00:00,Garrett,61.0,9201,101.0,6701,,522,,,7223,9723,15902
5925,5925,5925,5925,5925,5925,5925,5925,5926,2021-04-23 15:00:00+00:00,Garrett,73.0,9274,128.0,6829,,522,,,7351,9796,16103
5926,5926,5926,5926,5926,5926,5926,5926,5927,2021-04-24 15:00:00+00:00,Garrett,10.0,9284,23.0,6852,,522,,,7374,9806,16136
5927,5927,5927,5927,5927,5927,5927,5927,5928,2021-04-25 15:00:00+00:00,Garrett,,9284,14.0,6866,,522,,,7388,9806,16150
5928,5928,5928,5928,5928,5928,5928,5928,5929,2021-04-26 15:00:00+00:00,Garrett,14.0,9298,46.0,6912,,522,,,7434,9820,16210
5929,5929,5929,5929,5929,5929,5929,5929,5930,2021-04-27 15:00:00+00:00,Garrett,64.0,9362,263.0,7175,,522,,,7697,9884,16537
5930,5930,5930,5930,5930,5930,5930,5930,5931,2021-04-28 15:00:00+00:00,Garrett,25.0,9387,54.0,7229,1.0,523,26.0,55.0,7752,9910,16616
5931,5931,5931,5931,5931,5931,5931,5931,5932,2021-04-29 15:00:00+00:00,Garrett,82.0,9469,218.0,7447,5.0,528,87.0,223.0,7975,9997,16916
5932,5932,5932,5932,5932,5932,5932,5932,5933,2021-04-30 15:00:00+00:00,Garrett,43.0,9512,122.0,7569,,528,,,8097,10040,17081
5933,5933,5933,5933,5933,5933,5933,5933,5934,2021-05-01 15:00:00+00:00,Garrett,49.0,9561,22.0,7591,2.0,530,51.0,24.0,8121,10091,17152
5934,5934,5934,5934,5934,5934,5934,5934,5935,2021-05-02 15:00:00+00:00,Garrett,12.0,9573,19.0,7610,,530,,,8140,10103,17183
5935,5935,5935,5935,5935,5935,5935,5935,5936,2021-05-03 15:00:00+00:00,Garrett,11.0,9584,28.0,7638,2.0,532,13.0,30.0,8170,10116,17222
5936,5936,5936,5936,5936,5936,5936,5936,5937,2021-05-04 15:00:00+00:00,Garrett,25.0,9609,93.0,7731,18.0,550,43.0,111.0,8281,10159,17340
5937,5937,5937,5937,5937,5937,5937,5937,5938,2021-05-05 15:00:00+00:00,Garrett,21.0,9630,50.0,7781,6.0,556,27.0,56.0,8337,10186,17411
5938,5938,5938,5938,5938,5938,5938,5938,5939,2021-05-06 15:00:00+00:00,Garrett,36.0,9666,61.0,7842,15.0,571,51.0,76.0,8413,10237,17508
5939,5939,5939,5939,5939,5939,5939,5939,5940,2021-05-07 15:00:00+00:00,Garrett,26.0,9692,70.0,7912,20.0,591,46.0,90.0,8503,10283,17604
5940,5940,5940,5940,5940,5940,5940,5940,5941,2021-05-08 15:00:00+00:00,Garrett,28.0,9720,13.0,7925,4.0,595,32.0,17.0,8520,10315,17645
5941,5941,5941,5941,5941,5941,5941,5941,5942,2021-05-09 15:00:00+00:00,Garrett,3.0,9723,12.0,7937,,595,,,8532,10318,17660
5942,5942,5942,5942,5942,5942,5942,5942,5943,2021-05-10 15:00:00+00:00,Garrett,9.0,9732,21.0,7958,1.0,596,10.0,22.0,8554,10328,17690
5943,5943,5943,5943,5943,5943,5943,5943,5944,2021-05-11 15:00:00+00:00,Garrett,23.0,9755,163.0,8121,16.0,612,39.0,179.0,8733,10367,17876
5944,5944,5944,5944,5944,5944,5944,5944,5945,2021-05-12 15:00:00+00:00,Garrett,25.0,9780,77.0,8198,5.0,617,30.0,82.0,8815,10397,17978
5945,5945,5945,5945,5945,5945,5945,5945,5946,2021-05-13 15:00:00+00:00,Garrett,39.0,9819,225.0,8423,6.0,623,45.0,231.0,9046,10442,18242
5946,5946,5946,5946,5946,5946,5946,5946,5947,2021-05-14 15:00:00+00:00,Garrett,36.0,9855,47.0,8470,16.0,639,52.0,63.0,9109,10494,18325
5947,5947,5947,5947,5947,5947,5947,5947,5948,2021-05-15 15:00:00+00:00,Garrett,34.0,9889,23.0,8493,12.0,651,46.0,35.0,9144,10540,18382
5948,5948,5948,5948,5948,5948,5948,5948,5949,2021-06-06 15:00:00+00:00,Kent,,10462,12.0,9333,,792,,,10125,11254,19795
5949,5949,5949,5949,5949,5949,5949,5949,5950,2021-06-07 15:00:00+00:00,Kent,15.0,10477,18.0,9351,3.0,795,18.0,21.0,10146,11272,19828
5950,5950,5950,5950,5950,5950,5950,5950,5951,2021-06-08 15:00:00+00:00,Kent,13.0,10490,24.0,9375,19.0,814,32.0,43.0,10189,11304,19865
5951,5951,5951,5951,5951,5951,5951,5951,5952,2021-06-09 15:00:00+00:00,Kent,36.0,10526,28.0,9403,2.0,816,38.0,30.0,10219,11342,19929
5952,5952,5952,5952,5952,5952,5952,5952,5953,2021-06-10 15:00:00+00:00,Kent,23.0,10549,46.0,9449,4.0,820,27.0,50.0,10269,11369,19998
5953,5953,5953,5953,5953,5953,5953,5953,5954,2021-06-11 15:00:00+00:00,Kent,15.0,10564,19.0,9468,4.0,824,19.0,23.0,10292,11388,20032
5954,5954,5954,5954,5954,5954,5954,5954,5955,2021-06-12 15:00:00+00:00,Kent,7.0,10571,16.0,9484,3.0,827,10.0,19.0,10311,11398,20055
5955,5955,5955,5955,5955,5955,5955,5955,5956,2021-06-13 15:00:00+00:00,Kent,3.0,10574,1.0,9485,,827,,,10312,11401,20059
5956,5956,5956,5956,5956,5956,5956,5956,5957,2021-06-14 15:00:00+00:00,Kent,6.0,10580,14.0,9499,6.0,833,12.0,20.0,10332,11413,20079
5957,5957,5957,5957,5957,5957,5957,5957,5958,2021-06-15 15:00:00+00:00,Kent,12.0,10592,84.0,9583,3.0,836,15.0,87.0,10419,11428,20175
5958,5958,5958,5958,5958,5958,5958,5958,5959,2021-06-16 15:00:00+00:00,Kent,7.0,10599,10.0,9593,,836,,,10429,11435,20192
5959,5959,5959,5959,5959,5959,5959,5959,5960,2021-06-17 15:00:00+00:00,Kent,4.0,10603,46.0,9639,1.0,837,5.0,47.0,10476,11440,20242
5960,5960,5960,5960,5960,5960,5960,5960,5961,2021-06-18 15:00:00+00:00,Kent,9.0,10612,38.0,9677,,837,,,10514,11449,20289
5961,5961,5961,5961,5961,5961,5961,5961,5962,2021-06-19 15:00:00+00:00,Kent,9.0,10621,11.0,9688,,837,,,10525,11458,20309
5962,5962,5962,5962,5962,5962,5962,5962,5963,2021-06-20 15:00:00+00:00,Kent,3.0,10624,6.0,9694,,837,,,10531,11461,20318
5963,5963,5963,5963,5963,5963,5963,5963,5964,2021-06-21 15:00:00+00:00,Kent,6.0,10630,15.0,9709,18.0,855,24.0,33.0,10564,11485,20339
5964,5964,5964,5964,5964,5964,5964,5964,5965,2021-06-22 15:00:00+00:00,Kent,8.0,10638,57.0,9766,1.0,856,9.0,58.0,10622,11494,20404
5965,5965,5965,5965,5965,5965,5965,5965,5966,2021-06-23 15:00:00+00:00,Kent,7.0,10645,17.0,9783,13.0,869,20.0,30.0,10652,11514,20428
5966,5966,5966,5966,5966,5966,5966,5966,5967,2021-06-24 15:00:00+00:00,Kent,19.0,10664,29.0,9812,1.0,870,20.0,30.0,10682,11534,20476
5967,5967,5967,5967,5967,5967,5967,5967,5968,2021-06-25 15:00:00+00:00,Kent,10.0,10674,14.0,9826,,870,,,10696,11544,20500
5968,5968,5968,5968,5968,5968,5968,5968,5969,2021-06-26 15:00:00+00:00,Kent,2.0,10676,7.0,9833,,870,,,10703,11546,20509
5969,5969,5969,5969,5969,5969,5969,5969,5970,2021-06-27 15:00:00+00:00,Kent,3.0,10679,3.0,9836,,870,,,10706,11549,20515
5970,5970,5970,5970,5970,5970,5970,5970,5971,2021-06-28 15:00:00+00:00,Kent,12.0,10691,5.0,9841,,870,,,10711,11561,20532
5971,5971,5971,5971,5971,5971,5971,5971,5972,2021-06-29 15:00:00+00:00,Kent,9.0,10700,11.0,9852,,870,,,10722,11570,20552
5972,5972,5972,5972,5972,5972,5972,5972,5973,2021-06-30 15:00:00+00:00,Kent,11.0,10711,22.0,9874,,870,,,10744,11581,20585
5973,5973,5973,5973,5973,5973,5973,5973,5974,2021-07-01 15:00:00+00:00,Kent,9.0,10720,18.0,9892,2.0,872,11.0,20.0,10764,11592,20612
5974,5974,5974,5974,5974,5974,5974,5974,5975,2021-07-02 15:00:00+00:00,Kent,8.0,10728,14.0,9906,5.0,877,13.0,19.0,10783,11605,20634
5975,5975,5975,5975,5975,5975,5975,5975,5976,2021-07-03 15:00:00+00:00,Kent,2.0,10730,2.0,9908,,877,,,10785,11607,20638
5976,5976,5976,5976,5976,5976,5976,5976,5977,2021-07-05 15:00:00+00:00,Kent,5.0,10735,6.0,9914,,877,,,10791,11612,20649
5977,5977,5977,5977,5977,5977,5977,5977,5978,2021-07-06 15:00:00+00:00,Kent,8.0,10743,10.0,9924,1.0,878,9.0,11.0,10802,11621,20667
5978,5978,5978,5978,5978,5978,5978,5978,5979,2021-07-07 15:00:00+00:00,Kent,6.0,10749,4.0,9928,1.0,879,7.0,5.0,10807,11628,20677
5979,5979,5979,5979,5979,5979,5979,5979,5980,2021-07-08 15:00:00+00:00,Kent,16.0,10765,27.0,9955,,879,,,10834,11644,20720
5980,5980,5980,5980,5980,5980,5980,5980,5981,2021-07-09 15:00:00+00:00,Kent,9.0,10774,11.0,9966,16.0,895,25.0,27.0,10861,11669,20740
5981,5981,5981,5981,5981,5981,5981,5981,5982,2021-07-10 15:00:00+00:00,Kent,4.0,10778,4.0,9970,1.0,896,5.0,5.0,10866,11674,20748
5982,5982,5982,5982,5982,5982,5982,5982,5983,2021-07-11 15:00:00+00:00,Kent,2.0,10780,,9970,,896,,,10866,11676,20750
5983,5983,5983,5983,5983,5983,5983,5983,5984,2021-07-12 15:00:00+00:00,Kent,6.0,10786,15.0,9985,,896,,,10881,11682,20771
5984,5984,5984,5984,5984,5984,5984,5984,5985,2021-07-13 15:00:00+00:00,Kent,6.0,10792,8.0,9993,,896,,,10889,11688,20785
5985,5985,5985,5985,5985,5985,5985,5985,5986,2021-07-14 15:00:00+00:00,Kent,8.0,10800,4.0,9997,,896,,,10893,11696,20797
5986,5986,5986,5986,5986,5986,5986,5986,5987,2021-07-15 15:00:00+00:00,Kent,21.0,10821,16.0,10013,3.0,899,24.0,19.0,10912,11720,20834
5987,5987,5987,5987,5987,5987,5987,5987,5988,2021-07-16 15:00:00+00:00,Kent,11.0,10832,4.0,10017,,899,,,10916,11731,20849
5988,5988,5988,5988,5988,5988,5988,5988,5989,2021-07-17 15:00:00+00:00,Kent,10.0,10842,2.0,10019,,899,,,10918,11741,20861
5989,5989,5989,5989,5989,5989,5989,5989,5990,2021-07-18 15:00:00+00:00,Kent,,10842,3.0,10022,,899,,,10921,11741,20864
5990,5990,5990,5990,5990,5990,5990,5990,5991,2021-07-19 15:00:00+00:00,Kent,11.0,10853,9.0,10031,1.0,900,12.0,10.0,10931,11753,20884
5991,5991,5991,5991,5991,5991,5991,5991,5992,2021-07-20 15:00:00+00:00,Kent,7.0,10860,7.0,10038,,900,,,10938,11760,20898
5992,5992,5992,5992,5992,5992,5992,5992,5993,2021-07-21 15:00:00+00:00,Kent,11.0,10871,5.0,10043,,900,,,10943,11771,20914
5993,5993,5993,5993,5993,5993,5993,5993,5994,2021-07-22 15:00:00+00:00,Kent,22.0,10893,15.0,10058,2.0,902,24.0,17.0,10960,11795,20951
5994,5994,5994,5994,5994,5994,5994,5994,5995,2021-07-23 15:00:00+00:00,Kent,11.0,10904,17.0,10075,1.0,903,12.0,18.0,10978,11807,20979
5995,5995,5995,5995,5995,5995,5995,5995,5996,2021-07-24 15:00:00+00:00,Kent,2.0,10906,4.0,10079,,903,,,10982,11809,20985
5996,5996,5996,5996,5996,5996,5996,5996,5997,2021-07-25 15:00:00+00:00,Kent,1.0,10907,3.0,10082,,903,,,10985,11810,20989
5997,5997,5997,5997,5997,5997,5997,5997,5998,2021-07-26 15:00:00+00:00,Kent,10.0,10917,7.0,10089,1.0,904,11.0,8.0,10993,11821,21006
5998,5998,5998,5998,5998,5998,5998,5998,5999,2021-07-27 15:00:00+00:00,Kent,19.0,10936,5.0,10094,2.0,906,21.0,7.0,11000,11842,21030
5999,5999,5999,5999,5999,5999,5999,5999,6000,2021-07-28 15:00:00+00:00,Kent,21.0,10957,2.0,10096,3.0,909,24.0,5.0,11005,11866,21053
6000,6000,6000,6000,6000,6000,6000,6000,6001,2021-07-29 15:00:00+00:00,Kent,32.0,10989,13.0,10109,4.0,913,36.0,17.0,11022,11902,21098
6001,6001,6001,6001,6001,6001,6001,6001,6002,2021-07-30 15:00:00+00:00,Kent,14.0,11003,16.0,10125,1.0,914,15.0,17.0,11039,11917,21128
6002,6002,6002,6002,6002,6002,6002,6002,6003,2021-07-31 15:00:00+00:00,Kent,9.0,11012,4.0,10129,,914,,,11043,11926,21141
6003,6003,6003,6003,6003,6003,6003,6003,6004,2021-08-01 15:00:00+00:00,Kent,4.0,11016,2.0,10131,,914,,,11045,11930,21147
6004,6004,6004,6004,6004,6004,6004,6004,6005,2021-08-02 15:00:00+00:00,Kent,6.0,11022,12.0,10143,,914,,,11057,11936,21165
6005,6005,6005,6005,6005,6005,6005,6005,6006,2021-08-03 15:00:00+00:00,Kent,15.0,11037,5.0,10148,,914,,,11062,11951,21185
6006,6006,6006,6006,6006,6006,6006,6006,6007,2021-08-04 15:00:00+00:00,Kent,17.0,11054,7.0,10155,,914,,,11069,11968,21209
6007,6007,6007,6007,6007,6007,6007,6007,6008,2021-08-05 15:00:00+00:00,Kent,29.0,11083,20.0,10175,4.0,918,33.0,24.0,11093,12001,21258
6008,6008,6008,6008,6008,6008,6008,6008,6009,2021-08-06 15:00:00+00:00,Kent,16.0,11099,5.0,10180,1.0,919,17.0,6.0,11099,12018,21279
6009,6009,6009,6009,6009,6009,6009,6009,6010,2021-08-07 15:00:00+00:00,Kent,5.0,11104,3.0,10183,,919,,,11102,12023,21287
6010,6010,6010,6010,6010,6010,6010,6010,6011,2021-08-08 15:00:00+00:00,Kent,38.0,11142,,10183,,919,,,11102,12061,21325
6011,6011,6011,6011,6011,6011,6011,6011,6012,2021-08-09 15:00:00+00:00,Kent,11.0,11153,6.0,10189,,919,,,11108,12072,21342
6012,6012,6012,6012,6012,6012,6012,6012,6013,2021-08-10 15:00:00+00:00,Kent,10.0,11163,9.0,10198,1.0,920,11.0,10.0,11118,12083,21361
6013,6013,6013,6013,6013,6013,6013,6013,6014,2021-08-11 15:00:00+00:00,Kent,8.0,11171,6.0,10204,2.0,922,10.0,8.0,11126,12093,21375
6014,6014,6014,6014,6014,6014,6014,6014,6015,2021-08-12 15:00:00+00:00,Kent,35.0,11206,15.0,10219,7.0,929,42.0,22.0,11148,12135,21425
6015,6015,6015,6015,6015,6015,6015,6015,6016,2021-08-13 15:00:00+00:00,Kent,15.0,11221,7.0,10226,1.0,930,16.0,8.0,11156,12151,21447
6016,6016,6016,6016,6016,6016,6016,6016,6017,2021-08-14 15:00:00+00:00,Kent,6.0,11227,7.0,10233,,930,,,11163,12157,21460
6017,6017,6017,6017,6017,6017,6017,6017,6018,2021-08-15 15:00:00+00:00,Kent,3.0,11230,2.0,10235,,930,,,11165,12160,21465
6018,6018,6018,6018,6018,6018,6018,6018,6019,2021-08-16 15:00:00+00:00,Kent,12.0,11242,11.0,10246,,930,,,11176,12172,21488
6019,6019,6019,6019,6019,6019,6019,6019,6020,2021-08-17 15:00:00+00:00,Kent,9.0,11251,7.0,10253,,930,,,11183,12181,21504
6020,6020,6020,6020,6020,6020,6020,6020,6021,2021-08-18 15:00:00+00:00,Kent,8.0,11259,14.0,10267,,930,,,11197,12189,21526
6021,6021,6021,6021,6021,6021,6021,6021,6022,2021-08-19 15:00:00+00:00,Kent,37.0,11296,19.0,10286,15.0,945,52.0,34.0,11231,12241,21582
6022,6022,6022,6022,6022,6022,6022,6022,6023,2021-08-20 15:00:00+00:00,Kent,17.0,11313,11.0,10297,1.0,946,18.0,12.0,11243,12259,21610
6023,6023,6023,6023,6023,6023,6023,6023,6024,2021-08-21 15:00:00+00:00,Kent,5.0,11318,6.0,10303,3.0,949,8.0,9.0,11252,12267,21621
6024,6024,6024,6024,6024,6024,6024,6024,6025,2021-08-22 15:00:00+00:00,Kent,4.0,11322,2.0,10305,,949,,,11254,12271,21627
6025,6025,6025,6025,6025,6025,6025,6025,6026,2021-08-23 15:00:00+00:00,Kent,14.0,11336,9.0,10314,,949,,,11263,12285,21650
6026,6026,6026,6026,6026,6026,6026,6026,6027,2021-08-24 15:00:00+00:00,Kent,8.0,11344,17.0,10331,1.0,950,9.0,18.0,11281,12294,21675
6027,6027,6027,6027,6027,6027,6027,6027,6028,2021-08-25 15:00:00+00:00,Kent,21.0,11365,14.0,10345,,950,,,11295,12315,21710
6028,6028,6028,6028,6028,6028,6028,6028,6029,2021-08-26 15:00:00+00:00,Kent,27.0,11392,36.0,10381,15.0,965,42.0,51.0,11346,12357,21773
6029,6029,6029,6029,6029,6029,6029,6029,6030,2021-08-27 15:00:00+00:00,Kent,11.0,11403,11.0,10392,,965,,,11357,12368,21795
6030,6030,6030,6030,6030,6030,6030,6030,6031,2021-08-28 15:00:00+00:00,Kent,5.0,11408,9.0,10401,,965,,,11366,12373,21809
6031,6031,6031,6031,6031,6031,6031,6031,6032,2021-08-29 15:00:00+00:00,Kent,9.0,11417,33.0,10434,,965,,,11399,12382,21851
6032,6032,6032,6032,6032,6032,6032,6032,6033,2021-08-30 15:00:00+00:00,Kent,12.0,11429,17.0,10451,,965,,,11416,12394,21880
6033,6033,6033,6033,6033,6033,6033,6033,6034,2021-08-31 15:00:00+00:00,Kent,15.0,11444,10.0,10461,,965,,,11426,12409,21905
6034,6034,6034,6034,6034,6034,6034,6034,6035,2021-09-01 15:00:00+00:00,Kent,10.0,11454,11.0,10472,,965,,,11437,12419,21926
6035,6035,6035,6035,6035,6035,6035,6035,6036,2021-09-02 15:00:00+00:00,Kent,15.0,11469,16.0,10488,10.0,975,25.0,26.0,11463,12444,21957
6036,6036,6036,6036,6036,6036,6036,6036,6037,2021-09-03 15:00:00+00:00,Kent,4.0,11473,9.0,10497,1.0,976,5.0,10.0,11473,12449,21970
6037,6037,6037,6037,6037,6037,6037,6037,6038,2021-09-04 15:00:00+00:00,Kent,6.0,11479,3.0,10500,,976,,,11476,12455,21979
6038,6038,6038,6038,6038,6038,6038,6038,6039,2021-09-05 15:00:00+00:00,Kent,,11479,2.0,10502,,976,,,11478,12455,21981
6039,6039,6039,6039,6039,6039,6039,6039,6040,2021-09-07 15:00:00+00:00,Kent,5.0,11484,8.0,10510,,976,,,11486,12460,21994
6040,6040,6040,6040,6040,6040,6040,6040,6041,2021-09-08 15:00:00+00:00,Kent,2.0,11486,11.0,10521,,976,,,11497,12462,22007
6041,6041,6041,6041,6041,6041,6041,6041,6042,2021-09-09 15:00:00+00:00,Kent,17.0,11503,43.0,10564,4.0,980,21.0,47.0,11544,12483,22067
6042,6042,6042,6042,6042,6042,6042,6042,6043,2021-09-10 15:00:00+00:00,Kent,10.0,11513,15.0,10579,1.0,981,11.0,16.0,11560,12494,22092
6043,6043,6043,6043,6043,6043,6043,6043,6044,2021-09-11 15:00:00+00:00,Kent,6.0,11519,4.0,10583,,981,,,11564,12500,22102
6044,6044,6044,6044,6044,6044,6044,6044,6045,2021-09-12 15:00:00+00:00,Kent,3.0,11522,1.0,10584,,981,,,11565,12503,22106
6045,6045,6045,6045,6045,6045,6045,6045,6046,2021-09-13 15:00:00+00:00,Kent,6.0,11528,13.0,10597,1.0,982,7.0,14.0,11579,12510,22125
6046,6046,6046,6046,6046,6046,6046,6046,6047,2021-09-14 15:00:00+00:00,Kent,8.0,11536,8.0,10605,,982,,,11587,12518,22141
6047,6047,6047,6047,6047,6047,6047,6047,6048,2021-09-15 15:00:00+00:00,Kent,11.0,11547,12.0,10617,2.0,984,13.0,14.0,11601,12531,22164
6048,6048,6048,6048,6048,6048,6048,6048,6049,2021-09-16 15:00:00+00:00,Kent,23.0,11570,19.0,10636,4.0,988,27.0,23.0,11624,12558,22206
6049,6049,6049,6049,6049,6049,6049,6049,6050,2021-09-17 15:00:00+00:00,Kent,3.0,11573,14.0,10650,,988,,,11638,12561,22223
6050,6050,6050,6050,6050,6050,6050,6050,6051,2021-09-18 15:00:00+00:00,Kent,4.0,11577,5.0,10655,,988,,,11643,12565,22232
6051,6051,6051,6051,6051,6051,6051,6051,6052,2021-09-19 15:00:00+00:00,Kent,1.0,11578,5.0,10660,,988,,,11648,12566,22238
6052,6052,6052,6052,6052,6052,6052,6052,6053,2021-09-20 15:00:00+00:00,Kent,8.0,11586,16.0,10676,,988,,,11664,12574,22262
6053,6053,6053,6053,6053,6053,6053,6053,6054,2021-09-21 15:00:00+00:00,Kent,4.0,11590,7.0,10683,,988,,,11671,12578,22273
6054,6054,6054,6054,6054,6054,6054,6054,6055,2021-09-22 15:00:00+00:00,Kent,2.0,11592,16.0,10699,1.0,989,3.0,17.0,11688,12581,22291
6055,6055,6055,6055,6055,6055,6055,6055,6056,2021-09-23 15:00:00+00:00,Kent,14.0,11606,14.0,10713,5.0,994,19.0,19.0,11707,12600,22319
6056,6056,6056,6056,6056,6056,6056,6056,6057,2021-09-24 15:00:00+00:00,Kent,3.0,11609,13.0,10726,,994,,,11720,12603,22335
6057,6057,6057,6057,6057,6057,6057,6057,6058,2021-09-25 15:00:00+00:00,Kent,4.0,11613,9.0,10735,,994,,,11729,12607,22348
6058,6058,6058,6058,6058,6058,6058,6058,6059,2021-09-26 15:00:00+00:00,Kent,1.0,11614,1.0,10736,,994,,,11730,12608,22350
6059,6059,6059,6059,6059,6059,6059,6059,6060,2021-09-27 15:00:00+00:00,Kent,9.0,11623,10.0,10746,,994,,,11740,12617,22369
6060,6060,6060,6060,6060,6060,6060,6060,6061,2021-09-28 15:00:00+00:00,Kent,5.0,11628,13.0,10759,1.0,995,6.0,14.0,11754,12623,22387
6061,6061,6061,6061,6061,6061,6061,6061,6062,2021-09-29 15:00:00+00:00,Kent,5.0,11633,7.0,10766,,995,,,11761,12628,22399
6062,6062,6062,6062,6062,6062,6062,6062,6063,2021-09-30 15:00:00+00:00,Kent,9.0,11642,15.0,10781,2.0,997,11.0,17.0,11778,12639,22423
6063,6063,6063,6063,6063,6063,6063,6063,6064,2021-10-01 15:00:00+00:00,Kent,6.0,11648,2.0,10783,1.0,998,7.0,3.0,11781,12646,22431
6064,6064,6064,6064,6064,6064,6064,6064,6065,2021-10-02 15:00:00+00:00,Kent,2.0,11650,1.0,10784,,998,,,11782,12648,22434
6065,6065,6065,6065,6065,6065,6065,6065,6066,2021-10-03 15:00:00+00:00,Kent,,11650,,10784,,998,,,11782,12648,22434
6066,6066,6066,6066,6066,6066,6066,6066,6067,2021-10-04 15:00:00+00:00,Kent,6.0,11656,2.0,10786,,998,,,11784,12654,22442
6067,6067,6067,6067,6067,6067,6067,6067,6068,2021-10-05 15:00:00+00:00,Kent,5.0,11661,4.0,10790,,998,,,11788,12659,22451
6068,6068,6068,6068,6068,6068,6068,6068,6069,2021-10-06 15:00:00+00:00,Kent,6.0,11667,5.0,10795,,998,,,11793,12665,22462
6069,6069,6069,6069,6069,6069,6069,6069,6070,2021-10-07 15:00:00+00:00,Kent,16.0,11683,18.0,10813,3.0,1001,19.0,21.0,11814,12684,22496
6070,6070,6070,6070,6070,6070,6070,6070,6071,2021-10-08 15:00:00+00:00,Kent,7.0,11690,4.0,10817,,1001,,,11818,12691,22507
6071,6071,6071,6071,6071,6071,6071,6071,6072,2021-10-09 15:00:00+00:00,Kent,4.0,11694,6.0,10823,,1001,,,11824,12695,22517
6072,6072,6072,6072,6072,6072,6072,6072,6073,2021-10-10 15:00:00+00:00,Kent,3.0,11697,2.0,10825,,1001,,,11826,12698,22522
6073,6073,6073,6073,6073,6073,6073,6073,6074,2021-10-11 15:00:00+00:00,Kent,6.0,11703,8.0,10833,,1001,,,11834,12704,22536
6074,6074,6074,6074,6074,6074,6074,6074,6075,2021-10-12 15:00:00+00:00,Kent,7.0,11710,5.0,10838,,1001,,,11839,12711,22548
6075,6075,6075,6075,6075,6075,6075,6075,6076,2021-10-13 15:00:00+00:00,Kent,3.0,11713,7.0,10845,,1001,,,11846,12714,22558
6076,6076,6076,6076,6076,6076,6076,6076,6077,2021-10-14 15:00:00+00:00,Kent,15.0,11728,15.0,10860,7.0,1008,22.0,22.0,11868,12736,22588
6077,6077,6077,6077,6077,6077,6077,6077,6078,2021-10-15 15:00:00+00:00,Kent,4.0,11732,8.0,10868,,1008,,,11876,12740,22600
6078,6078,6078,6078,6078,6078,6078,6078,6079,2021-10-16 15:00:00+00:00,Kent,1.0,11733,4.0,10872,,1008,,,11880,12741,22605
6079,6079,6079,6079,6079,6079,6079,6079,6080,2021-10-17 15:00:00+00:00,Kent,,11733,,10872,,1008,,,11880,12741,22605
6080,6080,6080,6080,6080,6080,6080,6080,6081,2021-10-18 15:00:00+00:00,Kent,4.0,11737,5.0,10877,,1008,,,11885,12745,22614
6081,6081,6081,6081,6081,6081,6081,6081,6082,2021-10-19 15:00:00+00:00,Kent,6.0,11743,5.0,10882,,1008,,,11890,12751,22625
6082,6082,6082,6082,6082,6082,6082,6082,6083,2021-10-20 15:00:00+00:00,Kent,1.0,11744,3.0,10885,,1008,,,11893,12752,22629
6083,6083,6083,6083,6083,6083,6083,6083,6084,2021-10-21 15:00:00+00:00,Kent,11.0,11755,6.0,10891,1.0,1009,12.0,7.0,11900,12764,22646
6084,6084,6084,6084,6084,6084,6084,6084,6085,2021-10-22 15:00:00+00:00,Kent,8.0,11763,8.0,10899,,1009,,,11908,12772,22662
6085,6085,6085,6085,6085,6085,6085,6085,6086,2021-10-23 15:00:00+00:00,Kent,2.0,11765,4.0,10903,,1009,,,11912,12774,22668
6086,6086,6086,6086,6086,6086,6086,6086,6087,2021-10-24 15:00:00+00:00,Kent,2.0,11767,2.0,10905,,1009,,,11914,12776,22672
6087,6087,6087,6087,6087,6087,6087,6087,6088,2021-10-25 15:00:00+00:00,Kent,7.0,11774,8.0,10913,,1009,,,11922,12783,22687
6088,6088,6088,6088,6088,6088,6088,6088,6089,2021-10-26 15:00:00+00:00,Kent,11.0,11785,12.0,10925,,1009,,,11934,12794,22710
6089,6089,6089,6089,6089,6089,6089,6089,6090,2021-10-27 15:00:00+00:00,Kent,11.0,11796,8.0,10933,,1009,,,11942,12805,22729
6090,6090,6090,6090,6090,6090,6090,6090,6091,2021-10-28 15:00:00+00:00,Kent,22.0,11818,15.0,10948,2.0,1011,24.0,17.0,11959,12829,22766
6091,6091,6091,6091,6091,6091,6091,6091,6092,2021-10-29 15:00:00+00:00,Kent,8.0,11826,6.0,10954,,1011,,,11965,12837,22780
6092,6092,6092,6092,6092,6092,6092,6092,6093,2021-10-30 15:00:00+00:00,Kent,1.0,11827,4.0,10958,,1011,,,11969,12838,22785
6093,6093,6093,6093,6093,6093,6093,6093,6094,2021-10-31 15:00:00+00:00,Kent,1.0,11828,1.0,10959,,1011,,,11970,12839,22787
6094,6094,6094,6094,6094,6094,6094,6094,6095,2021-11-01 15:00:00+00:00,Kent,4.0,11832,8.0,10967,,1011,,,11978,12843,22799
6095,6095,6095,6095,6095,6095,6095,6095,6096,2021-11-02 15:00:00+00:00,Kent,8.0,11840,10.0,10977,,1011,,,11988,12851,22817
6096,6096,6096,6096,6096,6096,6096,6096,6097,2021-11-03 15:00:00+00:00,Kent,11.0,11851,9.0,10986,2.0,1013,13.0,11.0,11999,12864,22837
6097,6097,6097,6097,6097,6097,6097,6097,6098,2021-11-04 15:00:00+00:00,Kent,18.0,11869,14.0,11000,,1013,,,12013,12882,22869
6098,6098,6098,6098,6098,6098,6098,6098,6099,2021-11-05 15:00:00+00:00,Kent,5.0,11874,7.0,11007,,1013,,,12020,12887,22881
6099,6099,6099,6099,6099,6099,6099,6099,6100,2020-12-16 15:00:00+00:00,Washington,5.0,5,,0,,0,,,0,5,5
6100,6100,6100,6100,6100,6100,6100,6100,6101,2020-12-17 15:00:00+00:00,Washington,4.0,9,,0,,0,,,0,9,9
6101,6101,6101,6101,6101,6101,6101,6101,6102,2020-12-18 15:00:00+00:00,Washington,69.0,78,,0,,0,,,0,78,78
6102,6102,6102,6102,6102,6102,6102,6102,6103,2020-12-20 15:00:00+00:00,Washington,1.0,79,,0,,0,,,0,79,79
6103,6103,6103,6103,6103,6103,6103,6103,6104,2020-12-21 15:00:00+00:00,Washington,163.0,242,1.0,1,,0,,,1,242,243
6104,6104,6104,6104,6104,6104,6104,6104,6105,2020-12-22 15:00:00+00:00,Washington,223.0,465,,1,,0,,,1,465,466
6105,6105,6105,6105,6105,6105,6105,6105,6106,2020-12-23 15:00:00+00:00,Washington,96.0,561,1.0,2,,0,,,2,561,563
6106,6106,6106,6106,6106,6106,6106,6106,6107,2020-12-24 15:00:00+00:00,Washington,5.0,566,,2,,0,,,2,566,568
6107,6107,6107,6107,6107,6107,6107,6107,6108,2020-12-25 15:00:00+00:00,Washington,3.0,569,,2,,0,,,2,569,571
6108,6108,6108,6108,6108,6108,6108,6108,6109,2020-12-26 15:00:00+00:00,Washington,1.0,570,,2,,0,,,2,570,572
6109,6109,6109,6109,6109,6109,6109,6109,6110,2020-12-27 15:00:00+00:00,Washington,108.0,678,,2,,0,,,2,678,680
6110,6110,6110,6110,6110,6110,6110,6110,6111,2020-12-28 15:00:00+00:00,Washington,265.0,943,1.0,3,,0,,,3,943,946
6111,6111,6111,6111,6111,6111,6111,6111,6112,2020-12-29 15:00:00+00:00,Washington,283.0,1226,1.0,4,,0,,,4,1226,1230
6112,6112,6112,6112,6112,6112,6112,6112,6113,2020-12-30 15:00:00+00:00,Washington,293.0,1519,1.0,5,,0,,,5,1519,1524
6113,6113,6113,6113,6113,6113,6113,6113,6114,2020-12-31 15:00:00+00:00,Washington,191.0,1710,,5,,0,,,5,1710,1715
6114,6114,6114,6114,6114,6114,6114,6114,6115,2021-01-01 15:00:00+00:00,Washington,180.0,1890,,5,,0,,,5,1890,1895
6115,6115,6115,6115,6115,6115,6115,6115,6116,2021-01-02 15:00:00+00:00,Washington,20.0,1910,,5,,0,,,5,1910,1915
6116,6116,6116,6116,6116,6116,6116,6116,6117,2021-05-16 15:00:00+00:00,Garrett,17.0,9906,14.0,8507,,651,,,9158,10557,18413
6117,6117,6117,6117,6117,6117,6117,6117,6118,2021-05-17 15:00:00+00:00,Garrett,46.0,9952,37.0,8544,7.0,658,53.0,44.0,9202,10610,18496
6118,6118,6118,6118,6118,6118,6118,6118,6119,2021-05-18 15:00:00+00:00,Garrett,39.0,9991,139.0,8683,11.0,669,50.0,150.0,9352,10660,18674
6119,6119,6119,6119,6119,6119,6119,6119,6120,2021-05-19 15:00:00+00:00,Garrett,40.0,10031,22.0,8705,4.0,673,44.0,26.0,9378,10704,18736
6120,6120,6120,6120,6120,6120,6120,6120,6121,2021-05-20 15:00:00+00:00,Garrett,31.0,10062,65.0,8770,9.0,682,40.0,74.0,9452,10744,18832
6121,6121,6121,6121,6121,6121,6121,6121,6122,2021-05-21 15:00:00+00:00,Garrett,45.0,10107,76.0,8846,3.0,685,48.0,79.0,9531,10792,18953
6122,6122,6122,6122,6122,6122,6122,6122,6123,2021-05-22 15:00:00+00:00,Garrett,20.0,10127,18.0,8864,3.0,688,23.0,21.0,9552,10815,18991
6123,6123,6123,6123,6123,6123,6123,6123,6124,2021-05-23 15:00:00+00:00,Garrett,14.0,10141,8.0,8872,3.0,691,17.0,11.0,9563,10832,19013
6124,6124,6124,6124,6124,6124,6124,6124,6125,2021-05-24 15:00:00+00:00,Garrett,18.0,10159,12.0,8884,2.0,693,20.0,14.0,9577,10852,19043
6125,6125,6125,6125,6125,6125,6125,6125,6126,2021-05-25 15:00:00+00:00,Garrett,52.0,10211,57.0,8941,11.0,704,63.0,68.0,9645,10915,19152
6126,6126,6126,6126,6126,6126,6126,6126,6127,2021-05-26 15:00:00+00:00,Garrett,14.0,10225,19.0,8960,4.0,708,18.0,23.0,9668,10933,19185
6127,6127,6127,6127,6127,6127,6127,6127,6128,2021-05-27 15:00:00+00:00,Garrett,50.0,10275,49.0,9009,9.0,717,59.0,58.0,9726,10992,19284
6128,6128,6128,6128,6128,6128,6128,6128,6129,2021-05-28 15:00:00+00:00,Garrett,12.0,10287,41.0,9050,5.0,722,17.0,46.0,9772,11009,19337
6129,6129,6129,6129,6129,6129,6129,6129,6130,2021-05-29 15:00:00+00:00,Garrett,6.0,10293,34.0,9084,7.0,729,13.0,41.0,9813,11022,19377
6130,6130,6130,6130,6130,6130,6130,6130,6131,2021-05-30 15:00:00+00:00,Garrett,8.0,10301,1.0,9085,2.0,731,10.0,3.0,9816,11032,19386
6131,6131,6131,6131,6131,6131,6131,6131,6132,2021-05-31 15:00:00+00:00,Garrett,,10301,8.0,9093,1.0,732,,9.0,9825,11033,19394
6132,6132,6132,6132,6132,6132,6132,6132,6133,2021-06-01 15:00:00+00:00,Garrett,10.0,10311,29.0,9122,5.0,737,15.0,34.0,9859,11048,19433
6133,6133,6133,6133,6133,6133,6133,6133,6134,2021-06-02 15:00:00+00:00,Garrett,10.0,10321,22.0,9144,11.0,748,21.0,33.0,9892,11069,19465
6134,6134,6134,6134,6134,6134,6134,6134,6135,2021-06-03 15:00:00+00:00,Garrett,10.0,10331,41.0,9185,1.0,749,11.0,42.0,9934,11080,19516
6135,6135,6135,6135,6135,6135,6135,6135,6136,2021-06-04 15:00:00+00:00,Garrett,12.0,10343,36.0,9221,2.0,751,14.0,38.0,9972,11094,19564
6136,6136,6136,6136,6136,6136,6136,6136,6137,2021-06-05 15:00:00+00:00,Garrett,8.0,10351,27.0,9248,5.0,756,13.0,32.0,10004,11107,19599
6137,6137,6137,6137,6137,6137,6137,6137,6138,2021-06-06 15:00:00+00:00,Garrett,4.0,10355,17.0,9265,,756,,,10021,11111,19620
6138,6138,6138,6138,6138,6138,6138,6138,6139,2021-06-07 15:00:00+00:00,Garrett,12.0,10367,25.0,9290,1.0,757,13.0,26.0,10047,11124,19657
6139,6139,6139,6139,6139,6139,6139,6139,6140,2021-06-08 15:00:00+00:00,Garrett,13.0,10380,38.0,9328,1.0,758,14.0,39.0,10086,11138,19708
6140,6140,6140,6140,6140,6140,6140,6140,6141,2021-06-09 15:00:00+00:00,Garrett,7.0,10387,28.0,9356,,758,,,10114,11145,19743
6141,6141,6141,6141,6141,6141,6141,6141,6142,2021-06-10 15:00:00+00:00,Garrett,9.0,10396,14.0,9370,,758,,,10128,11154,19766
6142,6142,6142,6142,6142,6142,6142,6142,6143,2021-06-11 15:00:00+00:00,Garrett,10.0,10406,26.0,9396,1.0,759,11.0,27.0,10155,11165,19802
6143,6143,6143,6143,6143,6143,6143,6143,6144,2021-06-12 15:00:00+00:00,Garrett,2.0,10408,16.0,9412,,759,,,10171,11167,19820
6144,6144,6144,6144,6144,6144,6144,6144,6145,2021-01-03 15:00:00+00:00,Washington,105.0,2015,,5,,0,,,5,2015,2020
6145,6145,6145,6145,6145,6145,6145,6145,6146,2021-01-04 15:00:00+00:00,Washington,379.0,2394,,5,,0,,,5,2394,2399
6146,6146,6146,6146,6146,6146,6146,6146,6147,2021-01-05 15:00:00+00:00,Washington,225.0,2619,,5,,0,,,5,2619,2624
6147,6147,6147,6147,6147,6147,6147,6147,6148,2021-01-06 15:00:00+00:00,Washington,483.0,3102,4.0,9,,0,,,9,3102,3111
6148,6148,6148,6148,6148,6148,6148,6148,6149,2021-01-07 15:00:00+00:00,Washington,561.0,3663,4.0,13,,0,,,13,3663,3676
6149,6149,6149,6149,6149,6149,6149,6149,6150,2021-01-08 15:00:00+00:00,Washington,442.0,4105,70.0,83,,0,,,83,4105,4188
6150,6150,6150,6150,6150,6150,6150,6150,6151,2021-01-09 15:00:00+00:00,Washington,37.0,4142,5.0,88,,0,,,88,4142,4230
6151,6151,6151,6151,6151,6151,6151,6151,6152,2021-01-10 15:00:00+00:00,Washington,12.0,4154,3.0,91,,0,,,91,4154,4245
6152,6152,6152,6152,6152,6152,6152,6152,6153,2021-01-11 15:00:00+00:00,Washington,228.0,4382,157.0,248,,0,,,248,4382,4630
6153,6153,6153,6153,6153,6153,6153,6153,6154,2021-01-12 15:00:00+00:00,Washington,282.0,4664,200.0,448,,0,,,448,4664,5112
6154,6154,6154,6154,6154,6154,6154,6154,6155,2021-01-13 15:00:00+00:00,Washington,534.0,5198,98.0,546,,0,,,546,5198,5744
6155,6155,6155,6155,6155,6155,6155,6155,6156,2021-01-14 15:00:00+00:00,Washington,559.0,5757,17.0,563,,0,,,563,5757,6320
6156,6156,6156,6156,6156,6156,6156,6156,6157,2021-01-15 15:00:00+00:00,Washington,428.0,6185,9.0,572,,0,,,572,6185,6757
6157,6157,6157,6157,6157,6157,6157,6157,6158,2021-01-16 15:00:00+00:00,Washington,37.0,6222,6.0,578,,0,,,578,6222,6800
6158,6158,6158,6158,6158,6158,6158,6158,6159,2021-01-17 15:00:00+00:00,Washington,37.0,6259,72.0,650,,0,,,650,6259,6909
6159,6159,6159,6159,6159,6159,6159,6159,6160,2021-01-18 15:00:00+00:00,Washington,15.0,6274,243.0,893,,0,,,893,6274,7167
6160,6160,6160,6160,6160,6160,6160,6160,6161,2021-01-19 15:00:00+00:00,Washington,384.0,6658,201.0,1094,,0,,,1094,6658,7752
6161,6161,6161,6161,6161,6161,6161,6161,6162,2021-01-20 15:00:00+00:00,Washington,557.0,7215,301.0,1395,,0,,,1395,7215,8610
6162,6162,6162,6162,6162,6162,6162,6162,6163,2021-01-21 15:00:00+00:00,Washington,787.0,8002,149.0,1544,,0,,,1544,8002,9546
6163,6163,6163,6163,6163,6163,6163,6163,6164,2021-01-22 15:00:00+00:00,Washington,638.0,8640,110.0,1654,,0,,,1654,8640,10294
6164,6164,6164,6164,6164,6164,6164,6164,6165,2021-01-23 15:00:00+00:00,Washington,84.0,8724,16.0,1670,,0,,,1670,8724,10394
6165,6165,6165,6165,6165,6165,6165,6165,6166,2021-01-24 15:00:00+00:00,Washington,148.0,8872,64.0,1734,,0,,,1734,8872,10606
6166,6166,6166,6166,6166,6166,6166,6166,6167,2021-01-25 15:00:00+00:00,Washington,590.0,9462,339.0,2073,,0,,,2073,9462,11535
6167,6167,6167,6167,6167,6167,6167,6167,6168,2021-01-26 15:00:00+00:00,Washington,531.0,9993,195.0,2268,,0,,,2268,9993,12261
6168,6168,6168,6168,6168,6168,6168,6168,6169,2021-01-27 15:00:00+00:00,Washington,532.0,10525,467.0,2735,,0,,,2735,10525,13260
6169,6169,6169,6169,6169,6169,6169,6169,6170,2021-01-28 15:00:00+00:00,Washington,561.0,11086,391.0,3126,,0,,,3126,11086,14212
6170,6170,6170,6170,6170,6170,6170,6170,6171,2021-01-29 15:00:00+00:00,Washington,591.0,11677,30.0,3156,,0,,,3156,11677,14833
6171,6171,6171,6171,6171,6171,6171,6171,6172,2021-01-30 15:00:00+00:00,Washington,42.0,11719,27.0,3183,,0,,,3183,11719,14902
6172,6172,6172,6172,6172,6172,6172,6172,6173,2021-04-28 15:00:00+00:00,Somerset,54.0,7632,120.0,5733,2.0,635,56.0,122.0,6368,8267,13365
6173,6173,6173,6173,6173,6173,6173,6173,6174,2021-04-29 15:00:00+00:00,Somerset,132.0,7764,80.0,5813,,635,,,6448,8399,13577
6174,6174,6174,6174,6174,6174,6174,6174,6175,2021-04-30 15:00:00+00:00,Somerset,106.0,7870,105.0,5918,4.0,639,110.0,109.0,6557,8509,13788
6175,6175,6175,6175,6175,6175,6175,6175,6176,2021-05-01 15:00:00+00:00,Somerset,17.0,7887,4.0,5922,15.0,654,32.0,19.0,6576,8541,13809
6176,6176,6176,6176,6176,6176,6176,6176,6177,2021-05-02 15:00:00+00:00,Somerset,4.0,7891,3.0,5925,,654,,,6579,8545,13816
6177,6177,6177,6177,6177,6177,6177,6177,6178,2021-05-03 15:00:00+00:00,Somerset,115.0,8006,128.0,6053,4.0,658,119.0,132.0,6711,8664,14059
6178,6178,6178,6178,6178,6178,6178,6178,6179,2021-05-04 15:00:00+00:00,Somerset,21.0,8027,25.0,6078,5.0,663,26.0,30.0,6741,8690,14105
6179,6179,6179,6179,6179,6179,6179,6179,6180,2021-05-05 15:00:00+00:00,Somerset,126.0,8153,95.0,6173,6.0,669,132.0,101.0,6842,8822,14326
6180,6180,6180,6180,6180,6180,6180,6180,6181,2021-05-06 15:00:00+00:00,Somerset,58.0,8211,128.0,6301,4.0,673,62.0,132.0,6974,8884,14512
6181,6181,6181,6181,6181,6181,6181,6181,6182,2021-05-07 15:00:00+00:00,Somerset,100.0,8311,61.0,6362,10.0,683,110.0,71.0,7045,8994,14673
6182,6182,6182,6182,6182,6182,6182,6182,6183,2021-05-08 15:00:00+00:00,Somerset,54.0,8365,12.0,6374,1.0,684,55.0,13.0,7058,9049,14739
6183,6183,6183,6183,6183,6183,6183,6183,6184,2021-05-09 15:00:00+00:00,Somerset,2.0,8367,1.0,6375,,684,,,7059,9051,14742
6184,6184,6184,6184,6184,6184,6184,6184,6185,2021-05-10 15:00:00+00:00,Somerset,14.0,8381,27.0,6402,2.0,686,16.0,29.0,7088,9067,14783
6185,6185,6185,6185,6185,6185,6185,6185,6186,2021-05-11 15:00:00+00:00,Somerset,15.0,8396,31.0,6433,3.0,689,18.0,34.0,7122,9085,14829
6186,6186,6186,6186,6186,6186,6186,6186,6187,2021-05-12 15:00:00+00:00,Somerset,21.0,8417,91.0,6524,4.0,693,25.0,95.0,7217,9110,14941
6187,6187,6187,6187,6187,6187,6187,6187,6188,2021-05-13 15:00:00+00:00,Somerset,36.0,8453,77.0,6601,3.0,696,39.0,80.0,7297,9149,15054
6188,6188,6188,6188,6188,6188,6188,6188,6189,2021-05-14 15:00:00+00:00,Somerset,91.0,8544,199.0,6800,4.0,700,95.0,203.0,7500,9244,15344
6189,6189,6189,6189,6189,6189,6189,6189,6190,2021-05-15 15:00:00+00:00,Somerset,15.0,8559,9.0,6809,3.0,703,18.0,12.0,7512,9262,15368
6190,6190,6190,6190,6190,6190,6190,6190,6191,2021-05-16 15:00:00+00:00,Somerset,2.0,8561,3.0,6812,1.0,704,3.0,4.0,7516,9265,15373
6191,6191,6191,6191,6191,6191,6191,6191,6192,2021-05-17 15:00:00+00:00,Somerset,76.0,8637,96.0,6908,18.0,722,94.0,114.0,7630,9359,15545
6192,6192,6192,6192,6192,6192,6192,6192,6193,2021-05-18 15:00:00+00:00,Somerset,30.0,8667,20.0,6928,7.0,729,37.0,27.0,7657,9396,15595
6193,6193,6193,6193,6193,6193,6193,6193,6194,2021-05-19 15:00:00+00:00,Somerset,89.0,8756,62.0,6990,5.0,734,94.0,67.0,7724,9490,15746
6194,6194,6194,6194,6194,6194,6194,6194,6195,2021-05-20 15:00:00+00:00,Somerset,50.0,8806,129.0,7119,20.0,754,70.0,149.0,7873,9560,15925
6195,6195,6195,6195,6195,6195,6195,6195,6196,2021-05-21 15:00:00+00:00,Somerset,47.0,8853,88.0,7207,14.0,768,61.0,102.0,7975,9621,16060
6196,6196,6196,6196,6196,6196,6196,6196,6197,2021-05-22 15:00:00+00:00,Somerset,11.0,8864,6.0,7213,2.0,770,13.0,8.0,7983,9634,16077
6197,6197,6197,6197,6197,6197,6197,6197,6198,2021-05-23 15:00:00+00:00,Somerset,11.0,8875,2.0,7215,,770,,,7985,9645,16090
6198,6198,6198,6198,6198,6198,6198,6198,6199,2021-05-24 15:00:00+00:00,Somerset,31.0,8906,83.0,7298,8.0,778,39.0,91.0,8076,9684,16204
6199,6199,6199,6199,6199,6199,6199,6199,6200,2021-05-25 15:00:00+00:00,Somerset,25.0,8931,48.0,7346,11.0,789,36.0,59.0,8135,9720,16277
6200,6200,6200,6200,6200,6200,6200,6200,6201,2021-01-31 15:00:00+00:00,Washington,6.0,11725,1.0,3184,,0,,,3184,11725,14909
6201,6201,6201,6201,6201,6201,6201,6201,6202,2021-02-01 15:00:00+00:00,Washington,415.0,12140,32.0,3216,,0,,,3216,12140,15356
6202,6202,6202,6202,6202,6202,6202,6202,6203,2021-02-02 15:00:00+00:00,Washington,720.0,12860,55.0,3271,,0,,,3271,12860,16131
6203,6203,6203,6203,6203,6203,6203,6203,6204,2021-02-03 15:00:00+00:00,Washington,429.0,13289,256.0,3527,,0,,,3527,13289,16816
6204,6204,6204,6204,6204,6204,6204,6204,6205,2021-02-04 15:00:00+00:00,Washington,1209.0,14498,150.0,3677,,0,,,3677,14498,18175
6205,6205,6205,6205,6205,6205,6205,6205,6206,2021-02-05 15:00:00+00:00,Washington,952.0,15450,444.0,4121,,0,,,4121,15450,19571
6206,6206,6206,6206,6206,6206,6206,6206,6207,2021-02-06 15:00:00+00:00,Washington,12.0,15462,15.0,4136,,0,,,4136,15462,19598
6207,6207,6207,6207,6207,6207,6207,6207,6208,2021-02-07 15:00:00+00:00,Washington,17.0,15479,37.0,4173,,0,,,4173,15479,19652
6208,6208,6208,6208,6208,6208,6208,6208,6209,2021-02-08 15:00:00+00:00,Washington,756.0,16235,220.0,4393,,0,,,4393,16235,20628
6209,6209,6209,6209,6209,6209,6209,6209,6210,2021-02-09 15:00:00+00:00,Washington,377.0,16612,264.0,4657,,0,,,4657,16612,21269
6210,6210,6210,6210,6210,6210,6210,6210,6211,2021-02-10 15:00:00+00:00,Washington,513.0,17125,323.0,4980,,0,,,4980,17125,22105
6211,6211,6211,6211,6211,6211,6211,6211,6212,2021-02-11 15:00:00+00:00,Washington,482.0,17607,534.0,5514,,0,,,5514,17607,23121
6212,6212,6212,6212,6212,6212,6212,6212,6213,2021-02-12 15:00:00+00:00,Washington,374.0,17981,472.0,5986,,0,,,5986,17981,23967
6213,6213,6213,6213,6213,6213,6213,6213,6214,2021-02-13 15:00:00+00:00,Washington,28.0,18009,43.0,6029,,0,,,6029,18009,24038
6214,6214,6214,6214,6214,6214,6214,6214,6215,2021-02-14 15:00:00+00:00,Washington,40.0,18049,140.0,6169,,0,,,6169,18049,24218
6215,6215,6215,6215,6215,6215,6215,6215,6216,2021-02-15 15:00:00+00:00,Washington,249.0,18298,391.0,6560,,0,,,6560,18298,24858
6216,6216,6216,6216,6216,6216,6216,6216,6217,2021-02-16 15:00:00+00:00,Washington,387.0,18685,846.0,7406,,0,,,7406,18685,26091
6217,6217,6217,6217,6217,6217,6217,6217,6218,2021-02-17 15:00:00+00:00,Washington,202.0,18887,877.0,8283,,0,,,8283,18887,27170
6218,6218,6218,6218,6218,6218,6218,6218,6219,2021-02-18 15:00:00+00:00,Washington,15.0,18902,48.0,8331,,0,,,8331,18902,27233
6219,6219,6219,6219,6219,6219,6219,6219,6220,2021-02-19 15:00:00+00:00,Washington,41.0,18943,887.0,9218,,0,,,9218,18943,28161
6220,6220,6220,6220,6220,6220,6220,6220,6221,2021-02-20 15:00:00+00:00,Washington,30.0,18973,85.0,9303,,0,,,9303,18973,28276
6221,6221,6221,6221,6221,6221,6221,6221,6222,2021-02-21 15:00:00+00:00,Washington,17.0,18990,59.0,9362,,0,,,9362,18990,28352
6222,6222,6222,6222,6222,6222,6222,6222,6223,2021-02-22 15:00:00+00:00,Washington,41.0,19031,501.0,9863,,0,,,9863,19031,28894
6223,6223,6223,6223,6223,6223,6223,6223,6224,2021-02-23 15:00:00+00:00,Washington,130.0,19161,86.0,9949,,0,,,9949,19161,29110
6224,6224,6224,6224,6224,6224,6224,6224,6225,2021-02-24 15:00:00+00:00,Washington,326.0,19487,456.0,10405,,0,,,10405,19487,29892
6225,6225,6225,6225,6225,6225,6225,6225,6226,2021-02-25 15:00:00+00:00,Washington,401.0,19888,1437.0,11842,,0,,,11842,19888,31730
6226,6226,6226,6226,6226,6226,6226,6226,6227,2021-02-26 15:00:00+00:00,Washington,971.0,20859,613.0,12455,,0,,,12455,20859,33314
6227,6227,6227,6227,6227,6227,6227,6227,6228,2021-02-27 15:00:00+00:00,Washington,44.0,20903,9.0,12464,,0,,,12464,20903,33367
6228,6228,6228,6228,6228,6228,6228,6228,6229,2021-05-26 15:00:00+00:00,Somerset,26.0,8957,101.0,7447,4.0,793,30.0,105.0,8240,9750,16404
6229,6229,6229,6229,6229,6229,6229,6229,6230,2021-05-27 15:00:00+00:00,Somerset,62.0,9019,30.0,7477,6.0,799,68.0,36.0,8276,9818,16496
6230,6230,6230,6230,6230,6230,6230,6230,6231,2021-05-28 15:00:00+00:00,Somerset,76.0,9095,133.0,7610,15.0,814,91.0,148.0,8424,9909,16705
6231,6231,6231,6231,6231,6231,6231,6231,6232,2021-05-29 15:00:00+00:00,Somerset,7.0,9102,15.0,7625,4.0,818,11.0,19.0,8443,9920,16727
6232,6232,6232,6232,6232,6232,6232,6232,6233,2021-05-30 15:00:00+00:00,Somerset,1.0,9103,4.0,7629,,818,,,8447,9921,16732
6233,6233,6233,6233,6233,6233,6233,6233,6234,2021-05-31 15:00:00+00:00,Somerset,5.0,9108,6.0,7635,,818,,,8453,9926,16743
6234,6234,6234,6234,6234,6234,6234,6234,6235,2021-06-01 15:00:00+00:00,Somerset,23.0,9131,26.0,7661,11.0,829,34.0,37.0,8490,9960,16792
6235,6235,6235,6235,6235,6235,6235,6235,6236,2021-06-02 15:00:00+00:00,Somerset,28.0,9159,58.0,7719,1.0,830,29.0,59.0,8549,9989,16878
6236,6236,6236,6236,6236,6236,6236,6236,6237,2021-06-03 15:00:00+00:00,Somerset,20.0,9179,44.0,7763,,830,,,8593,10009,16942
6237,6237,6237,6237,6237,6237,6237,6237,6238,2021-06-04 15:00:00+00:00,Somerset,21.0,9200,48.0,7811,5.0,835,26.0,53.0,8646,10035,17011
6238,6238,6238,6238,6238,6238,6238,6238,6239,2021-06-05 15:00:00+00:00,Somerset,11.0,9211,14.0,7825,5.0,840,16.0,19.0,8665,10051,17036
6239,6239,6239,6239,6239,6239,6239,6239,6240,2021-06-06 15:00:00+00:00,Somerset,27.0,9238,2.0,7827,1.0,841,28.0,3.0,8668,10079,17065
6240,6240,6240,6240,6240,6240,6240,6240,6241,2021-06-07 15:00:00+00:00,Somerset,14.0,9252,42.0,7869,2.0,843,16.0,44.0,8712,10095,17121
6241,6241,6241,6241,6241,6241,6241,6241,6242,2021-06-08 15:00:00+00:00,Somerset,10.0,9262,25.0,7894,5.0,848,15.0,30.0,8742,10110,17156
6242,6242,6242,6242,6242,6242,6242,6242,6243,2021-06-09 15:00:00+00:00,Somerset,14.0,9276,38.0,7932,3.0,851,17.0,41.0,8783,10127,17208
6243,6243,6243,6243,6243,6243,6243,6243,6244,2021-06-10 15:00:00+00:00,Somerset,30.0,9306,32.0,7964,8.0,859,38.0,40.0,8823,10165,17270
6244,6244,6244,6244,6244,6244,6244,6244,6245,2021-06-11 15:00:00+00:00,Somerset,42.0,9348,52.0,8016,9.0,868,51.0,61.0,8884,10216,17364
6245,6245,6245,6245,6245,6245,6245,6245,6246,2021-06-12 15:00:00+00:00,Somerset,2.0,9350,11.0,8027,4.0,872,6.0,15.0,8899,10222,17377
6246,6246,6246,6246,6246,6246,6246,6246,6247,2021-06-13 15:00:00+00:00,Somerset,1.0,9351,4.0,8031,,872,,,8903,10223,17382
6247,6247,6247,6247,6247,6247,6247,6247,6248,2021-06-14 15:00:00+00:00,Somerset,10.0,9361,43.0,8074,3.0,875,13.0,46.0,8949,10236,17435
6248,6248,6248,6248,6248,6248,6248,6248,6249,2021-06-15 15:00:00+00:00,Somerset,7.0,9368,27.0,8101,1.0,876,8.0,28.0,8977,10244,17469
6249,6249,6249,6249,6249,6249,6249,6249,6250,2021-06-16 15:00:00+00:00,Somerset,6.0,9374,67.0,8168,2.0,878,8.0,69.0,9046,10252,17542
6250,6250,6250,6250,6250,6250,6250,6250,6251,2021-06-17 15:00:00+00:00,Somerset,9.0,9383,34.0,8202,1.0,879,10.0,35.0,9081,10262,17585
6251,6251,6251,6251,6251,6251,6251,6251,6252,2021-06-18 15:00:00+00:00,Somerset,14.0,9397,41.0,8243,,879,,,9122,10276,17640
6252,6252,6252,6252,6252,6252,6252,6252,6253,2021-06-19 15:00:00+00:00,Somerset,13.0,9410,9.0,8252,3.0,882,16.0,12.0,9134,10292,17662
6253,6253,6253,6253,6253,6253,6253,6253,6254,2021-06-20 15:00:00+00:00,Somerset,1.0,9411,2.0,8254,,882,,,9136,10293,17665
6254,6254,6254,6254,6254,6254,6254,6254,6255,2021-06-21 15:00:00+00:00,Somerset,20.0,9431,22.0,8276,4.0,886,24.0,26.0,9162,10317,17707
6255,6255,6255,6255,6255,6255,6255,6255,6256,2021-06-22 15:00:00+00:00,Somerset,20.0,9451,6.0,8282,,886,,,9168,10337,17733
6256,6256,6256,6256,6256,6256,6256,6256,6257,2021-03-24 15:00:00+00:00,Unknown,2277.0,81908,843.0,39189,80.0,3382,2357.0,923.0,42571,85290,121097
6257,6257,6257,6257,6257,6257,6257,6257,6258,2021-03-25 15:00:00+00:00,Unknown,2462.0,84370,841.0,40030,136.0,3518,2598.0,977.0,43548,87888,124400
6258,6258,6258,6258,6258,6258,6258,6258,6259,2021-03-26 15:00:00+00:00,Unknown,2333.0,86703,1080.0,41110,206.0,3724,2539.0,1286.0,44834,90427,127813
6259,6259,6259,6259,6259,6259,6259,6259,6260,2021-03-27 15:00:00+00:00,Unknown,1804.0,88507,728.0,41838,98.0,3822,1902.0,826.0,45660,92329,130345
6260,6260,6260,6260,6260,6260,6260,6260,6261,2021-03-28 15:00:00+00:00,Unknown,1670.0,90177,578.0,42416,67.0,3889,1737.0,645.0,46305,94066,132593
6261,6261,6261,6261,6261,6261,6261,6261,6262,2021-03-29 15:00:00+00:00,Unknown,2127.0,92304,1197.0,43613,90.0,3979,2217.0,1287.0,47592,96283,135917
6262,6262,6262,6262,6262,6262,6262,6262,6263,2021-03-30 15:00:00+00:00,Unknown,2343.0,94647,1335.0,44948,166.0,4145,2509.0,1501.0,49093,98792,139595
6263,6263,6263,6263,6263,6263,6263,6263,6264,2021-03-31 15:00:00+00:00,Unknown,2750.0,97397,1598.0,46546,335.0,4480,3085.0,1933.0,51026,101877,143943
6264,6264,6264,6264,6264,6264,6264,6264,6265,2021-04-01 15:00:00+00:00,Unknown,2521.0,99918,2085.0,48631,381.0,4861,2902.0,2466.0,53492,104779,148549
6265,6265,6265,6265,6265,6265,6265,6265,6266,2021-04-02 15:00:00+00:00,Unknown,2522.0,102440,1814.0,50445,481.0,5342,3003.0,2295.0,55787,107782,152885
6266,6266,6266,6266,6266,6266,6266,6266,6267,2021-04-03 15:00:00+00:00,Unknown,1791.0,104231,961.0,51406,275.0,5617,2066.0,1236.0,57023,109848,155637
6267,6267,6267,6267,6267,6267,6267,6267,6268,2021-04-04 15:00:00+00:00,Unknown,569.0,104800,632.0,52038,62.0,5679,631.0,694.0,57717,110479,156838
6268,6268,6268,6268,6268,6268,6268,6268,6269,2021-04-05 15:00:00+00:00,Unknown,1845.0,106645,1394.0,53432,534.0,6213,2379.0,1928.0,59645,112858,160077
6269,6269,6269,6269,6269,6269,6269,6269,6270,2021-04-06 15:00:00+00:00,Unknown,1998.0,108643,1607.0,55039,796.0,7009,2794.0,2403.0,62048,115652,163682
6270,6270,6270,6270,6270,6270,6270,6270,6271,2021-04-07 15:00:00+00:00,Unknown,1959.0,110602,1554.0,56593,1113.0,8122,3072.0,2667.0,64715,118724,167195
6271,6271,6271,6271,6271,6271,6271,6271,6272,2021-04-08 15:00:00+00:00,Unknown,2239.0,112841,1752.0,58345,917.0,9039,3156.0,2669.0,67384,121880,171186
6272,6272,6272,6272,6272,6272,6272,6272,6273,2021-04-09 15:00:00+00:00,Unknown,2151.0,114992,1784.0,60129,1279.0,10318,3430.0,3063.0,70447,125310,175121
6273,6273,6273,6273,6273,6273,6273,6273,6274,2021-04-10 15:00:00+00:00,Unknown,1723.0,116715,1298.0,61427,714.0,11032,2437.0,2012.0,72459,127747,178142
6274,6274,6274,6274,6274,6274,6274,6274,6275,2021-04-11 15:00:00+00:00,Unknown,1319.0,118034,766.0,62193,1154.0,12186,2473.0,1920.0,74379,130220,180227
6275,6275,6275,6275,6275,6275,6275,6275,6276,2021-04-12 15:00:00+00:00,Unknown,1635.0,119669,1963.0,64156,1256.0,13442,2891.0,3219.0,77598,133111,183825
6276,6276,6276,6276,6276,6276,6276,6276,6277,2021-04-13 15:00:00+00:00,Unknown,2370.0,122039,2295.0,66451,32.0,13474,2402.0,2327.0,79925,135513,188490
6277,6277,6277,6277,6277,6277,6277,6277,6278,2021-04-14 15:00:00+00:00,Unknown,2436.0,124475,1826.0,68277,8.0,13482,2444.0,1834.0,81759,137957,192752
6278,6278,6278,6278,6278,6278,6278,6278,6279,2021-04-15 15:00:00+00:00,Unknown,2227.0,126702,1910.0,70187,16.0,13498,2243.0,1926.0,83685,140200,196889
6279,6279,6279,6279,6279,6279,6279,6279,6280,2021-04-16 15:00:00+00:00,Unknown,2052.0,128754,2022.0,72209,3.0,13501,2055.0,2025.0,85710,142255,200963
6280,6280,6280,6280,6280,6280,6280,6280,6281,2021-04-17 15:00:00+00:00,Unknown,1667.0,130421,1156.0,73365,2.0,13503,1669.0,1158.0,86868,143924,203786
6281,6281,6281,6281,6281,6281,6281,6281,6282,2021-04-18 15:00:00+00:00,Unknown,1223.0,131644,999.0,74364,1.0,13504,1224.0,1000.0,87868,145148,206008
6282,6282,6282,6282,6282,6282,6282,6282,6283,2021-04-19 15:00:00+00:00,Unknown,1397.0,133041,1780.0,76144,6.0,13510,1403.0,1786.0,89654,146551,209185
6283,6283,6283,6283,6283,6283,6283,6283,6284,2021-04-20 15:00:00+00:00,Unknown,1432.0,134473,2336.0,78480,3.0,13513,1435.0,2339.0,91993,147986,212953
6284,6284,6284,6284,6284,6284,6284,6284,6285,2021-02-28 15:00:00+00:00,Washington,55.0,20958,19.0,12483,,0,,,12483,20958,33441
6285,6285,6285,6285,6285,6285,6285,6285,6286,2021-03-01 15:00:00+00:00,Washington,404.0,21362,549.0,13032,,0,,,13032,21362,34394
6286,6286,6286,6286,6286,6286,6286,6286,6287,2021-03-02 15:00:00+00:00,Washington,376.0,21738,1010.0,14042,,0,,,14042,21738,35780
6287,6287,6287,6287,6287,6287,6287,6287,6288,2021-03-03 15:00:00+00:00,Washington,337.0,22075,506.0,14548,31.0,31,368.0,537.0,14579,22106,36623
6288,6288,6288,6288,6288,6288,6288,6288,6289,2021-03-04 15:00:00+00:00,Washington,551.0,22626,991.0,15539,181.0,212,732.0,1172.0,15751,22838,38165
6289,6289,6289,6289,6289,6289,6289,6289,6290,2021-03-05 15:00:00+00:00,Washington,659.0,23285,762.0,16301,78.0,290,737.0,840.0,16591,23575,39586
6290,6290,6290,6290,6290,6290,6290,6290,6291,2021-03-06 15:00:00+00:00,Washington,76.0,23361,7.0,16308,28.0,318,104.0,35.0,16626,23679,39669
6291,6291,6291,6291,6291,6291,6291,6291,6292,2021-03-07 15:00:00+00:00,Washington,50.0,23411,7.0,16315,20.0,338,70.0,27.0,16653,23749,39726
6292,6292,6292,6292,6292,6292,6292,6292,6293,2021-03-08 15:00:00+00:00,Washington,433.0,23844,277.0,16592,19.0,357,452.0,296.0,16949,24201,40436
6293,6293,6293,6293,6293,6293,6293,6293,6294,2021-03-09 15:00:00+00:00,Washington,801.0,24645,203.0,16795,27.0,384,828.0,230.0,17179,25029,41440
6294,6294,6294,6294,6294,6294,6294,6294,6295,2021-03-10 15:00:00+00:00,Washington,646.0,25291,185.0,16980,37.0,421,683.0,222.0,17401,25712,42271
6295,6295,6295,6295,6295,6295,6295,6295,6296,2021-03-11 15:00:00+00:00,Washington,887.0,26178,246.0,17226,51.0,472,938.0,297.0,17698,26650,43404
6296,6296,6296,6296,6296,6296,6296,6296,6297,2021-03-12 15:00:00+00:00,Washington,605.0,26783,166.0,17392,127.0,599,732.0,293.0,17991,27382,44175
6297,6297,6297,6297,6297,6297,6297,6297,6298,2021-03-13 15:00:00+00:00,Washington,265.0,27048,29.0,17421,51.0,650,316.0,80.0,18071,27698,44469
6298,6298,6298,6298,6298,6298,6298,6298,6299,2021-03-14 15:00:00+00:00,Washington,74.0,27122,24.0,17445,8.0,658,82.0,32.0,18103,27780,44567
6299,6299,6299,6299,6299,6299,6299,6299,6300,2021-03-15 15:00:00+00:00,Washington,539.0,27661,175.0,17620,6.0,664,545.0,181.0,18284,28325,45281
6300,6300,6300,6300,6300,6300,6300,6300,6301,2021-03-16 15:00:00+00:00,Washington,494.0,28155,211.0,17831,4.0,668,498.0,215.0,18499,28823,45986
6301,6301,6301,6301,6301,6301,6301,6301,6302,2021-03-17 15:00:00+00:00,Washington,365.0,28520,390.0,18221,8.0,676,373.0,398.0,18897,29196,46741
6302,6302,6302,6302,6302,6302,6302,6302,6303,2021-03-18 15:00:00+00:00,Washington,409.0,28929,80.0,18301,24.0,700,433.0,104.0,19001,29629,47230
6303,6303,6303,6303,6303,6303,6303,6303,6304,2021-03-19 15:00:00+00:00,Washington,430.0,29359,877.0,19178,15.0,715,445.0,892.0,19893,30074,48537
6304,6304,6304,6304,6304,6304,6304,6304,6305,2021-03-20 15:00:00+00:00,Washington,92.0,29451,24.0,19202,6.0,721,98.0,30.0,19923,30172,48653
6305,6305,6305,6305,6305,6305,6305,6305,6306,2021-03-21 15:00:00+00:00,Washington,98.0,29549,22.0,19224,1.0,722,99.0,23.0,19946,30271,48773
6306,6306,6306,6306,6306,6306,6306,6306,6307,2021-03-22 15:00:00+00:00,Washington,537.0,30086,190.0,19414,21.0,743,558.0,211.0,20157,30829,49500
6307,6307,6307,6307,6307,6307,6307,6307,6308,2021-03-23 15:00:00+00:00,Washington,594.0,30680,289.0,19703,22.0,765,616.0,311.0,20468,31445,50383
6308,6308,6308,6308,6308,6308,6308,6308,6309,2021-03-24 15:00:00+00:00,Washington,381.0,31061,240.0,19943,20.0,785,401.0,260.0,20728,31846,51004
6309,6309,6309,6309,6309,6309,6309,6309,6310,2021-03-25 15:00:00+00:00,Washington,298.0,31359,399.0,20342,198.0,983,496.0,597.0,21325,32342,51701
6310,6310,6310,6310,6310,6310,6310,6310,6311,2021-03-26 15:00:00+00:00,Washington,349.0,31708,108.0,20450,222.0,1205,571.0,330.0,21655,32913,52158
6311,6311,6311,6311,6311,6311,6311,6311,6312,2021-03-27 15:00:00+00:00,Washington,83.0,31791,53.0,20503,181.0,1386,264.0,234.0,21889,33177,52294
6312,6312,6312,6312,6312,6312,6312,6312,6313,2021-06-23 15:00:00+00:00,Somerset,11.0,9462,32.0,8314,4.0,890,15.0,36.0,9204,10352,17776
6313,6313,6313,6313,6313,6313,6313,6313,6314,2021-06-24 15:00:00+00:00,Somerset,14.0,9476,22.0,8336,1.0,891,15.0,23.0,9227,10367,17812
6314,6314,6314,6314,6314,6314,6314,6314,6315,2021-06-25 15:00:00+00:00,Somerset,10.0,9486,20.0,8356,8.0,899,18.0,28.0,9255,10385,17842
6315,6315,6315,6315,6315,6315,6315,6315,6316,2021-06-26 15:00:00+00:00,Somerset,2.0,9488,4.0,8360,2.0,901,4.0,6.0,9261,10389,17848
6316,6316,6316,6316,6316,6316,6316,6316,6317,2021-06-27 15:00:00+00:00,Somerset,2.0,9490,23.0,8383,1.0,902,3.0,24.0,9285,10392,17873
6317,6317,6317,6317,6317,6317,6317,6317,6318,2021-06-28 15:00:00+00:00,Somerset,10.0,9500,61.0,8444,1.0,903,11.0,62.0,9347,10403,17944
6318,6318,6318,6318,6318,6318,6318,6318,6319,2021-06-29 15:00:00+00:00,Somerset,19.0,9519,14.0,8458,1.0,904,20.0,15.0,9362,10423,17977
6319,6319,6319,6319,6319,6319,6319,6319,6320,2021-06-30 15:00:00+00:00,Somerset,18.0,9537,27.0,8485,2.0,906,20.0,29.0,9391,10443,18022
6320,6320,6320,6320,6320,6320,6320,6320,6321,2021-07-01 15:00:00+00:00,Somerset,5.0,9542,18.0,8503,2.0,908,7.0,20.0,9411,10450,18045
6321,6321,6321,6321,6321,6321,6321,6321,6322,2021-07-02 15:00:00+00:00,Somerset,9.0,9551,12.0,8515,2.0,910,11.0,14.0,9425,10461,18066
6322,6322,6322,6322,6322,6322,6322,6322,6323,2021-07-03 15:00:00+00:00,Somerset,2.0,9553,,8515,,910,,,9425,10463,18068
6323,6323,6323,6323,6323,6323,6323,6323,6324,2021-07-04 15:00:00+00:00,Somerset,1.0,9554,,8515,,910,,,9425,10464,18069
6324,6324,6324,6324,6324,6324,6324,6324,6325,2021-07-05 15:00:00+00:00,Somerset,6.0,9560,3.0,8518,,910,,,9428,10470,18078
6325,6325,6325,6325,6325,6325,6325,6325,6326,2021-07-06 15:00:00+00:00,Somerset,21.0,9581,28.0,8546,,910,,,9456,10491,18127
6326,6326,6326,6326,6326,6326,6326,6326,6327,2021-07-07 15:00:00+00:00,Somerset,17.0,9598,11.0,8557,3.0,913,20.0,14.0,9470,10511,18155
6327,6327,6327,6327,6327,6327,6327,6327,6328,2021-07-08 15:00:00+00:00,Somerset,11.0,9609,40.0,8597,2.0,915,13.0,42.0,9512,10524,18206
6328,6328,6328,6328,6328,6328,6328,6328,6329,2021-07-09 15:00:00+00:00,Somerset,16.0,9625,23.0,8620,3.0,918,19.0,26.0,9538,10543,18245
6329,6329,6329,6329,6329,6329,6329,6329,6330,2021-07-10 15:00:00+00:00,Somerset,3.0,9628,9.0,8629,,918,,,9547,10546,18257
6330,6330,6330,6330,6330,6330,6330,6330,6331,2021-07-11 15:00:00+00:00,Somerset,2.0,9630,1.0,8630,,918,,,9548,10548,18260
6331,6331,6331,6331,6331,6331,6331,6331,6332,2021-07-12 15:00:00+00:00,Somerset,30.0,9660,15.0,8645,2.0,920,32.0,17.0,9565,10580,18305
6332,6332,6332,6332,6332,6332,6332,6332,6333,2021-07-13 15:00:00+00:00,Somerset,23.0,9683,20.0,8665,2.0,922,25.0,22.0,9587,10605,18348
6333,6333,6333,6333,6333,6333,6333,6333,6334,2021-07-14 15:00:00+00:00,Somerset,18.0,9701,13.0,8678,3.0,925,21.0,16.0,9603,10626,18379
6334,6334,6334,6334,6334,6334,6334,6334,6335,2021-07-15 15:00:00+00:00,Somerset,10.0,9711,9.0,8687,4.0,929,14.0,13.0,9616,10640,18398
6335,6335,6335,6335,6335,6335,6335,6335,6336,2021-07-16 15:00:00+00:00,Somerset,21.0,9732,11.0,8698,2.0,931,23.0,13.0,9629,10663,18430
6336,6336,6336,6336,6336,6336,6336,6336,6337,2021-07-17 15:00:00+00:00,Somerset,1.0,9733,5.0,8703,,931,,,9634,10664,18436
6337,6337,6337,6337,6337,6337,6337,6337,6338,2021-07-18 15:00:00+00:00,Somerset,3.0,9736,2.0,8705,,931,,,9636,10667,18441
6338,6338,6338,6338,6338,6338,6338,6338,6339,2021-07-19 15:00:00+00:00,Somerset,17.0,9753,12.0,8717,4.0,935,21.0,16.0,9652,10688,18470
6339,6339,6339,6339,6339,6339,6339,6339,6340,2021-07-20 15:00:00+00:00,Somerset,11.0,9764,20.0,8737,1.0,936,12.0,21.0,9673,10700,18501
6340,6340,6340,6340,6340,6340,6340,6340,6341,2021-06-13 15:00:00+00:00,Garrett,3.0,10411,8.0,9420,,759,,,10179,11170,19831
6341,6341,6341,6341,6341,6341,6341,6341,6342,2021-06-14 15:00:00+00:00,Garrett,8.0,10419,33.0,9453,,759,,,10212,11178,19872
6342,6342,6342,6342,6342,6342,6342,6342,6343,2021-06-15 15:00:00+00:00,Garrett,4.0,10423,38.0,9491,2.0,761,6.0,40.0,10252,11184,19914
6343,6343,6343,6343,6343,6343,6343,6343,6344,2021-06-16 15:00:00+00:00,Garrett,4.0,10427,33.0,9524,4.0,765,8.0,37.0,10289,11192,19951
6344,6344,6344,6344,6344,6344,6344,6344,6345,2021-06-17 15:00:00+00:00,Garrett,4.0,10431,47.0,9571,1.0,766,5.0,48.0,10337,11197,20002
6345,6345,6345,6345,6345,6345,6345,6345,6346,2021-06-18 15:00:00+00:00,Garrett,18.0,10449,32.0,9603,6.0,772,24.0,38.0,10375,11221,20052
6346,6346,6346,6346,6346,6346,6346,6346,6347,2021-06-19 15:00:00+00:00,Garrett,2.0,10451,18.0,9621,,772,,,10393,11223,20072
6347,6347,6347,6347,6347,6347,6347,6347,6348,2021-06-20 15:00:00+00:00,Garrett,4.0,10455,9.0,9630,2.0,774,6.0,11.0,10404,11229,20085
6348,6348,6348,6348,6348,6348,6348,6348,6349,2021-06-21 15:00:00+00:00,Garrett,4.0,10459,10.0,9640,2.0,776,6.0,12.0,10416,11235,20099
6349,6349,6349,6349,6349,6349,6349,6349,6350,2021-06-22 15:00:00+00:00,Garrett,8.0,10467,17.0,9657,2.0,778,10.0,19.0,10435,11245,20124
6350,6350,6350,6350,6350,6350,6350,6350,6351,2021-06-23 15:00:00+00:00,Garrett,1.0,10468,6.0,9663,3.0,781,4.0,9.0,10444,11249,20131
6351,6351,6351,6351,6351,6351,6351,6351,6352,2021-06-24 15:00:00+00:00,Garrett,5.0,10473,12.0,9675,3.0,784,8.0,15.0,10459,11257,20148
6352,6352,6352,6352,6352,6352,6352,6352,6353,2021-06-25 15:00:00+00:00,Garrett,12.0,10485,21.0,9696,3.0,787,15.0,24.0,10483,11272,20181
6353,6353,6353,6353,6353,6353,6353,6353,6354,2021-06-26 15:00:00+00:00,Garrett,1.0,10486,1.0,9697,,787,,,10484,11273,20183
6354,6354,6354,6354,6354,6354,6354,6354,6355,2021-06-27 15:00:00+00:00,Garrett,3.0,10489,6.0,9703,1.0,788,4.0,7.0,10491,11277,20192
6355,6355,6355,6355,6355,6355,6355,6355,6356,2021-06-28 15:00:00+00:00,Garrett,7.0,10496,4.0,9707,,788,,,10495,11284,20203
6356,6356,6356,6356,6356,6356,6356,6356,6357,2021-06-29 15:00:00+00:00,Garrett,4.0,10500,22.0,9729,3.0,791,7.0,25.0,10520,11291,20229
6357,6357,6357,6357,6357,6357,6357,6357,6358,2021-06-30 15:00:00+00:00,Garrett,9.0,10509,7.0,9736,,791,,,10527,11300,20245
6358,6358,6358,6358,6358,6358,6358,6358,6359,2021-07-01 15:00:00+00:00,Garrett,3.0,10512,7.0,9743,,791,,,10534,11303,20255
6359,6359,6359,6359,6359,6359,6359,6359,6360,2021-07-02 15:00:00+00:00,Garrett,15.0,10527,14.0,9757,5.0,796,20.0,19.0,10553,11323,20284
6360,6360,6360,6360,6360,6360,6360,6360,6361,2021-07-03 15:00:00+00:00,Garrett,,10527,5.0,9762,,796,,,10558,11323,20289
6361,6361,6361,6361,6361,6361,6361,6361,6362,2021-07-04 15:00:00+00:00,Garrett,1.0,10528,1.0,9763,,796,,,10559,11324,20291
6362,6362,6362,6362,6362,6362,6362,6362,6363,2021-07-05 15:00:00+00:00,Garrett,2.0,10530,5.0,9768,,796,,,10564,11326,20298
6363,6363,6363,6363,6363,6363,6363,6363,6364,2021-07-06 15:00:00+00:00,Garrett,6.0,10536,12.0,9780,2.0,798,8.0,14.0,10578,11334,20316
6364,6364,6364,6364,6364,6364,6364,6364,6365,2021-07-07 15:00:00+00:00,Garrett,6.0,10542,9.0,9789,1.0,799,7.0,10.0,10588,11341,20331
6365,6365,6365,6365,6365,6365,6365,6365,6366,2021-07-08 15:00:00+00:00,Garrett,8.0,10550,5.0,9794,2.0,801,10.0,7.0,10595,11351,20344
6366,6366,6366,6366,6366,6366,6366,6366,6367,2021-07-09 15:00:00+00:00,Garrett,16.0,10566,14.0,9808,4.0,805,20.0,18.0,10613,11371,20374
6367,6367,6367,6367,6367,6367,6367,6367,6368,2021-07-10 15:00:00+00:00,Garrett,3.0,10569,3.0,9811,,805,,,10616,11374,20380
6368,6368,6368,6368,6368,6368,6368,6368,6369,2021-03-28 15:00:00+00:00,Washington,98.0,31889,62.0,20565,193.0,1579,291.0,255.0,22144,33468,52454
6369,6369,6369,6369,6369,6369,6369,6369,6370,2021-03-29 15:00:00+00:00,Washington,465.0,32354,240.0,20805,15.0,1594,480.0,255.0,22399,33948,53159
6370,6370,6370,6370,6370,6370,6370,6370,6371,2021-03-30 15:00:00+00:00,Washington,973.0,33327,820.0,21625,56.0,1650,1029.0,876.0,23275,34977,54952
6371,6371,6371,6371,6371,6371,6371,6371,6372,2021-03-31 15:00:00+00:00,Washington,445.0,33772,545.0,22170,334.0,1984,779.0,879.0,24154,35756,55942
6372,6372,6372,6372,6372,6372,6372,6372,6373,2021-04-01 15:00:00+00:00,Washington,769.0,34541,1188.0,23358,447.0,2431,1216.0,1635.0,25789,36972,57899
6373,6373,6373,6373,6373,6373,6373,6373,6374,2021-04-02 15:00:00+00:00,Washington,456.0,34997,1065.0,24423,525.0,2956,981.0,1590.0,27379,37953,59420
6374,6374,6374,6374,6374,6374,6374,6374,6375,2021-04-03 15:00:00+00:00,Washington,91.0,35088,68.0,24491,466.0,3422,557.0,534.0,27913,38510,59579
6375,6375,6375,6375,6375,6375,6375,6375,6376,2021-04-04 15:00:00+00:00,Washington,65.0,35153,45.0,24536,1.0,3423,66.0,46.0,27959,38576,59689
6376,6376,6376,6376,6376,6376,6376,6376,6377,2021-04-05 15:00:00+00:00,Washington,445.0,35598,452.0,24988,517.0,3940,962.0,969.0,28928,39538,60586
6377,6377,6377,6377,6377,6377,6377,6377,6378,2021-04-06 15:00:00+00:00,Washington,310.0,35908,434.0,25422,753.0,4693,1063.0,1187.0,30115,40601,61330
6378,6378,6378,6378,6378,6378,6378,6378,6379,2021-04-07 15:00:00+00:00,Washington,324.0,36232,396.0,25818,1422.0,6115,1746.0,1818.0,31933,42347,62050
6379,6379,6379,6379,6379,6379,6379,6379,6380,2021-04-08 15:00:00+00:00,Washington,350.0,36582,419.0,26237,830.0,6945,1180.0,1249.0,33182,43527,62819
6380,6380,6380,6380,6380,6380,6380,6380,6381,2021-04-09 15:00:00+00:00,Washington,425.0,37007,363.0,26600,697.0,7642,1122.0,1060.0,34242,44649,63607
6381,6381,6381,6381,6381,6381,6381,6381,6382,2021-04-10 15:00:00+00:00,Washington,95.0,37102,260.0,26860,388.0,8030,483.0,648.0,34890,45132,63962
6382,6382,6382,6382,6382,6382,6382,6382,6383,2021-04-11 15:00:00+00:00,Washington,70.0,37172,73.0,26933,184.0,8214,254.0,257.0,35147,45386,64105
6383,6383,6383,6383,6383,6383,6383,6383,6384,2021-04-12 15:00:00+00:00,Washington,541.0,37713,838.0,27771,283.0,8497,824.0,1121.0,36268,46210,65484
6384,6384,6384,6384,6384,6384,6384,6384,6385,2021-04-13 15:00:00+00:00,Washington,662.0,38375,378.0,28149,1.0,8498,663.0,379.0,36647,46873,66524
6385,6385,6385,6385,6385,6385,6385,6385,6386,2021-04-14 15:00:00+00:00,Washington,742.0,39117,388.0,28537,,8498,,,37035,47615,67654
6386,6386,6386,6386,6386,6386,6386,6386,6387,2021-04-15 15:00:00+00:00,Washington,1082.0,40199,367.0,28904,,8498,,,37402,48697,69103
6387,6387,6387,6387,6387,6387,6387,6387,6388,2021-04-16 15:00:00+00:00,Washington,553.0,40752,439.0,29343,,8498,,,37841,49250,70095
6388,6388,6388,6388,6388,6388,6388,6388,6389,2021-04-17 15:00:00+00:00,Washington,177.0,40929,51.0,29394,,8498,,,37892,49427,70323
6389,6389,6389,6389,6389,6389,6389,6389,6390,2021-04-18 15:00:00+00:00,Washington,146.0,41075,56.0,29450,,8498,,,37948,49573,70525
6390,6390,6390,6390,6390,6390,6390,6390,6391,2021-04-19 15:00:00+00:00,Washington,298.0,41373,501.0,29951,1.0,8499,299.0,502.0,38450,49872,71324
6391,6391,6391,6391,6391,6391,6391,6391,6392,2021-04-20 15:00:00+00:00,Washington,484.0,41857,474.0,30425,,8499,,,38924,50356,72282
6392,6392,6392,6392,6392,6392,6392,6392,6393,2021-04-21 15:00:00+00:00,Washington,397.0,42254,425.0,30850,,8499,,,39349,50753,73104
6393,6393,6393,6393,6393,6393,6393,6393,6394,2021-04-22 15:00:00+00:00,Washington,616.0,42870,654.0,31504,,8499,,,40003,51369,74374
6394,6394,6394,6394,6394,6394,6394,6394,6395,2021-04-23 15:00:00+00:00,Washington,458.0,43328,343.0,31847,1.0,8500,459.0,344.0,40347,51828,75175
6395,6395,6395,6395,6395,6395,6395,6395,6396,2021-04-24 15:00:00+00:00,Washington,246.0,43574,93.0,31940,2.0,8502,248.0,95.0,40442,52076,75514
6396,6396,6396,6396,6396,6396,6396,6396,6397,2021-07-21 15:00:00+00:00,Somerset,20.0,9784,10.0,8747,3.0,939,23.0,13.0,9686,10723,18531
6397,6397,6397,6397,6397,6397,6397,6397,6398,2021-07-22 15:00:00+00:00,Somerset,15.0,9799,9.0,8756,2.0,941,17.0,11.0,9697,10740,18555
6398,6398,6398,6398,6398,6398,6398,6398,6399,2021-07-23 15:00:00+00:00,Somerset,28.0,9827,14.0,8770,,941,,,9711,10768,18597
6399,6399,6399,6399,6399,6399,6399,6399,6400,2021-07-24 15:00:00+00:00,Somerset,4.0,9831,2.0,8772,,941,,,9713,10772,18603
6400,6400,6400,6400,6400,6400,6400,6400,6401,2021-07-25 15:00:00+00:00,Somerset,8.0,9839,1.0,8773,16.0,957,24.0,17.0,9730,10796,18612
6401,6401,6401,6401,6401,6401,6401,6401,6402,2021-07-26 15:00:00+00:00,Somerset,18.0,9857,15.0,8788,3.0,960,21.0,18.0,9748,10817,18645
6402,6402,6402,6402,6402,6402,6402,6402,6403,2021-07-27 15:00:00+00:00,Somerset,31.0,9888,14.0,8802,3.0,963,34.0,17.0,9765,10851,18690
6403,6403,6403,6403,6403,6403,6403,6403,6404,2021-07-28 15:00:00+00:00,Somerset,45.0,9933,13.0,8815,4.0,967,49.0,17.0,9782,10900,18748
6404,6404,6404,6404,6404,6404,6404,6404,6405,2021-07-29 15:00:00+00:00,Somerset,17.0,9950,9.0,8824,5.0,972,22.0,14.0,9796,10922,18774
6405,6405,6405,6405,6405,6405,6405,6405,6406,2021-07-30 15:00:00+00:00,Somerset,25.0,9975,11.0,8835,3.0,975,28.0,14.0,9810,10950,18810
6406,6406,6406,6406,6406,6406,6406,6406,6407,2021-07-31 15:00:00+00:00,Somerset,5.0,9980,2.0,8837,,975,,,9812,10955,18817
6407,6407,6407,6407,6407,6407,6407,6407,6408,2021-08-01 15:00:00+00:00,Somerset,1.0,9981,1.0,8838,,975,,,9813,10956,18819
6408,6408,6408,6408,6408,6408,6408,6408,6409,2021-08-02 15:00:00+00:00,Somerset,36.0,10017,11.0,8849,3.0,978,39.0,14.0,9827,10995,18866
6409,6409,6409,6409,6409,6409,6409,6409,6410,2021-08-03 15:00:00+00:00,Somerset,33.0,10050,15.0,8864,9.0,987,42.0,24.0,9851,11037,18914
6410,6410,6410,6410,6410,6410,6410,6410,6411,2021-08-04 15:00:00+00:00,Somerset,35.0,10085,12.0,8876,4.0,991,39.0,16.0,9867,11076,18961
6411,6411,6411,6411,6411,6411,6411,6411,6412,2021-08-05 15:00:00+00:00,Somerset,31.0,10116,10.0,8886,5.0,996,36.0,15.0,9882,11112,19002
6412,6412,6412,6412,6412,6412,6412,6412,6413,2021-08-06 15:00:00+00:00,Somerset,39.0,10155,22.0,8908,1.0,997,40.0,23.0,9905,11152,19063
6413,6413,6413,6413,6413,6413,6413,6413,6414,2021-08-07 15:00:00+00:00,Somerset,11.0,10166,1.0,8909,2.0,999,13.0,3.0,9908,11165,19075
6414,6414,6414,6414,6414,6414,6414,6414,6415,2021-08-08 15:00:00+00:00,Somerset,10.0,10176,3.0,8912,1.0,1000,11.0,4.0,9912,11176,19088
6415,6415,6415,6415,6415,6415,6415,6415,6416,2021-08-09 15:00:00+00:00,Somerset,27.0,10203,25.0,8937,2.0,1002,29.0,27.0,9939,11205,19140
6416,6416,6416,6416,6416,6416,6416,6416,6417,2021-08-10 15:00:00+00:00,Somerset,16.0,10219,6.0,8943,1.0,1003,17.0,7.0,9946,11222,19162
6417,6417,6417,6417,6417,6417,6417,6417,6418,2021-08-11 15:00:00+00:00,Somerset,33.0,10252,7.0,8950,15.0,1018,48.0,22.0,9968,11270,19202
6418,6418,6418,6418,6418,6418,6418,6418,6419,2021-08-12 15:00:00+00:00,Somerset,16.0,10268,13.0,8963,7.0,1025,23.0,20.0,9988,11293,19231
6419,6419,6419,6419,6419,6419,6419,6419,6420,2021-08-13 15:00:00+00:00,Somerset,16.0,10284,39.0,9002,,1025,,,10027,11309,19286
6420,6420,6420,6420,6420,6420,6420,6420,6421,2021-08-14 15:00:00+00:00,Somerset,9.0,10293,,9002,,1025,,,10027,11318,19295
6421,6421,6421,6421,6421,6421,6421,6421,6422,2021-08-15 15:00:00+00:00,Somerset,8.0,10301,2.0,9004,1.0,1026,9.0,3.0,10030,11327,19305
6422,6422,6422,6422,6422,6422,6422,6422,6423,2021-08-16 15:00:00+00:00,Somerset,19.0,10320,13.0,9017,2.0,1028,21.0,15.0,10045,11348,19337
6423,6423,6423,6423,6423,6423,6423,6423,6424,2021-08-17 15:00:00+00:00,Somerset,32.0,10352,23.0,9040,4.0,1032,36.0,27.0,10072,11384,19392
6424,6424,6424,6424,6424,6424,6424,6424,6425,2021-04-21 15:00:00+00:00,Unknown,1717.0,136190,2750.0,81230,1.0,13514,1718.0,2751.0,94744,149704,217420
6425,6425,6425,6425,6425,6425,6425,6425,6426,2021-04-22 15:00:00+00:00,Unknown,1667.0,137857,2303.0,83533,,13514,,,97047,151371,221390
6426,6426,6426,6426,6426,6426,6426,6426,6427,2021-04-23 15:00:00+00:00,Unknown,1585.0,139442,2381.0,85914,1.0,13515,1586.0,2382.0,99429,152957,225356
6427,6427,6427,6427,6427,6427,6427,6427,6428,2021-04-24 15:00:00+00:00,Unknown,1594.0,141036,1941.0,87855,5.0,13520,1599.0,1946.0,101375,154556,228891
6428,6428,6428,6428,6428,6428,6428,6428,6429,2021-04-25 15:00:00+00:00,Unknown,988.0,142024,682.0,88537,1.0,13521,989.0,683.0,102058,155545,230561
6429,6429,6429,6429,6429,6429,6429,6429,6430,2021-04-26 15:00:00+00:00,Unknown,1499.0,143523,1726.0,90263,8.0,13529,1507.0,1734.0,103792,157052,233786
6430,6430,6430,6430,6430,6430,6430,6430,6431,2021-04-27 15:00:00+00:00,Unknown,1261.0,144784,1603.0,91866,81.0,13610,1342.0,1684.0,105476,158394,236650
6431,6431,6431,6431,6431,6431,6431,6431,6432,2021-04-28 15:00:00+00:00,Unknown,1327.0,146111,1957.0,93823,102.0,13712,1429.0,2059.0,107535,159823,239934
6432,6432,6432,6432,6432,6432,6432,6432,6433,2021-04-29 15:00:00+00:00,Unknown,1318.0,147429,2191.0,96014,122.0,13834,1440.0,2313.0,109848,161263,243443
6433,6433,6433,6433,6433,6433,6433,6433,6434,2021-04-30 15:00:00+00:00,Unknown,1262.0,148691,1982.0,97996,126.0,13960,1388.0,2108.0,111956,162651,246687
6434,6434,6434,6434,6434,6434,6434,6434,6435,2021-05-01 15:00:00+00:00,Unknown,1007.0,149698,1590.0,99586,83.0,14043,1090.0,1673.0,113629,163741,249284
6435,6435,6435,6435,6435,6435,6435,6435,6436,2021-05-02 15:00:00+00:00,Unknown,414.0,150112,972.0,100558,71.0,14114,485.0,1043.0,114672,164226,250670
6436,6436,6436,6436,6436,6436,6436,6436,6437,2021-05-03 15:00:00+00:00,Unknown,726.0,150838,1383.0,101941,98.0,14212,824.0,1481.0,116153,165050,252779
6437,6437,6437,6437,6437,6437,6437,6437,6438,2021-05-04 15:00:00+00:00,Unknown,692.0,151530,1907.0,103848,131.0,14343,823.0,2038.0,118191,165873,255378
6438,6438,6438,6438,6438,6438,6438,6438,6439,2021-05-05 15:00:00+00:00,Unknown,870.0,152400,1910.0,105758,143.0,14486,1013.0,2053.0,120244,166886,258158
6439,6439,6439,6439,6439,6439,6439,6439,6440,2021-05-06 15:00:00+00:00,Unknown,809.0,153209,1812.0,107570,123.0,14609,932.0,1935.0,122179,167818,260779
6440,6440,6440,6440,6440,6440,6440,6440,6441,2021-05-07 15:00:00+00:00,Unknown,828.0,154037,1606.0,109176,129.0,14738,957.0,1735.0,123914,168775,263213
6441,6441,6441,6441,6441,6441,6441,6441,6442,2021-05-08 15:00:00+00:00,Unknown,572.0,154609,1246.0,110422,129.0,14867,701.0,1375.0,125289,169476,265031
6442,6442,6442,6442,6442,6442,6442,6442,6443,2021-05-09 15:00:00+00:00,Unknown,278.0,154887,638.0,111060,40.0,14907,318.0,678.0,125967,169794,265947
6443,6443,6443,6443,6443,6443,6443,6443,6444,2021-05-10 15:00:00+00:00,Unknown,506.0,155393,1147.0,112207,89.0,14996,595.0,1236.0,127203,170389,267600
6444,6444,6444,6444,6444,6444,6444,6444,6445,2021-05-11 15:00:00+00:00,Unknown,839.0,156232,1136.0,113343,91.0,15087,930.0,1227.0,128430,171319,269575
6445,6445,6445,6445,6445,6445,6445,6445,6446,2021-05-12 15:00:00+00:00,Unknown,620.0,156852,1257.0,114600,164.0,15251,784.0,1421.0,129851,172103,271452
6446,6446,6446,6446,6446,6446,6446,6446,6447,2021-05-13 15:00:00+00:00,Unknown,889.0,157741,1094.0,115694,92.0,15343,981.0,1186.0,131037,173084,273435
6447,6447,6447,6447,6447,6447,6447,6447,6448,2021-05-14 15:00:00+00:00,Unknown,1015.0,158756,1125.0,116819,129.0,15472,1144.0,1254.0,132291,174228,275575
6448,6448,6448,6448,6448,6448,6448,6448,6449,2021-05-15 15:00:00+00:00,Unknown,757.0,159513,1061.0,117880,131.0,15603,888.0,1192.0,133483,175116,277393
6449,6449,6449,6449,6449,6449,6449,6449,6450,2021-05-16 15:00:00+00:00,Unknown,369.0,159882,707.0,118587,140.0,15743,509.0,847.0,134330,175625,278469
6450,6450,6450,6450,6450,6450,6450,6450,6451,2021-05-17 15:00:00+00:00,Unknown,718.0,160600,1159.0,119746,125.0,15868,843.0,1284.0,135614,176468,280346
6451,6451,6451,6451,6451,6451,6451,6451,6452,2021-05-18 15:00:00+00:00,Unknown,999.0,161599,1213.0,120959,152.0,16020,1151.0,1365.0,136979,177619,282558
6452,6452,6452,6452,6452,6452,6452,6452,6453,2021-07-11 15:00:00+00:00,Garrett,3.0,10572,3.0,9814,,805,,,10619,11377,20386
6453,6453,6453,6453,6453,6453,6453,6453,6454,2021-07-12 15:00:00+00:00,Garrett,1.0,10573,10.0,9824,3.0,808,4.0,13.0,10632,11381,20397
6454,6454,6454,6454,6454,6454,6454,6454,6455,2021-07-13 15:00:00+00:00,Garrett,6.0,10579,7.0,9831,2.0,810,8.0,9.0,10641,11389,20410
6455,6455,6455,6455,6455,6455,6455,6455,6456,2021-07-14 15:00:00+00:00,Garrett,4.0,10583,4.0,9835,1.0,811,5.0,5.0,10646,11394,20418
6456,6456,6456,6456,6456,6456,6456,6456,6457,2021-07-15 15:00:00+00:00,Garrett,4.0,10587,2.0,9837,2.0,813,6.0,4.0,10650,11400,20424
6457,6457,6457,6457,6457,6457,6457,6457,6458,2021-07-16 15:00:00+00:00,Garrett,12.0,10599,16.0,9853,3.0,816,15.0,19.0,10669,11415,20452
6458,6458,6458,6458,6458,6458,6458,6458,6459,2021-07-17 15:00:00+00:00,Garrett,2.0,10601,2.0,9855,,816,,,10671,11417,20456
6459,6459,6459,6459,6459,6459,6459,6459,6460,2021-07-18 15:00:00+00:00,Garrett,1.0,10602,2.0,9857,,816,,,10673,11418,20459
6460,6460,6460,6460,6460,6460,6460,6460,6461,2021-07-19 15:00:00+00:00,Garrett,11.0,10613,10.0,9867,,816,,,10683,11429,20480
6461,6461,6461,6461,6461,6461,6461,6461,6462,2021-07-20 15:00:00+00:00,Garrett,11.0,10624,4.0,9871,1.0,817,12.0,5.0,10688,11441,20495
6462,6462,6462,6462,6462,6462,6462,6462,6463,2021-07-21 15:00:00+00:00,Garrett,13.0,10637,5.0,9876,4.0,821,17.0,9.0,10697,11458,20513
6463,6463,6463,6463,6463,6463,6463,6463,6464,2021-07-22 15:00:00+00:00,Garrett,9.0,10646,7.0,9883,,821,,,10704,11467,20529
6464,6464,6464,6464,6464,6464,6464,6464,6465,2021-07-23 15:00:00+00:00,Garrett,16.0,10662,9.0,9892,5.0,826,21.0,14.0,10718,11488,20554
6465,6465,6465,6465,6465,6465,6465,6465,6466,2021-07-24 15:00:00+00:00,Garrett,6.0,10668,,9892,1.0,827,7.0,,10719,11495,20560
6466,6466,6466,6466,6466,6466,6466,6466,6467,2021-07-25 15:00:00+00:00,Garrett,2.0,10670,3.0,9895,,827,,,10722,11497,20565
6467,6467,6467,6467,6467,6467,6467,6467,6468,2021-07-26 15:00:00+00:00,Garrett,12.0,10682,5.0,9900,7.0,834,19.0,12.0,10734,11516,20582
6468,6468,6468,6468,6468,6468,6468,6468,6469,2021-07-27 15:00:00+00:00,Garrett,19.0,10701,6.0,9906,6.0,840,25.0,12.0,10746,11541,20607
6469,6469,6469,6469,6469,6469,6469,6469,6470,2021-07-28 15:00:00+00:00,Garrett,11.0,10712,5.0,9911,2.0,842,13.0,7.0,10753,11554,20623
6470,6470,6470,6470,6470,6470,6470,6470,6471,2021-07-29 15:00:00+00:00,Garrett,9.0,10721,5.0,9916,4.0,846,13.0,9.0,10762,11567,20637
6471,6471,6471,6471,6471,6471,6471,6471,6472,2021-07-30 15:00:00+00:00,Garrett,14.0,10735,10.0,9926,5.0,851,19.0,15.0,10777,11586,20661
6472,6472,6472,6472,6472,6472,6472,6472,6473,2021-07-31 15:00:00+00:00,Garrett,9.0,10744,1.0,9927,,851,,,10778,11595,20671
6473,6473,6473,6473,6473,6473,6473,6473,6474,2021-08-01 15:00:00+00:00,Garrett,3.0,10747,3.0,9930,,851,,,10781,11598,20677
6474,6474,6474,6474,6474,6474,6474,6474,6475,2021-08-02 15:00:00+00:00,Garrett,10.0,10757,4.0,9934,2.0,853,12.0,6.0,10787,11610,20691
6475,6475,6475,6475,6475,6475,6475,6475,6476,2021-08-03 15:00:00+00:00,Garrett,18.0,10775,6.0,9940,5.0,858,23.0,11.0,10798,11633,20715
6476,6476,6476,6476,6476,6476,6476,6476,6477,2021-08-04 15:00:00+00:00,Garrett,4.0,10779,8.0,9948,1.0,859,5.0,9.0,10807,11638,20727
6477,6477,6477,6477,6477,6477,6477,6477,6478,2021-08-05 15:00:00+00:00,Garrett,17.0,10796,3.0,9951,,859,,,10810,11655,20747
6478,6478,6478,6478,6478,6478,6478,6478,6479,2021-08-06 15:00:00+00:00,Garrett,25.0,10821,12.0,9963,2.0,861,27.0,14.0,10824,11682,20784
6479,6479,6479,6479,6479,6479,6479,6479,6480,2021-08-07 15:00:00+00:00,Garrett,6.0,10827,3.0,9966,,861,,,10827,11688,20793
6480,6480,6480,6480,6480,6480,6480,6480,6481,2021-04-25 15:00:00+00:00,Washington,142.0,43716,66.0,32006,,8502,,,40508,52218,75722
6481,6481,6481,6481,6481,6481,6481,6481,6482,2021-04-26 15:00:00+00:00,Washington,529.0,44245,256.0,32262,,8502,,,40764,52747,76507
6482,6482,6482,6482,6482,6482,6482,6482,6483,2021-04-27 15:00:00+00:00,Washington,318.0,44563,546.0,32808,9.0,8511,327.0,555.0,41319,53074,77371
6483,6483,6483,6483,6483,6483,6483,6483,6484,2021-04-28 15:00:00+00:00,Washington,630.0,45193,417.0,33225,69.0,8580,699.0,486.0,41805,53773,78418
6484,6484,6484,6484,6484,6484,6484,6484,6485,2021-04-29 15:00:00+00:00,Washington,596.0,45789,438.0,33663,32.0,8612,628.0,470.0,42275,54401,79452
6485,6485,6485,6485,6485,6485,6485,6485,6486,2021-04-30 15:00:00+00:00,Washington,498.0,46287,421.0,34084,36.0,8648,534.0,457.0,42732,54935,80371
6486,6486,6486,6486,6486,6486,6486,6486,6487,2021-05-01 15:00:00+00:00,Washington,162.0,46449,136.0,34220,14.0,8662,176.0,150.0,42882,55111,80669
6487,6487,6487,6487,6487,6487,6487,6487,6488,2021-05-02 15:00:00+00:00,Washington,101.0,46550,125.0,34345,4.0,8666,105.0,129.0,43011,55216,80895
6488,6488,6488,6488,6488,6488,6488,6488,6489,2021-05-03 15:00:00+00:00,Washington,295.0,46845,573.0,34918,38.0,8704,333.0,611.0,43622,55549,81763
6489,6489,6489,6489,6489,6489,6489,6489,6490,2021-05-04 15:00:00+00:00,Washington,295.0,47140,577.0,35495,27.0,8731,322.0,604.0,44226,55871,82635
6490,6490,6490,6490,6490,6490,6490,6490,6491,2021-05-05 15:00:00+00:00,Washington,251.0,47391,282.0,35777,36.0,8767,287.0,318.0,44544,56158,83168
6491,6491,6491,6491,6491,6491,6491,6491,6492,2021-05-06 15:00:00+00:00,Washington,325.0,47716,1063.0,36840,65.0,8832,390.0,1128.0,45672,56548,84556
6492,6492,6492,6492,6492,6492,6492,6492,6493,2021-05-07 15:00:00+00:00,Washington,276.0,47992,719.0,37559,23.0,8855,299.0,742.0,46414,56847,85551
6493,6493,6493,6493,6493,6493,6493,6493,6494,2021-05-08 15:00:00+00:00,Washington,179.0,48171,214.0,37773,12.0,8867,191.0,226.0,46640,57038,85944
6494,6494,6494,6494,6494,6494,6494,6494,6495,2021-05-09 15:00:00+00:00,Washington,30.0,48201,54.0,37827,11.0,8878,41.0,65.0,46705,57079,86028
6495,6495,6495,6495,6495,6495,6495,6495,6496,2021-05-10 15:00:00+00:00,Washington,119.0,48320,347.0,38174,23.0,8901,142.0,370.0,47075,57221,86494
6496,6496,6496,6496,6496,6496,6496,6496,6497,2021-05-11 15:00:00+00:00,Washington,306.0,48626,459.0,38633,29.0,8930,335.0,488.0,47563,57556,87259
6497,6497,6497,6497,6497,6497,6497,6497,6498,2021-05-12 15:00:00+00:00,Washington,187.0,48813,861.0,39494,26.0,8956,213.0,887.0,48450,57769,88307
6498,6498,6498,6498,6498,6498,6498,6498,6499,2021-05-13 15:00:00+00:00,Washington,254.0,49067,480.0,39974,18.0,8974,272.0,498.0,48948,58041,89041
6499,6499,6499,6499,6499,6499,6499,6499,6500,2021-05-14 15:00:00+00:00,Washington,544.0,49611,631.0,40605,34.0,9008,578.0,665.0,49613,58619,90216
6500,6500,6500,6500,6500,6500,6500,6500,6501,2021-05-15 15:00:00+00:00,Washington,322.0,49933,207.0,40812,5.0,9013,327.0,212.0,49825,58946,90745
6501,6501,6501,6501,6501,6501,6501,6501,6502,2021-05-16 15:00:00+00:00,Washington,65.0,49998,63.0,40875,5.0,9018,70.0,68.0,49893,59016,90873
6502,6502,6502,6502,6502,6502,6502,6502,6503,2021-05-17 15:00:00+00:00,Washington,344.0,50342,221.0,41096,17.0,9035,361.0,238.0,50131,59377,91438
6503,6503,6503,6503,6503,6503,6503,6503,6504,2021-05-18 15:00:00+00:00,Washington,531.0,50873,319.0,41415,71.0,9106,602.0,390.0,50521,59979,92288
6504,6504,6504,6504,6504,6504,6504,6504,6505,2021-05-19 15:00:00+00:00,Washington,674.0,51547,633.0,42048,36.0,9142,710.0,669.0,51190,60689,93595
6505,6505,6505,6505,6505,6505,6505,6505,6506,2021-05-20 15:00:00+00:00,Washington,293.0,51840,687.0,42735,56.0,9198,349.0,743.0,51933,61038,94575
6506,6506,6506,6506,6506,6506,6506,6506,6507,2021-05-21 15:00:00+00:00,Washington,556.0,52396,474.0,43209,36.0,9234,592.0,510.0,52443,61630,95605
6507,6507,6507,6507,6507,6507,6507,6507,6508,2021-05-22 15:00:00+00:00,Washington,297.0,52693,208.0,43417,7.0,9241,304.0,215.0,52658,61934,96110
6508,6508,6508,6508,6508,6508,6508,6508,6509,2021-08-18 15:00:00+00:00,Somerset,21.0,10373,23.0,9063,31.0,1063,52.0,54.0,10126,11436,19436
6509,6509,6509,6509,6509,6509,6509,6509,6510,2021-08-19 15:00:00+00:00,Somerset,29.0,10402,13.0,9076,3.0,1066,32.0,16.0,10142,11468,19478
6510,6510,6510,6510,6510,6510,6510,6510,6511,2021-08-20 15:00:00+00:00,Somerset,29.0,10431,22.0,9098,2.0,1068,31.0,24.0,10166,11499,19529
6511,6511,6511,6511,6511,6511,6511,6511,6512,2021-08-21 15:00:00+00:00,Somerset,4.0,10435,4.0,9102,2.0,1070,6.0,6.0,10172,11505,19537
6512,6512,6512,6512,6512,6512,6512,6512,6513,2021-08-22 15:00:00+00:00,Somerset,10.0,10445,11.0,9113,,1070,,,10183,11515,19558
6513,6513,6513,6513,6513,6513,6513,6513,6514,2021-08-23 15:00:00+00:00,Somerset,16.0,10461,16.0,9129,,1070,,,10199,11531,19590
6514,6514,6514,6514,6514,6514,6514,6514,6515,2021-08-24 15:00:00+00:00,Somerset,21.0,10482,18.0,9147,5.0,1075,26.0,23.0,10222,11557,19629
6515,6515,6515,6515,6515,6515,6515,6515,6516,2021-08-25 15:00:00+00:00,Somerset,23.0,10505,46.0,9193,4.0,1079,27.0,50.0,10272,11584,19698
6516,6516,6516,6516,6516,6516,6516,6516,6517,2021-08-26 15:00:00+00:00,Somerset,33.0,10538,17.0,9210,1.0,1080,34.0,18.0,10290,11618,19748
6517,6517,6517,6517,6517,6517,6517,6517,6518,2021-08-27 15:00:00+00:00,Somerset,11.0,10549,23.0,9233,1.0,1081,12.0,24.0,10314,11630,19782
6518,6518,6518,6518,6518,6518,6518,6518,6519,2021-08-28 15:00:00+00:00,Somerset,8.0,10557,8.0,9241,,1081,,,10322,11638,19798
6519,6519,6519,6519,6519,6519,6519,6519,6520,2021-08-29 15:00:00+00:00,Somerset,12.0,10569,3.0,9244,,1081,,,10325,11650,19813
6520,6520,6520,6520,6520,6520,6520,6520,6521,2021-08-30 15:00:00+00:00,Somerset,23.0,10592,8.0,9252,4.0,1085,27.0,12.0,10337,11677,19844
6521,6521,6521,6521,6521,6521,6521,6521,6522,2021-08-31 15:00:00+00:00,Somerset,52.0,10644,23.0,9275,6.0,1091,58.0,29.0,10366,11735,19919
6522,6522,6522,6522,6522,6522,6522,6522,6523,2021-09-01 15:00:00+00:00,Somerset,23.0,10667,31.0,9306,,1091,,,10397,11758,19973
6523,6523,6523,6523,6523,6523,6523,6523,6524,2021-09-02 15:00:00+00:00,Somerset,19.0,10686,32.0,9338,3.0,1094,22.0,35.0,10432,11780,20024
6524,6524,6524,6524,6524,6524,6524,6524,6525,2021-09-03 15:00:00+00:00,Somerset,15.0,10701,41.0,9379,,1094,,,10473,11795,20080
6525,6525,6525,6525,6525,6525,6525,6525,6526,2021-09-04 15:00:00+00:00,Somerset,6.0,10707,9.0,9388,,1094,,,10482,11801,20095
6526,6526,6526,6526,6526,6526,6526,6526,6527,2021-09-05 15:00:00+00:00,Somerset,6.0,10713,10.0,9398,,1094,,,10492,11807,20111
6527,6527,6527,6527,6527,6527,6527,6527,6528,2021-09-06 15:00:00+00:00,Somerset,6.0,10719,5.0,9403,,1094,,,10497,11813,20122
6528,6528,6528,6528,6528,6528,6528,6528,6529,2021-09-07 15:00:00+00:00,Somerset,12.0,10731,30.0,9433,3.0,1097,15.0,33.0,10530,11828,20164
6529,6529,6529,6529,6529,6529,6529,6529,6530,2021-09-08 15:00:00+00:00,Somerset,15.0,10746,42.0,9475,19.0,1116,34.0,61.0,10591,11862,20221
6530,6530,6530,6530,6530,6530,6530,6530,6531,2021-09-09 15:00:00+00:00,Somerset,25.0,10771,20.0,9495,7.0,1123,32.0,27.0,10618,11894,20266
6531,6531,6531,6531,6531,6531,6531,6531,6532,2021-09-10 15:00:00+00:00,Somerset,24.0,10795,26.0,9521,3.0,1126,27.0,29.0,10647,11921,20316
6532,6532,6532,6532,6532,6532,6532,6532,6533,2021-09-11 15:00:00+00:00,Somerset,7.0,10802,10.0,9531,,1126,,,10657,11928,20333
6533,6533,6533,6533,6533,6533,6533,6533,6534,2021-09-12 15:00:00+00:00,Somerset,13.0,10815,8.0,9539,,1126,,,10665,11941,20354
6534,6534,6534,6534,6534,6534,6534,6534,6535,2021-09-13 15:00:00+00:00,Somerset,13.0,10828,16.0,9555,2.0,1128,15.0,18.0,10683,11956,20383
6535,6535,6535,6535,6535,6535,6535,6535,6536,2021-09-14 15:00:00+00:00,Somerset,15.0,10843,25.0,9580,2.0,1130,17.0,27.0,10710,11973,20423
6536,6536,6536,6536,6536,6536,6536,6536,6537,2021-09-15 15:00:00+00:00,Somerset,15.0,10858,28.0,9608,4.0,1134,19.0,32.0,10742,11992,20466
6537,6537,6537,6537,6537,6537,6537,6537,6538,2021-09-16 15:00:00+00:00,Somerset,12.0,10870,26.0,9634,2.0,1136,14.0,28.0,10770,12006,20504
6538,6538,6538,6538,6538,6538,6538,6538,6539,2021-09-17 15:00:00+00:00,Somerset,19.0,10889,17.0,9651,5.0,1141,24.0,22.0,10792,12030,20540
6539,6539,6539,6539,6539,6539,6539,6539,6540,2021-09-18 15:00:00+00:00,Somerset,7.0,10896,3.0,9654,,1141,,,10795,12037,20550
6540,6540,6540,6540,6540,6540,6540,6540,6541,2021-09-19 15:00:00+00:00,Somerset,11.0,10907,10.0,9664,,1141,,,10805,12048,20571
6541,6541,6541,6541,6541,6541,6541,6541,6542,2021-09-20 15:00:00+00:00,Somerset,7.0,10914,11.0,9675,,1141,,,10816,12055,20589
6542,6542,6542,6542,6542,6542,6542,6542,6543,2021-09-21 15:00:00+00:00,Somerset,102.0,11016,38.0,9713,2.0,1143,104.0,40.0,10856,12159,20729
6543,6543,6543,6543,6543,6543,6543,6543,6544,2021-09-22 15:00:00+00:00,Somerset,7.0,11023,20.0,9733,1.0,1144,8.0,21.0,10877,12167,20756
6544,6544,6544,6544,6544,6544,6544,6544,6545,2021-09-23 15:00:00+00:00,Somerset,10.0,11033,9.0,9742,1.0,1145,11.0,10.0,10887,12178,20775
6545,6545,6545,6545,6545,6545,6545,6545,6546,2021-09-24 15:00:00+00:00,Somerset,8.0,11041,18.0,9760,1.0,1146,9.0,19.0,10906,12187,20801
6546,6546,6546,6546,6546,6546,6546,6546,6547,2021-09-25 15:00:00+00:00,Somerset,6.0,11047,4.0,9764,,1146,,,10910,12193,20811
6547,6547,6547,6547,6547,6547,6547,6547,6548,2021-09-26 15:00:00+00:00,Somerset,2.0,11049,11.0,9775,,1146,,,10921,12195,20824
6548,6548,6548,6548,6548,6548,6548,6548,6549,2021-09-27 15:00:00+00:00,Somerset,9.0,11058,7.0,9782,1.0,1147,10.0,8.0,10929,12205,20840
6549,6549,6549,6549,6549,6549,6549,6549,6550,2021-09-28 15:00:00+00:00,Somerset,8.0,11066,11.0,9793,2.0,1149,10.0,13.0,10942,12215,20859
6550,6550,6550,6550,6550,6550,6550,6550,6551,2021-09-29 15:00:00+00:00,Somerset,14.0,11080,17.0,9810,,1149,,,10959,12229,20890
6551,6551,6551,6551,6551,6551,6551,6551,6552,2021-09-30 15:00:00+00:00,Somerset,7.0,11087,14.0,9824,2.0,1151,9.0,16.0,10975,12238,20911
6552,6552,6552,6552,6552,6552,6552,6552,6553,2021-10-01 15:00:00+00:00,Somerset,14.0,11101,23.0,9847,1.0,1152,15.0,24.0,10999,12253,20948
6553,6553,6553,6553,6553,6553,6553,6553,6554,2021-10-02 15:00:00+00:00,Somerset,3.0,11104,10.0,9857,,1152,,,11009,12256,20961
6554,6554,6554,6554,6554,6554,6554,6554,6555,2021-10-03 15:00:00+00:00,Somerset,2.0,11106,9.0,9866,,1152,,,11018,12258,20972
6555,6555,6555,6555,6555,6555,6555,6555,6556,2021-10-04 15:00:00+00:00,Somerset,12.0,11118,13.0,9879,2.0,1154,14.0,15.0,11033,12272,20997
6556,6556,6556,6556,6556,6556,6556,6556,6557,2021-10-05 15:00:00+00:00,Somerset,3.0,11121,8.0,9887,,1154,,,11041,12275,21008
6557,6557,6557,6557,6557,6557,6557,6557,6558,2021-10-06 15:00:00+00:00,Somerset,7.0,11128,13.0,9900,,1154,,,11054,12282,21028
6558,6558,6558,6558,6558,6558,6558,6558,6559,2021-10-07 15:00:00+00:00,Somerset,16.0,11144,8.0,9908,,1154,,,11062,12298,21052
6559,6559,6559,6559,6559,6559,6559,6559,6560,2021-10-08 15:00:00+00:00,Somerset,17.0,11161,18.0,9926,1.0,1155,18.0,19.0,11081,12316,21087
6560,6560,6560,6560,6560,6560,6560,6560,6561,2021-10-09 15:00:00+00:00,Somerset,7.0,11168,5.0,9931,1.0,1156,8.0,6.0,11087,12324,21099
6561,6561,6561,6561,6561,6561,6561,6561,6562,2021-10-10 15:00:00+00:00,Somerset,4.0,11172,4.0,9935,,1156,,,11091,12328,21107
6562,6562,6562,6562,6562,6562,6562,6562,6563,2021-10-11 15:00:00+00:00,Somerset,11.0,11183,14.0,9949,2.0,1158,13.0,16.0,11107,12341,21132
6563,6563,6563,6563,6563,6563,6563,6563,6564,2021-10-12 15:00:00+00:00,Somerset,8.0,11191,14.0,9963,,1158,,,11121,12349,21154
6564,6564,6564,6564,6564,6564,6564,6564,6565,2021-05-23 15:00:00+00:00,Washington,62.0,52755,72.0,43489,1.0,9242,63.0,73.0,52731,61997,96244
6565,6565,6565,6565,6565,6565,6565,6565,6566,2021-05-24 15:00:00+00:00,Washington,158.0,52913,375.0,43864,19.0,9261,177.0,394.0,53125,62174,96777
6566,6566,6566,6566,6566,6566,6566,6566,6567,2021-05-25 15:00:00+00:00,Washington,270.0,53183,332.0,44196,47.0,9308,317.0,379.0,53504,62491,97379
6567,6567,6567,6567,6567,6567,6567,6567,6568,2021-05-26 15:00:00+00:00,Washington,330.0,53513,353.0,44549,37.0,9345,367.0,390.0,53894,62858,98062
6568,6568,6568,6568,6568,6568,6568,6568,6569,2021-05-27 15:00:00+00:00,Washington,257.0,53770,394.0,44943,29.0,9374,286.0,423.0,54317,63144,98713
6569,6569,6569,6569,6569,6569,6569,6569,6570,2021-05-28 15:00:00+00:00,Washington,262.0,54032,372.0,45315,20.0,9394,282.0,392.0,54709,63426,99347
6570,6570,6570,6570,6570,6570,6570,6570,6571,2021-05-29 15:00:00+00:00,Washington,174.0,54206,175.0,45490,16.0,9410,190.0,191.0,54900,63616,99696
6571,6571,6571,6571,6571,6571,6571,6571,6572,2021-05-30 15:00:00+00:00,Washington,52.0,54258,33.0,45523,3.0,9413,55.0,36.0,54936,63671,99781
6572,6572,6572,6572,6572,6572,6572,6572,6573,2021-05-31 15:00:00+00:00,Washington,17.0,54275,23.0,45546,,9413,,,54959,63688,99821
6573,6573,6573,6573,6573,6573,6573,6573,6574,2021-06-01 15:00:00+00:00,Washington,152.0,54427,371.0,45917,39.0,9452,191.0,410.0,55369,63879,100344
6574,6574,6574,6574,6574,6574,6574,6574,6575,2021-06-02 15:00:00+00:00,Washington,157.0,54584,500.0,46417,43.0,9495,200.0,543.0,55912,64079,101001
6575,6575,6575,6575,6575,6575,6575,6575,6576,2021-06-03 15:00:00+00:00,Washington,105.0,54689,238.0,46655,43.0,9538,148.0,281.0,56193,64227,101344
6576,6576,6576,6576,6576,6576,6576,6576,6577,2021-06-04 15:00:00+00:00,Washington,177.0,54866,517.0,47172,42.0,9580,219.0,559.0,56752,64446,102038
6577,6577,6577,6577,6577,6577,6577,6577,6578,2021-06-05 15:00:00+00:00,Washington,45.0,54911,283.0,47455,28.0,9608,73.0,311.0,57063,64519,102366
6578,6578,6578,6578,6578,6578,6578,6578,6579,2021-06-06 15:00:00+00:00,Washington,46.0,54957,61.0,47516,3.0,9611,49.0,64.0,57127,64568,102473
6579,6579,6579,6579,6579,6579,6579,6579,6580,2021-06-07 15:00:00+00:00,Washington,118.0,55075,319.0,47835,18.0,9629,136.0,337.0,57464,64704,102910
6580,6580,6580,6580,6580,6580,6580,6580,6581,2021-06-08 15:00:00+00:00,Washington,129.0,55204,477.0,48312,15.0,9644,144.0,492.0,57956,64848,103516
6581,6581,6581,6581,6581,6581,6581,6581,6582,2021-06-09 15:00:00+00:00,Washington,126.0,55330,337.0,48649,16.0,9660,142.0,353.0,58309,64990,103979
6582,6582,6582,6582,6582,6582,6582,6582,6583,2021-06-10 15:00:00+00:00,Washington,122.0,55452,298.0,48947,46.0,9706,168.0,344.0,58653,65158,104399
6583,6583,6583,6583,6583,6583,6583,6583,6584,2021-06-11 15:00:00+00:00,Washington,153.0,55605,361.0,49308,13.0,9719,166.0,374.0,59027,65324,104913
6584,6584,6584,6584,6584,6584,6584,6584,6585,2021-06-12 15:00:00+00:00,Washington,45.0,55650,274.0,49582,14.0,9733,59.0,288.0,59315,65383,105232
6585,6585,6585,6585,6585,6585,6585,6585,6586,2021-06-13 15:00:00+00:00,Washington,22.0,55672,85.0,49667,7.0,9740,29.0,92.0,59407,65412,105339
6586,6586,6586,6586,6586,6586,6586,6586,6587,2021-06-14 15:00:00+00:00,Washington,141.0,55813,183.0,49850,30.0,9770,171.0,213.0,59620,65583,105663
6587,6587,6587,6587,6587,6587,6587,6587,6588,2021-06-15 15:00:00+00:00,Washington,101.0,55914,258.0,50108,43.0,9813,144.0,301.0,59921,65727,106022
6588,6588,6588,6588,6588,6588,6588,6588,6589,2021-06-16 15:00:00+00:00,Washington,126.0,56040,297.0,50405,25.0,9838,151.0,322.0,60243,65878,106445
6589,6589,6589,6589,6589,6589,6589,6589,6590,2021-06-17 15:00:00+00:00,Washington,100.0,56140,188.0,50593,21.0,9859,121.0,209.0,60452,65999,106733
6590,6590,6590,6590,6590,6590,6590,6590,6591,2021-06-18 15:00:00+00:00,Washington,143.0,56283,247.0,50840,15.0,9874,158.0,262.0,60714,66157,107123
6591,6591,6591,6591,6591,6591,6591,6591,6592,2021-06-19 15:00:00+00:00,Washington,64.0,56347,154.0,50994,11.0,9885,75.0,165.0,60879,66232,107341
6592,6592,6592,6592,6592,6592,6592,6592,6593,2021-08-08 15:00:00+00:00,Garrett,5.0,10832,1.0,9967,,861,,,10828,11693,20799
6593,6593,6593,6593,6593,6593,6593,6593,6594,2021-08-09 15:00:00+00:00,Garrett,18.0,10850,6.0,9973,,861,,,10834,11711,20823
6594,6594,6594,6594,6594,6594,6594,6594,6595,2021-08-10 15:00:00+00:00,Garrett,27.0,10877,9.0,9982,4.0,865,31.0,13.0,10847,11742,20859
6595,6595,6595,6595,6595,6595,6595,6595,6596,2021-08-11 15:00:00+00:00,Garrett,24.0,10901,7.0,9989,3.0,868,27.0,10.0,10857,11769,20890
6596,6596,6596,6596,6596,6596,6596,6596,6597,2021-08-12 15:00:00+00:00,Garrett,4.0,10905,1.0,9990,,868,,,10858,11773,20895
6597,6597,6597,6597,6597,6597,6597,6597,6598,2021-08-13 15:00:00+00:00,Garrett,19.0,10924,11.0,10001,2.0,870,21.0,13.0,10871,11794,20925
6598,6598,6598,6598,6598,6598,6598,6598,6599,2021-08-14 15:00:00+00:00,Garrett,11.0,10935,2.0,10003,,870,,,10873,11805,20938
6599,6599,6599,6599,6599,6599,6599,6599,6600,2021-08-15 15:00:00+00:00,Garrett,6.0,10941,1.0,10004,,870,,,10874,11811,20945
6600,6600,6600,6600,6600,6600,6600,6600,6601,2021-08-16 15:00:00+00:00,Garrett,19.0,10960,9.0,10013,,870,,,10883,11830,20973
6601,6601,6601,6601,6601,6601,6601,6601,6602,2021-08-17 15:00:00+00:00,Garrett,37.0,10997,14.0,10027,5.0,875,42.0,19.0,10902,11872,21024
6602,6602,6602,6602,6602,6602,6602,6602,6603,2021-08-18 15:00:00+00:00,Garrett,25.0,11022,6.0,10033,,875,,,10908,11897,21055
6603,6603,6603,6603,6603,6603,6603,6603,6604,2021-08-19 15:00:00+00:00,Garrett,16.0,11038,7.0,10040,9.0,884,25.0,16.0,10924,11922,21078
6604,6604,6604,6604,6604,6604,6604,6604,6605,2021-08-20 15:00:00+00:00,Garrett,30.0,11068,6.0,10046,5.0,889,35.0,11.0,10935,11957,21114
6605,6605,6605,6605,6605,6605,6605,6605,6606,2021-08-21 15:00:00+00:00,Garrett,6.0,11074,7.0,10053,,889,,,10942,11963,21127
6606,6606,6606,6606,6606,6606,6606,6606,6607,2021-08-22 15:00:00+00:00,Garrett,2.0,11076,5.0,10058,1.0,890,3.0,6.0,10948,11966,21134
6607,6607,6607,6607,6607,6607,6607,6607,6608,2021-08-23 15:00:00+00:00,Garrett,16.0,11092,8.0,10066,,890,,,10956,11982,21158
6608,6608,6608,6608,6608,6608,6608,6608,6609,2021-08-24 15:00:00+00:00,Garrett,23.0,11115,20.0,10086,2.0,892,25.0,22.0,10978,12007,21201
6609,6609,6609,6609,6609,6609,6609,6609,6610,2021-08-25 15:00:00+00:00,Garrett,21.0,11136,14.0,10100,3.0,895,24.0,17.0,10995,12031,21236
6610,6610,6610,6610,6610,6610,6610,6610,6611,2021-08-26 15:00:00+00:00,Garrett,18.0,11154,10.0,10110,1.0,896,19.0,11.0,11006,12050,21264
6611,6611,6611,6611,6611,6611,6611,6611,6612,2021-08-27 15:00:00+00:00,Garrett,42.0,11196,19.0,10129,4.0,900,46.0,23.0,11029,12096,21325
6612,6612,6612,6612,6612,6612,6612,6612,6613,2021-08-28 15:00:00+00:00,Garrett,10.0,11206,5.0,10134,,900,,,11034,12106,21340
6613,6613,6613,6613,6613,6613,6613,6613,6614,2021-08-29 15:00:00+00:00,Garrett,9.0,11215,2.0,10136,,900,,,11036,12115,21351
6614,6614,6614,6614,6614,6614,6614,6614,6615,2021-08-30 15:00:00+00:00,Garrett,20.0,11235,12.0,10148,,900,,,11048,12135,21383
6615,6615,6615,6615,6615,6615,6615,6615,6616,2021-08-31 15:00:00+00:00,Garrett,32.0,11267,21.0,10169,8.0,908,40.0,29.0,11077,12175,21436
6616,6616,6616,6616,6616,6616,6616,6616,6617,2021-09-01 15:00:00+00:00,Garrett,22.0,11289,11.0,10180,6.0,914,28.0,17.0,11094,12203,21469
6617,6617,6617,6617,6617,6617,6617,6617,6618,2021-09-02 15:00:00+00:00,Garrett,15.0,11304,7.0,10187,4.0,918,19.0,11.0,11105,12222,21491
6618,6618,6618,6618,6618,6618,6618,6618,6619,2021-09-03 15:00:00+00:00,Garrett,24.0,11328,23.0,10210,1.0,919,25.0,24.0,11129,12247,21538
6619,6619,6619,6619,6619,6619,6619,6619,6620,2021-09-04 15:00:00+00:00,Garrett,8.0,11336,6.0,10216,,919,,,11135,12255,21552
6620,6620,6620,6620,6620,6620,6620,6620,6621,2021-05-19 15:00:00+00:00,Unknown,997.0,162596,1254.0,122213,123.0,16143,1120.0,1377.0,138356,178739,284809
6621,6621,6621,6621,6621,6621,6621,6621,6622,2021-05-20 15:00:00+00:00,Unknown,935.0,163531,1269.0,123482,152.0,16295,1087.0,1421.0,139777,179826,287013
6622,6622,6622,6622,6622,6622,6622,6622,6623,2021-05-21 15:00:00+00:00,Unknown,1032.0,164563,1133.0,124615,116.0,16411,1148.0,1249.0,141026,180974,289178
6623,6623,6623,6623,6623,6623,6623,6623,6624,2021-05-22 15:00:00+00:00,Unknown,804.0,165367,698.0,125313,120.0,16531,924.0,818.0,141844,181898,290680
6624,6624,6624,6624,6624,6624,6624,6624,6625,2021-05-23 15:00:00+00:00,Unknown,352.0,165719,397.0,125710,113.0,16644,465.0,510.0,142354,182363,291429
6625,6625,6625,6625,6625,6625,6625,6625,6626,2021-05-24 15:00:00+00:00,Unknown,631.0,166350,659.0,126369,124.0,16768,755.0,783.0,143137,183118,292719
6626,6626,6626,6626,6626,6626,6626,6626,6627,2021-05-25 15:00:00+00:00,Unknown,748.0,167098,643.0,127012,93.0,16861,841.0,736.0,143873,183959,294110
6627,6627,6627,6627,6627,6627,6627,6627,6628,2021-05-26 15:00:00+00:00,Unknown,642.0,167740,765.0,127777,160.0,17021,802.0,925.0,144798,184761,295517
6628,6628,6628,6628,6628,6628,6628,6628,6629,2021-05-27 15:00:00+00:00,Unknown,557.0,168297,642.0,128419,99.0,17120,656.0,741.0,145539,185417,296716
6629,6629,6629,6629,6629,6629,6629,6629,6630,2021-05-28 15:00:00+00:00,Unknown,558.0,168855,679.0,129098,135.0,17255,693.0,814.0,146353,186110,297953
6630,6630,6630,6630,6630,6630,6630,6630,6631,2021-05-29 15:00:00+00:00,Unknown,428.0,169283,457.0,129555,69.0,17324,497.0,526.0,146879,186607,298838
6631,6631,6631,6631,6631,6631,6631,6631,6632,2021-05-30 15:00:00+00:00,Unknown,255.0,169538,246.0,129801,46.0,17370,301.0,292.0,147171,186908,299339
6632,6632,6632,6632,6632,6632,6632,6632,6633,2021-05-31 15:00:00+00:00,Unknown,98.0,169636,178.0,129979,21.0,17391,119.0,199.0,147370,187027,299615
6633,6633,6633,6633,6633,6633,6633,6633,6634,2021-06-01 15:00:00+00:00,Unknown,542.0,170178,803.0,130782,100.0,17491,642.0,903.0,148273,187669,300960
6634,6634,6634,6634,6634,6634,6634,6634,6635,2021-06-02 15:00:00+00:00,Unknown,460.0,170638,513.0,131295,55.0,17546,515.0,568.0,148841,188184,301933
6635,6635,6635,6635,6635,6635,6635,6635,6636,2021-06-03 15:00:00+00:00,Unknown,443.0,171081,623.0,131918,72.0,17618,515.0,695.0,149536,188699,302999
6636,6636,6636,6636,6636,6636,6636,6636,6637,2021-06-04 15:00:00+00:00,Unknown,456.0,171537,778.0,132696,66.0,17684,522.0,844.0,150380,189221,304233
6637,6637,6637,6637,6637,6637,6637,6637,6638,2021-06-05 15:00:00+00:00,Unknown,346.0,171883,555.0,133251,41.0,17725,387.0,596.0,150976,189608,305134
6638,6638,6638,6638,6638,6638,6638,6638,6639,2021-06-06 15:00:00+00:00,Unknown,220.0,172103,237.0,133488,46.0,17771,266.0,283.0,151259,189874,305591
6639,6639,6639,6639,6639,6639,6639,6639,6640,2021-06-07 15:00:00+00:00,Unknown,400.0,172503,461.0,133949,40.0,17811,440.0,501.0,151760,190314,306452
6640,6640,6640,6640,6640,6640,6640,6640,6641,2021-06-08 15:00:00+00:00,Unknown,370.0,172873,754.0,134703,52.0,17863,422.0,806.0,152566,190736,307576
6641,6641,6641,6641,6641,6641,6641,6641,6642,2021-06-09 15:00:00+00:00,Unknown,422.0,173295,622.0,135325,58.0,17921,480.0,680.0,153246,191216,308620
6642,6642,6642,6642,6642,6642,6642,6642,6643,2021-06-10 15:00:00+00:00,Unknown,394.0,173689,643.0,135968,67.0,17988,461.0,710.0,153956,191677,309657
6643,6643,6643,6643,6643,6643,6643,6643,6644,2021-06-11 15:00:00+00:00,Unknown,360.0,174049,730.0,136698,91.0,18079,451.0,821.0,154777,192128,310747
6644,6644,6644,6644,6644,6644,6644,6644,6645,2021-06-12 15:00:00+00:00,Unknown,316.0,174365,618.0,137316,38.0,18117,354.0,656.0,155433,192482,311681
6645,6645,6645,6645,6645,6645,6645,6645,6646,2021-06-13 15:00:00+00:00,Unknown,126.0,174491,241.0,137557,24.0,18141,150.0,265.0,155698,192632,312048
6646,6646,6646,6646,6646,6646,6646,6646,6647,2021-06-14 15:00:00+00:00,Unknown,362.0,174853,439.0,137996,63.0,18204,425.0,502.0,156200,193057,312849
6647,6647,6647,6647,6647,6647,6647,6647,6648,2021-06-15 15:00:00+00:00,Unknown,365.0,175218,727.0,138723,63.0,18267,428.0,790.0,156990,193485,313941
6648,6648,6648,6648,6648,6648,6648,6648,6649,2021-06-20 15:00:00+00:00,Washington,32.0,56379,39.0,51033,4.0,9889,36.0,43.0,60922,66268,107412
6649,6649,6649,6649,6649,6649,6649,6649,6650,2021-06-21 15:00:00+00:00,Washington,62.0,56441,106.0,51139,6.0,9895,68.0,112.0,61034,66336,107580
6650,6650,6650,6650,6650,6650,6650,6650,6651,2021-06-22 15:00:00+00:00,Washington,124.0,56565,143.0,51282,4.0,9899,128.0,147.0,61181,66464,107847
6651,6651,6651,6651,6651,6651,6651,6651,6652,2021-06-23 15:00:00+00:00,Washington,105.0,56670,475.0,51757,17.0,9916,122.0,492.0,61673,66586,108427
6652,6652,6652,6652,6652,6652,6652,6652,6653,2021-06-24 15:00:00+00:00,Washington,79.0,56749,173.0,51930,20.0,9936,99.0,193.0,61866,66685,108679
6653,6653,6653,6653,6653,6653,6653,6653,6654,2021-06-25 15:00:00+00:00,Washington,123.0,56872,167.0,52097,31.0,9967,154.0,198.0,62064,66839,108969
6654,6654,6654,6654,6654,6654,6654,6654,6655,2021-06-26 15:00:00+00:00,Washington,63.0,56935,69.0,52166,22.0,9989,85.0,91.0,62155,66924,109101
6655,6655,6655,6655,6655,6655,6655,6655,6656,2021-06-27 15:00:00+00:00,Washington,42.0,56977,42.0,52208,3.0,9992,45.0,45.0,62200,66969,109185
6656,6656,6656,6656,6656,6656,6656,6656,6657,2021-06-28 15:00:00+00:00,Washington,59.0,57036,68.0,52276,16.0,10008,75.0,84.0,62284,67044,109312
6657,6657,6657,6657,6657,6657,6657,6657,6658,2021-06-29 15:00:00+00:00,Washington,100.0,57136,177.0,52453,8.0,10016,108.0,185.0,62469,67152,109589
6658,6658,6658,6658,6658,6658,6658,6658,6659,2021-06-30 15:00:00+00:00,Washington,124.0,57260,124.0,52577,16.0,10032,140.0,140.0,62609,67292,109837
6659,6659,6659,6659,6659,6659,6659,6659,6660,2021-07-01 15:00:00+00:00,Washington,109.0,57369,166.0,52743,26.0,10058,135.0,192.0,62801,67427,110112
6660,6660,6660,6660,6660,6660,6660,6660,6661,2021-07-02 15:00:00+00:00,Washington,107.0,57476,142.0,52885,7.0,10065,114.0,149.0,62950,67541,110361
6661,6661,6661,6661,6661,6661,6661,6661,6662,2021-07-03 15:00:00+00:00,Washington,52.0,57528,60.0,52945,9.0,10074,61.0,69.0,63019,67602,110473
6662,6662,6662,6662,6662,6662,6662,6662,6663,2021-07-04 15:00:00+00:00,Washington,11.0,57539,10.0,52955,,10074,,,63029,67613,110494
6663,6663,6663,6663,6663,6663,6663,6663,6664,2021-07-05 15:00:00+00:00,Washington,59.0,57598,73.0,53028,2.0,10076,61.0,75.0,63104,67674,110626
6664,6664,6664,6664,6664,6664,6664,6664,6665,2021-07-06 15:00:00+00:00,Washington,96.0,57694,141.0,53169,14.0,10090,110.0,155.0,63259,67784,110863
6665,6665,6665,6665,6665,6665,6665,6665,6666,2021-07-07 15:00:00+00:00,Washington,72.0,57766,73.0,53242,18.0,10108,90.0,91.0,63350,67874,111008
6666,6666,6666,6666,6666,6666,6666,6666,6667,2021-07-08 15:00:00+00:00,Washington,100.0,57866,133.0,53375,40.0,10148,140.0,173.0,63523,68014,111241
6667,6667,6667,6667,6667,6667,6667,6667,6668,2021-07-09 15:00:00+00:00,Washington,122.0,57988,135.0,53510,26.0,10174,148.0,161.0,63684,68162,111498
6668,6668,6668,6668,6668,6668,6668,6668,6669,2021-07-10 15:00:00+00:00,Washington,50.0,58038,50.0,53560,13.0,10187,63.0,63.0,63747,68225,111598
6669,6669,6669,6669,6669,6669,6669,6669,6670,2021-07-11 15:00:00+00:00,Washington,32.0,58070,37.0,53597,6.0,10193,38.0,43.0,63790,68263,111667
6670,6670,6670,6670,6670,6670,6670,6670,6671,2021-07-12 15:00:00+00:00,Washington,55.0,58125,71.0,53668,11.0,10204,66.0,82.0,63872,68329,111793
6671,6671,6671,6671,6671,6671,6671,6671,6672,2021-07-13 15:00:00+00:00,Washington,84.0,58209,114.0,53782,13.0,10217,97.0,127.0,63999,68426,111991
6672,6672,6672,6672,6672,6672,6672,6672,6673,2021-07-14 15:00:00+00:00,Washington,70.0,58279,61.0,53843,13.0,10230,83.0,74.0,64073,68509,112122
6673,6673,6673,6673,6673,6673,6673,6673,6674,2021-07-15 15:00:00+00:00,Washington,78.0,58357,63.0,53906,23.0,10253,101.0,86.0,64159,68610,112263
6674,6674,6674,6674,6674,6674,6674,6674,6675,2021-07-16 15:00:00+00:00,Washington,95.0,58452,139.0,54045,5.0,10258,100.0,144.0,64303,68710,112497
6675,6675,6675,6675,6675,6675,6675,6675,6676,2021-07-17 15:00:00+00:00,Washington,56.0,58508,71.0,54116,13.0,10271,69.0,84.0,64387,68779,112624
6676,6676,6676,6676,6676,6676,6676,6676,6677,2021-10-13 15:00:00+00:00,Somerset,3.0,11194,7.0,9970,1.0,1159,4.0,8.0,11129,12353,21164
6677,6677,6677,6677,6677,6677,6677,6677,6678,2021-10-14 15:00:00+00:00,Somerset,4.0,11198,7.0,9977,1.0,1160,5.0,8.0,11137,12358,21175
6678,6678,6678,6678,6678,6678,6678,6678,6679,2021-10-15 15:00:00+00:00,Somerset,12.0,11210,15.0,9992,2.0,1162,14.0,17.0,11154,12372,21202
6679,6679,6679,6679,6679,6679,6679,6679,6680,2021-10-16 15:00:00+00:00,Somerset,2.0,11212,5.0,9997,1.0,1163,3.0,6.0,11160,12375,21209
6680,6680,6680,6680,6680,6680,6680,6680,6681,2021-10-17 15:00:00+00:00,Somerset,,11212,3.0,10000,,1163,,,11163,12375,21212
6681,6681,6681,6681,6681,6681,6681,6681,6682,2021-10-18 15:00:00+00:00,Somerset,6.0,11218,10.0,10010,,1163,,,11173,12381,21228
6682,6682,6682,6682,6682,6682,6682,6682,6683,2021-10-19 15:00:00+00:00,Somerset,35.0,11253,52.0,10062,1.0,1164,36.0,53.0,11226,12417,21315
6683,6683,6683,6683,6683,6683,6683,6683,6684,2021-10-20 15:00:00+00:00,Somerset,17.0,11270,45.0,10107,1.0,1165,18.0,46.0,11272,12435,21377
6684,6684,6684,6684,6684,6684,6684,6684,6685,2021-10-21 15:00:00+00:00,Somerset,5.0,11275,9.0,10116,4.0,1169,9.0,13.0,11285,12444,21391
6685,6685,6685,6685,6685,6685,6685,6685,6686,2021-10-22 15:00:00+00:00,Somerset,9.0,11284,15.0,10131,1.0,1170,10.0,16.0,11301,12454,21415
6686,6686,6686,6686,6686,6686,6686,6686,6687,2021-10-23 15:00:00+00:00,Somerset,1.0,11285,8.0,10139,,1170,,,11309,12455,21424
6687,6687,6687,6687,6687,6687,6687,6687,6688,2021-10-24 15:00:00+00:00,Somerset,2.0,11287,1.0,10140,,1170,,,11310,12457,21427
6688,6688,6688,6688,6688,6688,6688,6688,6689,2021-10-25 15:00:00+00:00,Somerset,14.0,11301,9.0,10149,,1170,,,11319,12471,21450
6689,6689,6689,6689,6689,6689,6689,6689,6690,2021-10-26 15:00:00+00:00,Somerset,13.0,11314,8.0,10157,,1170,,,11327,12484,21471
6690,6690,6690,6690,6690,6690,6690,6690,6691,2021-10-27 15:00:00+00:00,Somerset,9.0,11323,18.0,10175,2.0,1172,11.0,20.0,11347,12495,21498
6691,6691,6691,6691,6691,6691,6691,6691,6692,2021-10-28 15:00:00+00:00,Somerset,10.0,11333,10.0,10185,2.0,1174,12.0,12.0,11359,12507,21518
6692,6692,6692,6692,6692,6692,6692,6692,6693,2021-10-29 15:00:00+00:00,Somerset,15.0,11348,21.0,10206,2.0,1176,17.0,23.0,11382,12524,21554
6693,6693,6693,6693,6693,6693,6693,6693,6694,2021-10-30 15:00:00+00:00,Somerset,3.0,11351,4.0,10210,,1176,,,11386,12527,21561
6694,6694,6694,6694,6694,6694,6694,6694,6695,2021-10-31 15:00:00+00:00,Somerset,1.0,11352,2.0,10212,,1176,,,11388,12528,21564
6695,6695,6695,6695,6695,6695,6695,6695,6696,2021-11-01 15:00:00+00:00,Somerset,8.0,11360,11.0,10223,1.0,1177,9.0,12.0,11400,12537,21583
6696,6696,6696,6696,6696,6696,6696,6696,6697,2021-11-02 15:00:00+00:00,Somerset,5.0,11365,8.0,10231,3.0,1180,8.0,11.0,11411,12545,21596
6697,6697,6697,6697,6697,6697,6697,6697,6698,2021-11-03 15:00:00+00:00,Somerset,8.0,11373,15.0,10246,1.0,1181,9.0,16.0,11427,12554,21619
6698,6698,6698,6698,6698,6698,6698,6698,6699,2021-11-04 15:00:00+00:00,Somerset,3.0,11376,9.0,10255,2.0,1183,5.0,11.0,11438,12559,21631
6699,6699,6699,6699,6699,6699,6699,6699,6700,2021-11-05 15:00:00+00:00,Somerset,14.0,11390,11.0,10266,6.0,1189,20.0,17.0,11455,12579,21656
6700,6700,6700,6700,6700,6700,6700,6700,6701,2021-11-06 15:00:00+00:00,Somerset,2.0,11392,1.0,10267,,1189,,,11456,12581,21659
6701,6701,6701,6701,6701,6701,6701,6701,6702,2020-12-16 15:00:00+00:00,Wicomico,2.0,2,,0,,0,,,0,2,2
6702,6702,6702,6702,6702,6702,6702,6702,6703,2020-12-17 15:00:00+00:00,Wicomico,84.0,86,,0,,0,,,0,86,86
6703,6703,6703,6703,6703,6703,6703,6703,6704,2020-12-18 15:00:00+00:00,Wicomico,333.0,419,,0,,0,,,0,419,419
6704,6704,6704,6704,6704,6704,6704,6704,6705,2021-09-05 15:00:00+00:00,Garrett,7.0,11343,4.0,10220,,919,,,11139,12262,21563
6705,6705,6705,6705,6705,6705,6705,6705,6706,2021-09-06 15:00:00+00:00,Garrett,2.0,11345,3.0,10223,,919,,,11142,12264,21568
6706,6706,6706,6706,6706,6706,6706,6706,6707,2021-09-07 15:00:00+00:00,Garrett,23.0,11368,29.0,10252,1.0,920,24.0,30.0,11172,12288,21620
6707,6707,6707,6707,6707,6707,6707,6707,6708,2021-09-08 15:00:00+00:00,Garrett,8.0,11376,8.0,10260,1.0,921,9.0,9.0,11181,12297,21636
6708,6708,6708,6708,6708,6708,6708,6708,6709,2021-09-09 15:00:00+00:00,Garrett,12.0,11388,7.0,10267,,921,,,11188,12309,21655
6709,6709,6709,6709,6709,6709,6709,6709,6710,2021-09-10 15:00:00+00:00,Garrett,21.0,11409,26.0,10293,2.0,923,23.0,28.0,11216,12332,21702
6710,6710,6710,6710,6710,6710,6710,6710,6711,2021-09-11 15:00:00+00:00,Garrett,10.0,11419,9.0,10302,,923,,,11225,12342,21721
6711,6711,6711,6711,6711,6711,6711,6711,6712,2021-09-12 15:00:00+00:00,Garrett,7.0,11426,2.0,10304,,923,,,11227,12349,21730
6712,6712,6712,6712,6712,6712,6712,6712,6713,2021-09-13 15:00:00+00:00,Garrett,10.0,11436,9.0,10313,1.0,924,11.0,10.0,11237,12360,21749
6713,6713,6713,6713,6713,6713,6713,6713,6714,2021-09-14 15:00:00+00:00,Garrett,27.0,11463,29.0,10342,4.0,928,31.0,33.0,11270,12391,21805
6714,6714,6714,6714,6714,6714,6714,6714,6715,2021-09-15 15:00:00+00:00,Garrett,10.0,11473,20.0,10362,,928,,,11290,12401,21835
6715,6715,6715,6715,6715,6715,6715,6715,6716,2021-09-16 15:00:00+00:00,Garrett,15.0,11488,14.0,10376,1.0,929,16.0,15.0,11305,12417,21864
6716,6716,6716,6716,6716,6716,6716,6716,6717,2021-09-17 15:00:00+00:00,Garrett,29.0,11517,42.0,10418,7.0,936,36.0,49.0,11354,12453,21935
6717,6717,6717,6717,6717,6717,6717,6717,6718,2021-09-18 15:00:00+00:00,Garrett,10.0,11527,11.0,10429,1.0,937,11.0,12.0,11366,12464,21956
6718,6718,6718,6718,6718,6718,6718,6718,6719,2021-09-19 15:00:00+00:00,Garrett,6.0,11533,18.0,10447,1.0,938,7.0,19.0,11385,12471,21980
6719,6719,6719,6719,6719,6719,6719,6719,6720,2021-09-20 15:00:00+00:00,Garrett,4.0,11537,17.0,10464,,938,,,11402,12475,22001
6720,6720,6720,6720,6720,6720,6720,6720,6721,2021-09-21 15:00:00+00:00,Garrett,19.0,11556,19.0,10483,3.0,941,22.0,22.0,11424,12497,22039
6721,6721,6721,6721,6721,6721,6721,6721,6722,2021-09-22 15:00:00+00:00,Garrett,14.0,11570,15.0,10498,1.0,942,15.0,16.0,11440,12512,22068
6722,6722,6722,6722,6722,6722,6722,6722,6723,2021-09-23 15:00:00+00:00,Garrett,14.0,11584,17.0,10515,,942,,,11457,12526,22099
6723,6723,6723,6723,6723,6723,6723,6723,6724,2021-09-24 15:00:00+00:00,Garrett,27.0,11611,32.0,10547,3.0,945,30.0,35.0,11492,12556,22158
6724,6724,6724,6724,6724,6724,6724,6724,6725,2021-09-25 15:00:00+00:00,Garrett,10.0,11621,10.0,10557,,945,,,11502,12566,22178
6725,6725,6725,6725,6725,6725,6725,6725,6726,2021-09-26 15:00:00+00:00,Garrett,3.0,11624,8.0,10565,,945,,,11510,12569,22189
6726,6726,6726,6726,6726,6726,6726,6726,6727,2021-09-27 15:00:00+00:00,Garrett,12.0,11636,16.0,10581,,945,,,11526,12581,22217
6727,6727,6727,6727,6727,6727,6727,6727,6728,2021-09-28 15:00:00+00:00,Garrett,22.0,11658,25.0,10606,4.0,949,26.0,29.0,11555,12607,22264
6728,6728,6728,6728,6728,6728,6728,6728,6729,2021-09-29 15:00:00+00:00,Garrett,7.0,11665,6.0,10612,,949,,,11561,12614,22277
6729,6729,6729,6729,6729,6729,6729,6729,6730,2021-09-30 15:00:00+00:00,Garrett,7.0,11672,6.0,10618,,949,,,11567,12621,22290
6730,6730,6730,6730,6730,6730,6730,6730,6731,2021-10-01 15:00:00+00:00,Garrett,19.0,11691,22.0,10640,5.0,954,24.0,27.0,11594,12645,22331
6731,6731,6731,6731,6731,6731,6731,6731,6732,2021-10-02 15:00:00+00:00,Garrett,5.0,11696,10.0,10650,,954,,,11604,12650,22346
6732,6732,6732,6732,6732,6732,6732,6732,6733,2021-07-18 15:00:00+00:00,Washington,17.0,58525,31.0,54147,,10271,,,64418,68796,112672
6733,6733,6733,6733,6733,6733,6733,6733,6734,2021-07-19 15:00:00+00:00,Washington,75.0,58600,51.0,54198,20.0,10291,95.0,71.0,64489,68891,112798
6734,6734,6734,6734,6734,6734,6734,6734,6735,2021-07-20 15:00:00+00:00,Washington,95.0,58695,101.0,54299,17.0,10308,112.0,118.0,64607,69003,112994
6735,6735,6735,6735,6735,6735,6735,6735,6736,2021-07-21 15:00:00+00:00,Washington,92.0,58787,87.0,54386,20.0,10328,112.0,107.0,64714,69115,113173
6736,6736,6736,6736,6736,6736,6736,6736,6737,2021-07-22 15:00:00+00:00,Washington,127.0,58914,97.0,54483,33.0,10361,160.0,130.0,64844,69275,113397
6737,6737,6737,6737,6737,6737,6737,6737,6738,2021-07-23 15:00:00+00:00,Washington,134.0,59048,90.0,54573,15.0,10376,149.0,105.0,64949,69424,113621
6738,6738,6738,6738,6738,6738,6738,6738,6739,2021-07-24 15:00:00+00:00,Washington,92.0,59140,49.0,54622,15.0,10391,107.0,64.0,65013,69531,113762
6739,6739,6739,6739,6739,6739,6739,6739,6740,2021-07-25 15:00:00+00:00,Washington,39.0,59179,18.0,54640,3.0,10394,42.0,21.0,65034,69573,113819
6740,6740,6740,6740,6740,6740,6740,6740,6741,2021-07-26 15:00:00+00:00,Washington,94.0,59273,54.0,54694,8.0,10402,102.0,62.0,65096,69675,113967
6741,6741,6741,6741,6741,6741,6741,6741,6742,2021-07-27 15:00:00+00:00,Washington,136.0,59409,74.0,54768,16.0,10418,152.0,90.0,65186,69827,114177
6742,6742,6742,6742,6742,6742,6742,6742,6743,2021-07-28 15:00:00+00:00,Washington,125.0,59534,119.0,54887,20.0,10438,145.0,139.0,65325,69972,114421
6743,6743,6743,6743,6743,6743,6743,6743,6744,2021-07-29 15:00:00+00:00,Washington,188.0,59722,86.0,54973,41.0,10479,229.0,127.0,65452,70201,114695
6744,6744,6744,6744,6744,6744,6744,6744,6745,2021-07-30 15:00:00+00:00,Washington,141.0,59863,75.0,55048,15.0,10494,156.0,90.0,65542,70357,114911
6745,6745,6745,6745,6745,6745,6745,6745,6746,2021-07-31 15:00:00+00:00,Washington,114.0,59977,51.0,55099,12.0,10506,126.0,63.0,65605,70483,115076
6746,6746,6746,6746,6746,6746,6746,6746,6747,2021-08-01 15:00:00+00:00,Washington,40.0,60017,31.0,55130,1.0,10507,41.0,32.0,65637,70524,115147
6747,6747,6747,6747,6747,6747,6747,6747,6748,2021-08-02 15:00:00+00:00,Washington,119.0,60136,68.0,55198,3.0,10510,122.0,71.0,65708,70646,115334
6748,6748,6748,6748,6748,6748,6748,6748,6749,2021-08-03 15:00:00+00:00,Washington,151.0,60287,81.0,55279,32.0,10542,183.0,113.0,65821,70829,115566
6749,6749,6749,6749,6749,6749,6749,6749,6750,2021-08-04 15:00:00+00:00,Washington,130.0,60417,79.0,55358,19.0,10561,149.0,98.0,65919,70978,115775
6750,6750,6750,6750,6750,6750,6750,6750,6751,2021-08-05 15:00:00+00:00,Washington,222.0,60639,71.0,55429,29.0,10590,251.0,100.0,66019,71229,116068
6751,6751,6751,6751,6751,6751,6751,6751,6752,2021-08-06 15:00:00+00:00,Washington,185.0,60824,83.0,55512,20.0,10610,205.0,103.0,66122,71434,116336
6752,6752,6752,6752,6752,6752,6752,6752,6753,2021-08-07 15:00:00+00:00,Washington,81.0,60905,41.0,55553,,10610,,,66163,71515,116458
6753,6753,6753,6753,6753,6753,6753,6753,6754,2021-08-08 15:00:00+00:00,Washington,56.0,60961,24.0,55577,2.0,10612,58.0,26.0,66189,71573,116538
6754,6754,6754,6754,6754,6754,6754,6754,6755,2021-08-09 15:00:00+00:00,Washington,158.0,61119,61.0,55638,11.0,10623,169.0,72.0,66261,71742,116757
6755,6755,6755,6755,6755,6755,6755,6755,6756,2021-08-10 15:00:00+00:00,Washington,166.0,61285,112.0,55750,17.0,10640,183.0,129.0,66390,71925,117035
6756,6756,6756,6756,6756,6756,6756,6756,6757,2021-08-11 15:00:00+00:00,Washington,97.0,61382,71.0,55821,8.0,10648,105.0,79.0,66469,72030,117203
6757,6757,6757,6757,6757,6757,6757,6757,6758,2021-08-12 15:00:00+00:00,Washington,167.0,61549,91.0,55912,26.0,10674,193.0,117.0,66586,72223,117461
6758,6758,6758,6758,6758,6758,6758,6758,6759,2021-08-13 15:00:00+00:00,Washington,134.0,61683,67.0,55979,19.0,10693,153.0,86.0,66672,72376,117662
6759,6759,6759,6759,6759,6759,6759,6759,6760,2021-08-14 15:00:00+00:00,Washington,67.0,61750,40.0,56019,11.0,10704,78.0,51.0,66723,72454,117769
6760,6760,6760,6760,6760,6760,6760,6760,6761,2020-12-19 15:00:00+00:00,Wicomico,129.0,548,,0,,0,,,0,548,548
6761,6761,6761,6761,6761,6761,6761,6761,6762,2020-12-20 15:00:00+00:00,Wicomico,2.0,550,,0,,0,,,0,550,550
6762,6762,6762,6762,6762,6762,6762,6762,6763,2020-12-21 15:00:00+00:00,Wicomico,29.0,579,2.0,2,,0,,,2,579,581
6763,6763,6763,6763,6763,6763,6763,6763,6764,2020-12-22 15:00:00+00:00,Wicomico,68.0,647,,2,,0,,,2,647,649
6764,6764,6764,6764,6764,6764,6764,6764,6765,2020-12-23 15:00:00+00:00,Wicomico,189.0,836,1.0,3,,0,,,3,836,839
6765,6765,6765,6765,6765,6765,6765,6765,6766,2020-12-24 15:00:00+00:00,Wicomico,129.0,965,,3,,0,,,3,965,968
6766,6766,6766,6766,6766,6766,6766,6766,6767,2020-12-25 15:00:00+00:00,Wicomico,3.0,968,,3,,0,,,3,968,971
6767,6767,6767,6767,6767,6767,6767,6767,6768,2020-12-26 15:00:00+00:00,Wicomico,5.0,973,1.0,4,,0,,,4,973,977
6768,6768,6768,6768,6768,6768,6768,6768,6769,2020-12-27 15:00:00+00:00,Wicomico,15.0,988,,4,,0,,,4,988,992
6769,6769,6769,6769,6769,6769,6769,6769,6770,2020-12-28 15:00:00+00:00,Wicomico,303.0,1291,2.0,6,,0,,,6,1291,1297
6770,6770,6770,6770,6770,6770,6770,6770,6771,2020-12-29 15:00:00+00:00,Wicomico,489.0,1780,3.0,9,,0,,,9,1780,1789
6771,6771,6771,6771,6771,6771,6771,6771,6772,2020-12-30 15:00:00+00:00,Wicomico,305.0,2085,4.0,13,,0,,,13,2085,2098
6772,6772,6772,6772,6772,6772,6772,6772,6773,2020-12-31 15:00:00+00:00,Wicomico,200.0,2285,1.0,14,,0,,,14,2285,2299
6773,6773,6773,6773,6773,6773,6773,6773,6774,2021-01-01 15:00:00+00:00,Wicomico,119.0,2404,6.0,20,,0,,,20,2404,2424
6774,6774,6774,6774,6774,6774,6774,6774,6775,2021-01-02 15:00:00+00:00,Wicomico,163.0,2567,1.0,21,,0,,,21,2567,2588
6775,6775,6775,6775,6775,6775,6775,6775,6776,2021-01-03 15:00:00+00:00,Wicomico,46.0,2613,2.0,23,,0,,,23,2613,2636
6776,6776,6776,6776,6776,6776,6776,6776,6777,2021-01-04 15:00:00+00:00,Wicomico,111.0,2724,3.0,26,,0,,,26,2724,2750
6777,6777,6777,6777,6777,6777,6777,6777,6778,2021-01-05 15:00:00+00:00,Wicomico,265.0,2989,2.0,28,,0,,,28,2989,3017
6778,6778,6778,6778,6778,6778,6778,6778,6779,2021-01-06 15:00:00+00:00,Wicomico,249.0,3238,6.0,34,,0,,,34,3238,3272
6779,6779,6779,6779,6779,6779,6779,6779,6780,2021-01-07 15:00:00+00:00,Wicomico,216.0,3454,102.0,136,,0,,,136,3454,3590
6780,6780,6780,6780,6780,6780,6780,6780,6781,2021-01-08 15:00:00+00:00,Wicomico,237.0,3691,325.0,461,,0,,,461,3691,4152
6781,6781,6781,6781,6781,6781,6781,6781,6782,2021-01-09 15:00:00+00:00,Wicomico,148.0,3839,109.0,570,,0,,,570,3839,4409
6782,6782,6782,6782,6782,6782,6782,6782,6783,2021-01-10 15:00:00+00:00,Wicomico,2.0,3841,2.0,572,,0,,,572,3841,4413
6783,6783,6783,6783,6783,6783,6783,6783,6784,2021-01-11 15:00:00+00:00,Wicomico,229.0,4070,20.0,592,,0,,,592,4070,4662
6784,6784,6784,6784,6784,6784,6784,6784,6785,2021-01-12 15:00:00+00:00,Wicomico,160.0,4230,33.0,625,,0,,,625,4230,4855
6785,6785,6785,6785,6785,6785,6785,6785,6786,2021-01-13 15:00:00+00:00,Wicomico,161.0,4391,157.0,782,,0,,,782,4391,5173
6786,6786,6786,6786,6786,6786,6786,6786,6787,2021-01-14 15:00:00+00:00,Wicomico,459.0,4850,105.0,887,,0,,,887,4850,5737
6787,6787,6787,6787,6787,6787,6787,6787,6788,2021-01-15 15:00:00+00:00,Wicomico,533.0,5383,19.0,906,,0,,,906,5383,6289
6788,6788,6788,6788,6788,6788,6788,6788,6789,2021-06-16 15:00:00+00:00,Unknown,344.0,175562,465.0,139188,41.0,18308,385.0,506.0,157496,193870,314750
6789,6789,6789,6789,6789,6789,6789,6789,6790,2021-06-17 15:00:00+00:00,Unknown,361.0,175923,511.0,139699,40.0,18348,401.0,551.0,158047,194271,315622
6790,6790,6790,6790,6790,6790,6790,6790,6791,2021-06-18 15:00:00+00:00,Unknown,347.0,176270,494.0,140193,68.0,18416,415.0,562.0,158609,194686,316463
6791,6791,6791,6791,6791,6791,6791,6791,6792,2021-06-19 15:00:00+00:00,Unknown,234.0,176504,318.0,140511,36.0,18452,270.0,354.0,158963,194956,317015
6792,6792,6792,6792,6792,6792,6792,6792,6793,2021-06-20 15:00:00+00:00,Unknown,126.0,176630,196.0,140707,22.0,18474,148.0,218.0,159181,195104,317337
6793,6793,6793,6793,6793,6793,6793,6793,6794,2021-06-21 15:00:00+00:00,Unknown,284.0,176914,196.0,140903,31.0,18505,315.0,227.0,159408,195419,317817
6794,6794,6794,6794,6794,6794,6794,6794,6795,2021-06-22 15:00:00+00:00,Unknown,270.0,177184,345.0,141248,44.0,18549,314.0,389.0,159797,195733,318432
6795,6795,6795,6795,6795,6795,6795,6795,6796,2021-06-23 15:00:00+00:00,Unknown,324.0,177508,368.0,141616,29.0,18578,353.0,397.0,160194,196086,319124
6796,6796,6796,6796,6796,6796,6796,6796,6797,2021-06-24 15:00:00+00:00,Unknown,307.0,177815,285.0,141901,26.0,18604,333.0,311.0,160505,196419,319716
6797,6797,6797,6797,6797,6797,6797,6797,6798,2021-06-25 15:00:00+00:00,Unknown,319.0,178134,356.0,142257,40.0,18644,359.0,396.0,160901,196778,320391
6798,6798,6798,6798,6798,6798,6798,6798,6799,2021-06-26 15:00:00+00:00,Unknown,231.0,178365,261.0,142518,22.0,18666,253.0,283.0,161184,197031,320883
6799,6799,6799,6799,6799,6799,6799,6799,6800,2021-06-27 15:00:00+00:00,Unknown,155.0,178520,115.0,142633,12.0,18678,167.0,127.0,161311,197198,321153
6800,6800,6800,6800,6800,6800,6800,6800,6801,2021-06-28 15:00:00+00:00,Unknown,323.0,178843,246.0,142879,25.0,18703,348.0,271.0,161582,197546,321722
6801,6801,6801,6801,6801,6801,6801,6801,6802,2021-06-29 15:00:00+00:00,Unknown,277.0,179120,244.0,143123,37.0,18740,314.0,281.0,161863,197860,322243
6802,6802,6802,6802,6802,6802,6802,6802,6803,2021-06-30 15:00:00+00:00,Unknown,302.0,179422,267.0,143390,26.0,18766,328.0,293.0,162156,198188,322812
6803,6803,6803,6803,6803,6803,6803,6803,6804,2021-07-01 15:00:00+00:00,Unknown,291.0,179713,275.0,143665,29.0,18795,320.0,304.0,162460,198508,323378
6804,6804,6804,6804,6804,6804,6804,6804,6805,2021-07-02 15:00:00+00:00,Unknown,264.0,179977,261.0,143926,23.0,18818,287.0,284.0,162744,198795,323903
6805,6805,6805,6805,6805,6805,6805,6805,6806,2021-07-03 15:00:00+00:00,Unknown,220.0,180197,147.0,144073,14.0,18832,234.0,161.0,162905,199029,324270
6806,6806,6806,6806,6806,6806,6806,6806,6807,2021-07-04 15:00:00+00:00,Unknown,37.0,180234,28.0,144101,7.0,18839,44.0,35.0,162940,199073,324335
6807,6807,6807,6807,6807,6807,6807,6807,6808,2021-07-05 15:00:00+00:00,Unknown,254.0,180488,201.0,144302,21.0,18860,275.0,222.0,163162,199348,324790
6808,6808,6808,6808,6808,6808,6808,6808,6809,2021-07-06 15:00:00+00:00,Unknown,289.0,180777,278.0,144580,43.0,18903,332.0,321.0,163483,199680,325357
6809,6809,6809,6809,6809,6809,6809,6809,6810,2021-07-07 15:00:00+00:00,Unknown,276.0,181053,259.0,144839,39.0,18942,315.0,298.0,163781,199995,325892
6810,6810,6810,6810,6810,6810,6810,6810,6811,2021-07-08 15:00:00+00:00,Unknown,290.0,181343,213.0,145052,30.0,18972,320.0,243.0,164024,200315,326395
6811,6811,6811,6811,6811,6811,6811,6811,6812,2021-07-09 15:00:00+00:00,Unknown,321.0,181664,221.0,145273,21.0,18993,342.0,242.0,164266,200657,326937
6812,6812,6812,6812,6812,6812,6812,6812,6813,2021-07-10 15:00:00+00:00,Unknown,231.0,181895,176.0,145449,26.0,19019,257.0,202.0,164468,200914,327344
6813,6813,6813,6813,6813,6813,6813,6813,6814,2021-07-11 15:00:00+00:00,Unknown,148.0,182043,105.0,145554,8.0,19027,156.0,113.0,164581,201070,327597
6814,6814,6814,6814,6814,6814,6814,6814,6815,2021-07-12 15:00:00+00:00,Unknown,219.0,182262,199.0,145753,22.0,19049,241.0,221.0,164802,201311,328015
6815,6815,6815,6815,6815,6815,6815,6815,6816,2021-07-13 15:00:00+00:00,Unknown,255.0,182517,175.0,145928,19.0,19068,274.0,194.0,164996,201585,328445
6816,6816,6816,6816,6816,6816,6816,6816,6817,2021-10-03 15:00:00+00:00,Garrett,2.0,11698,9.0,10659,,954,,,11613,12652,22357
6817,6817,6817,6817,6817,6817,6817,6817,6818,2021-10-04 15:00:00+00:00,Garrett,14.0,11712,8.0,10667,,954,,,11621,12666,22379
6818,6818,6818,6818,6818,6818,6818,6818,6819,2021-10-05 15:00:00+00:00,Garrett,23.0,11735,18.0,10685,1.0,955,24.0,19.0,11640,12690,22420
6819,6819,6819,6819,6819,6819,6819,6819,6820,2021-10-06 15:00:00+00:00,Garrett,5.0,11740,8.0,10693,1.0,956,6.0,9.0,11649,12696,22433
6820,6820,6820,6820,6820,6820,6820,6820,6821,2021-10-07 15:00:00+00:00,Garrett,13.0,11753,8.0,10701,4.0,960,17.0,12.0,11661,12713,22454
6821,6821,6821,6821,6821,6821,6821,6821,6822,2021-10-08 15:00:00+00:00,Garrett,22.0,11775,28.0,10729,2.0,962,24.0,30.0,11691,12737,22504
6822,6822,6822,6822,6822,6822,6822,6822,6823,2021-10-09 15:00:00+00:00,Garrett,12.0,11787,8.0,10737,,962,,,11699,12749,22524
6823,6823,6823,6823,6823,6823,6823,6823,6824,2021-10-10 15:00:00+00:00,Garrett,5.0,11792,3.0,10740,,962,,,11702,12754,22532
6824,6824,6824,6824,6824,6824,6824,6824,6825,2021-10-11 15:00:00+00:00,Garrett,10.0,11802,8.0,10748,,962,,,11710,12764,22550
6825,6825,6825,6825,6825,6825,6825,6825,6826,2021-10-12 15:00:00+00:00,Garrett,17.0,11819,14.0,10762,3.0,965,20.0,17.0,11727,12784,22581
6826,6826,6826,6826,6826,6826,6826,6826,6827,2021-10-13 15:00:00+00:00,Garrett,6.0,11825,17.0,10779,1.0,966,7.0,18.0,11745,12791,22604
6827,6827,6827,6827,6827,6827,6827,6827,6828,2021-10-14 15:00:00+00:00,Garrett,16.0,11841,14.0,10793,1.0,967,17.0,15.0,11760,12808,22634
6828,6828,6828,6828,6828,6828,6828,6828,6829,2021-10-15 15:00:00+00:00,Garrett,10.0,11851,15.0,10808,3.0,970,13.0,18.0,11778,12821,22659
6829,6829,6829,6829,6829,6829,6829,6829,6830,2021-10-16 15:00:00+00:00,Garrett,3.0,11854,6.0,10814,,970,,,11784,12824,22668
6830,6830,6830,6830,6830,6830,6830,6830,6831,2021-10-17 15:00:00+00:00,Garrett,6.0,11860,3.0,10817,,970,,,11787,12830,22677
6831,6831,6831,6831,6831,6831,6831,6831,6832,2021-10-18 15:00:00+00:00,Garrett,7.0,11867,9.0,10826,,970,,,11796,12837,22693
6832,6832,6832,6832,6832,6832,6832,6832,6833,2021-10-19 15:00:00+00:00,Garrett,14.0,11881,14.0,10840,2.0,972,16.0,16.0,11812,12853,22721
6833,6833,6833,6833,6833,6833,6833,6833,6834,2021-10-20 15:00:00+00:00,Garrett,9.0,11890,7.0,10847,,972,,,11819,12862,22737
6834,6834,6834,6834,6834,6834,6834,6834,6835,2021-10-21 15:00:00+00:00,Garrett,3.0,11893,5.0,10852,1.0,973,4.0,6.0,11825,12866,22745
6835,6835,6835,6835,6835,6835,6835,6835,6836,2021-10-22 15:00:00+00:00,Garrett,29.0,11922,22.0,10874,1.0,974,30.0,23.0,11848,12896,22796
6836,6836,6836,6836,6836,6836,6836,6836,6837,2021-10-23 15:00:00+00:00,Garrett,3.0,11925,7.0,10881,,974,,,11855,12899,22806
6837,6837,6837,6837,6837,6837,6837,6837,6838,2021-10-24 15:00:00+00:00,Garrett,6.0,11931,6.0,10887,,974,,,11861,12905,22818
6838,6838,6838,6838,6838,6838,6838,6838,6839,2021-10-25 15:00:00+00:00,Garrett,15.0,11946,23.0,10910,,974,,,11884,12920,22856
6839,6839,6839,6839,6839,6839,6839,6839,6840,2021-10-26 15:00:00+00:00,Garrett,23.0,11969,14.0,10924,3.0,977,26.0,17.0,11901,12946,22893
6840,6840,6840,6840,6840,6840,6840,6840,6841,2021-10-27 15:00:00+00:00,Garrett,12.0,11981,5.0,10929,1.0,978,13.0,6.0,11907,12959,22910
6841,6841,6841,6841,6841,6841,6841,6841,6842,2021-10-28 15:00:00+00:00,Garrett,4.0,11985,8.0,10937,,978,,,11915,12963,22922
6842,6842,6842,6842,6842,6842,6842,6842,6843,2021-10-29 15:00:00+00:00,Garrett,31.0,12016,16.0,10953,1.0,979,32.0,17.0,11932,12995,22969
6843,6843,6843,6843,6843,6843,6843,6843,6844,2021-10-30 15:00:00+00:00,Garrett,8.0,12024,3.0,10956,,979,,,11935,13003,22980
6844,6844,6844,6844,6844,6844,6844,6844,6845,2021-01-16 15:00:00+00:00,Wicomico,50.0,5433,3.0,909,,0,,,909,5433,6342
6845,6845,6845,6845,6845,6845,6845,6845,6846,2021-01-17 15:00:00+00:00,Wicomico,14.0,5447,15.0,924,,0,,,924,5447,6371
6846,6846,6846,6846,6846,6846,6846,6846,6847,2021-01-18 15:00:00+00:00,Wicomico,547.0,5994,26.0,950,,0,,,950,5994,6944
6847,6847,6847,6847,6847,6847,6847,6847,6848,2021-01-19 15:00:00+00:00,Wicomico,457.0,6451,165.0,1115,,0,,,1115,6451,7566
6848,6848,6848,6848,6848,6848,6848,6848,6849,2021-01-20 15:00:00+00:00,Wicomico,384.0,6835,32.0,1147,,0,,,1147,6835,7982
6849,6849,6849,6849,6849,6849,6849,6849,6850,2021-01-21 15:00:00+00:00,Wicomico,716.0,7551,61.0,1208,,0,,,1208,7551,8759
6850,6850,6850,6850,6850,6850,6850,6850,6851,2021-01-22 15:00:00+00:00,Wicomico,489.0,8040,103.0,1311,,0,,,1311,8040,9351
6851,6851,6851,6851,6851,6851,6851,6851,6852,2021-01-23 15:00:00+00:00,Wicomico,228.0,8268,107.0,1418,,0,,,1418,8268,9686
6852,6852,6852,6852,6852,6852,6852,6852,6853,2021-01-24 15:00:00+00:00,Wicomico,19.0,8287,32.0,1450,,0,,,1450,8287,9737
6853,6853,6853,6853,6853,6853,6853,6853,6854,2021-01-25 15:00:00+00:00,Wicomico,402.0,8689,285.0,1735,,0,,,1735,8689,10424
6854,6854,6854,6854,6854,6854,6854,6854,6855,2021-01-26 15:00:00+00:00,Wicomico,244.0,8933,305.0,2040,,0,,,2040,8933,10973
6855,6855,6855,6855,6855,6855,6855,6855,6856,2021-01-27 15:00:00+00:00,Wicomico,253.0,9186,303.0,2343,,0,,,2343,9186,11529
6856,6856,6856,6856,6856,6856,6856,6856,6857,2021-01-28 15:00:00+00:00,Wicomico,233.0,9419,161.0,2504,,0,,,2504,9419,11923
6857,6857,6857,6857,6857,6857,6857,6857,6858,2021-01-29 15:00:00+00:00,Wicomico,467.0,9886,166.0,2670,,0,,,2670,9886,12556
6858,6858,6858,6858,6858,6858,6858,6858,6859,2021-01-30 15:00:00+00:00,Wicomico,436.0,10322,83.0,2753,,0,,,2753,10322,13075
6859,6859,6859,6859,6859,6859,6859,6859,6860,2021-01-31 15:00:00+00:00,Wicomico,6.0,10328,36.0,2789,,0,,,2789,10328,13117
6860,6860,6860,6860,6860,6860,6860,6860,6861,2021-02-01 15:00:00+00:00,Wicomico,616.0,10944,50.0,2839,,0,,,2839,10944,13783
6861,6861,6861,6861,6861,6861,6861,6861,6862,2021-02-02 15:00:00+00:00,Wicomico,280.0,11224,280.0,3119,,0,,,3119,11224,14343
6862,6862,6862,6862,6862,6862,6862,6862,6863,2021-02-03 15:00:00+00:00,Wicomico,500.0,11724,182.0,3301,,0,,,3301,11724,15025
6863,6863,6863,6863,6863,6863,6863,6863,6864,2021-02-04 15:00:00+00:00,Wicomico,603.0,12327,350.0,3651,,0,,,3651,12327,15978
6864,6864,6864,6864,6864,6864,6864,6864,6865,2021-02-05 15:00:00+00:00,Wicomico,261.0,12588,356.0,4007,,0,,,4007,12588,16595
6865,6865,6865,6865,6865,6865,6865,6865,6866,2021-02-06 15:00:00+00:00,Wicomico,78.0,12666,23.0,4030,,0,,,4030,12666,16696
6866,6866,6866,6866,6866,6866,6866,6866,6867,2021-02-07 15:00:00+00:00,Wicomico,69.0,12735,11.0,4041,,0,,,4041,12735,16776
6867,6867,6867,6867,6867,6867,6867,6867,6868,2021-02-08 15:00:00+00:00,Wicomico,175.0,12910,329.0,4370,,0,,,4370,12910,17280
6868,6868,6868,6868,6868,6868,6868,6868,6869,2021-02-09 15:00:00+00:00,Wicomico,200.0,13110,172.0,4542,,0,,,4542,13110,17652
6869,6869,6869,6869,6869,6869,6869,6869,6870,2021-02-10 15:00:00+00:00,Wicomico,510.0,13620,345.0,4887,,0,,,4887,13620,18507
6870,6870,6870,6870,6870,6870,6870,6870,6871,2021-02-11 15:00:00+00:00,Wicomico,458.0,14078,450.0,5337,,0,,,5337,14078,19415
6871,6871,6871,6871,6871,6871,6871,6871,6872,2021-02-12 15:00:00+00:00,Wicomico,78.0,14156,54.0,5391,,0,,,5391,14156,19547
6872,6872,6872,6872,6872,6872,6872,6872,6873,2021-08-15 15:00:00+00:00,Washington,49.0,61799,34.0,56053,2.0,10706,51.0,36.0,66759,72505,117852
6873,6873,6873,6873,6873,6873,6873,6873,6874,2021-08-16 15:00:00+00:00,Washington,135.0,61934,89.0,56142,10.0,10716,145.0,99.0,66858,72650,118076
6874,6874,6874,6874,6874,6874,6874,6874,6875,2021-08-17 15:00:00+00:00,Washington,148.0,62082,158.0,56300,30.0,10746,178.0,188.0,67046,72828,118382
6875,6875,6875,6875,6875,6875,6875,6875,6876,2021-08-18 15:00:00+00:00,Washington,116.0,62198,102.0,56402,12.0,10758,128.0,114.0,67160,72956,118600
6876,6876,6876,6876,6876,6876,6876,6876,6877,2021-08-19 15:00:00+00:00,Washington,163.0,62361,199.0,56601,30.0,10788,193.0,229.0,67389,73149,118962
6877,6877,6877,6877,6877,6877,6877,6877,6878,2021-08-20 15:00:00+00:00,Washington,145.0,62506,104.0,56705,11.0,10799,156.0,115.0,67504,73305,119211
6878,6878,6878,6878,6878,6878,6878,6878,6879,2021-08-21 15:00:00+00:00,Washington,75.0,62581,67.0,56772,1.0,10800,76.0,68.0,67572,73381,119353
6879,6879,6879,6879,6879,6879,6879,6879,6880,2021-08-22 15:00:00+00:00,Washington,40.0,62621,46.0,56818,1.0,10801,41.0,47.0,67619,73422,119439
6880,6880,6880,6880,6880,6880,6880,6880,6881,2021-08-23 15:00:00+00:00,Washington,206.0,62827,98.0,56916,7.0,10808,213.0,105.0,67724,73635,119743
6881,6881,6881,6881,6881,6881,6881,6881,6882,2021-08-24 15:00:00+00:00,Washington,220.0,63047,135.0,57051,35.0,10843,255.0,170.0,67894,73890,120098
6882,6882,6882,6882,6882,6882,6882,6882,6883,2021-08-25 15:00:00+00:00,Washington,181.0,63228,99.0,57150,6.0,10849,187.0,105.0,67999,74077,120378
6883,6883,6883,6883,6883,6883,6883,6883,6884,2021-08-26 15:00:00+00:00,Washington,199.0,63427,236.0,57386,24.0,10873,223.0,260.0,68259,74300,120813
6884,6884,6884,6884,6884,6884,6884,6884,6885,2021-08-27 15:00:00+00:00,Washington,146.0,63573,144.0,57530,20.0,10893,166.0,164.0,68423,74466,121103
6885,6885,6885,6885,6885,6885,6885,6885,6886,2021-08-28 15:00:00+00:00,Washington,93.0,63666,92.0,57622,10.0,10903,103.0,102.0,68525,74569,121288
6886,6886,6886,6886,6886,6886,6886,6886,6887,2021-08-29 15:00:00+00:00,Washington,45.0,63711,35.0,57657,,10903,,,68560,74614,121368
6887,6887,6887,6887,6887,6887,6887,6887,6888,2021-08-30 15:00:00+00:00,Washington,152.0,63863,113.0,57770,6.0,10909,158.0,119.0,68679,74772,121633
6888,6888,6888,6888,6888,6888,6888,6888,6889,2021-08-31 15:00:00+00:00,Washington,96.0,63959,137.0,57907,13.0,10922,109.0,150.0,68829,74881,121866
6889,6889,6889,6889,6889,6889,6889,6889,6890,2021-09-01 15:00:00+00:00,Washington,120.0,64079,62.0,57969,20.0,10942,140.0,82.0,68911,75021,122048
6890,6890,6890,6890,6890,6890,6890,6890,6891,2021-09-02 15:00:00+00:00,Washington,121.0,64200,164.0,58133,13.0,10955,134.0,177.0,69088,75155,122333
6891,6891,6891,6891,6891,6891,6891,6891,6892,2021-09-03 15:00:00+00:00,Washington,119.0,64319,122.0,58255,16.0,10971,135.0,138.0,69226,75290,122574
6892,6892,6892,6892,6892,6892,6892,6892,6893,2021-09-04 15:00:00+00:00,Washington,78.0,64397,79.0,58334,,10971,,,69305,75368,122731
6893,6893,6893,6893,6893,6893,6893,6893,6894,2021-09-05 15:00:00+00:00,Washington,38.0,64435,44.0,58378,1.0,10972,39.0,45.0,69350,75407,122813
6894,6894,6894,6894,6894,6894,6894,6894,6895,2021-09-06 15:00:00+00:00,Washington,24.0,64459,23.0,58401,3.0,10975,27.0,26.0,69376,75434,122860
6895,6895,6895,6895,6895,6895,6895,6895,6896,2021-09-07 15:00:00+00:00,Washington,99.0,64558,189.0,58590,18.0,10993,117.0,207.0,69583,75551,123148
6896,6896,6896,6896,6896,6896,6896,6896,6897,2021-09-08 15:00:00+00:00,Washington,137.0,64695,102.0,58692,24.0,11017,161.0,126.0,69709,75712,123387
6897,6897,6897,6897,6897,6897,6897,6897,6898,2021-09-09 15:00:00+00:00,Washington,107.0,64802,127.0,58819,57.0,11074,164.0,184.0,69893,75876,123621
6898,6898,6898,6898,6898,6898,6898,6898,6899,2021-09-10 15:00:00+00:00,Washington,128.0,64930,133.0,58952,14.0,11088,142.0,147.0,70040,76018,123882
6899,6899,6899,6899,6899,6899,6899,6899,6900,2021-09-11 15:00:00+00:00,Washington,61.0,64991,79.0,59031,8.0,11096,69.0,87.0,70127,76087,124022
6900,6900,6900,6900,6900,6900,6900,6900,6901,2021-10-31 15:00:00+00:00,Garrett,5.0,12029,9.0,10965,1.0,980,6.0,10.0,11945,13009,22994
6901,6901,6901,6901,6901,6901,6901,6901,6902,2021-11-01 15:00:00+00:00,Garrett,20.0,12049,12.0,10977,,980,,,11957,13029,23026
6902,6902,6902,6902,6902,6902,6902,6902,6903,2021-11-02 15:00:00+00:00,Garrett,10.0,12059,16.0,10993,3.0,983,13.0,19.0,11976,13042,23052
6903,6903,6903,6903,6903,6903,6903,6903,6904,2021-11-03 15:00:00+00:00,Garrett,14.0,12073,9.0,11002,,983,,,11985,13056,23075
6904,6904,6904,6904,6904,6904,6904,6904,6905,2021-11-04 15:00:00+00:00,Garrett,7.0,12080,5.0,11007,1.0,984,8.0,6.0,11991,13064,23087
6905,6905,6905,6905,6905,6905,6905,6905,6906,2021-11-05 15:00:00+00:00,Garrett,19.0,12099,16.0,11023,,984,,,12007,13083,23122
6906,6906,6906,6906,6906,6906,6906,6906,6907,2021-11-06 15:00:00+00:00,Garrett,3.0,12102,5.0,11028,1.0,985,4.0,6.0,12013,13087,23130
6907,6907,6907,6907,6907,6907,6907,6907,6908,2020-12-14 15:00:00+00:00,Montgomery,6.0,6,,0,,0,,,0,6,6
6908,6908,6908,6908,6908,6908,6908,6908,6909,2020-12-15 15:00:00+00:00,Montgomery,11.0,17,,0,,0,,,0,17,17
6909,6909,6909,6909,6909,6909,6909,6909,6910,2020-12-16 15:00:00+00:00,Montgomery,31.0,48,,0,,0,,,0,48,48
6910,6910,6910,6910,6910,6910,6910,6910,6911,2020-12-17 15:00:00+00:00,Montgomery,94.0,142,,0,,0,,,0,142,142
6911,6911,6911,6911,6911,6911,6911,6911,6912,2020-12-18 15:00:00+00:00,Montgomery,327.0,469,2.0,2,,0,,,2,469,471
6912,6912,6912,6912,6912,6912,6912,6912,6913,2020-12-19 15:00:00+00:00,Montgomery,154.0,623,2.0,4,,0,,,4,623,627
6913,6913,6913,6913,6913,6913,6913,6913,6914,2020-12-20 15:00:00+00:00,Montgomery,91.0,714,2.0,6,,0,,,6,714,720
6914,6914,6914,6914,6914,6914,6914,6914,6915,2020-12-21 15:00:00+00:00,Montgomery,481.0,1195,6.0,12,,0,,,12,1195,1207
6915,6915,6915,6915,6915,6915,6915,6915,6916,2020-12-22 15:00:00+00:00,Montgomery,1054.0,2249,5.0,17,,0,,,17,2249,2266
6916,6916,6916,6916,6916,6916,6916,6916,6917,2020-12-23 15:00:00+00:00,Montgomery,742.0,2991,6.0,23,,0,,,23,2991,3014
6917,6917,6917,6917,6917,6917,6917,6917,6918,2020-12-24 15:00:00+00:00,Montgomery,257.0,3248,3.0,26,,0,,,26,3248,3274
6918,6918,6918,6918,6918,6918,6918,6918,6919,2020-12-25 15:00:00+00:00,Montgomery,227.0,3475,,26,,0,,,26,3475,3501
6919,6919,6919,6919,6919,6919,6919,6919,6920,2020-12-26 15:00:00+00:00,Montgomery,144.0,3619,2.0,28,,0,,,28,3619,3647
6920,6920,6920,6920,6920,6920,6920,6920,6921,2020-12-27 15:00:00+00:00,Montgomery,186.0,3805,2.0,30,,0,,,30,3805,3835
6921,6921,6921,6921,6921,6921,6921,6921,6922,2020-12-28 15:00:00+00:00,Montgomery,635.0,4440,6.0,36,,0,,,36,4440,4476
6922,6922,6922,6922,6922,6922,6922,6922,6923,2020-12-29 15:00:00+00:00,Montgomery,1051.0,5491,8.0,44,,0,,,44,5491,5535
6923,6923,6923,6923,6923,6923,6923,6923,6924,2020-12-30 15:00:00+00:00,Montgomery,1792.0,7283,13.0,57,,0,,,57,7283,7340
6924,6924,6924,6924,6924,6924,6924,6924,6925,2020-12-31 15:00:00+00:00,Montgomery,1367.0,8650,9.0,66,,0,,,66,8650,8716
6925,6925,6925,6925,6925,6925,6925,6925,6926,2021-01-01 15:00:00+00:00,Montgomery,536.0,9186,29.0,95,,0,,,95,9186,9281
6926,6926,6926,6926,6926,6926,6926,6926,6927,2021-01-02 15:00:00+00:00,Montgomery,481.0,9667,1.0,96,,0,,,96,9667,9763
6927,6927,6927,6927,6927,6927,6927,6927,6928,2021-01-03 15:00:00+00:00,Montgomery,429.0,10096,10.0,106,,0,,,106,10096,10202
6928,6928,6928,6928,6928,6928,6928,6928,6929,2021-07-14 15:00:00+00:00,Unknown,259.0,182776,204.0,146132,23.0,19091,282.0,227.0,165223,201867,328908
6929,6929,6929,6929,6929,6929,6929,6929,6930,2021-07-15 15:00:00+00:00,Unknown,279.0,183055,203.0,146335,22.0,19113,301.0,225.0,165448,202168,329390
6930,6930,6930,6930,6930,6930,6930,6930,6931,2021-07-16 15:00:00+00:00,Unknown,308.0,183363,240.0,146575,15.0,19128,323.0,255.0,165703,202491,329938
6931,6931,6931,6931,6931,6931,6931,6931,6932,2021-07-17 15:00:00+00:00,Unknown,201.0,183564,150.0,146725,12.0,19140,213.0,162.0,165865,202704,330289
6932,6932,6932,6932,6932,6932,6932,6932,6933,2021-07-18 15:00:00+00:00,Unknown,219.0,183783,96.0,146821,10.0,19150,229.0,106.0,165971,202933,330604
6933,6933,6933,6933,6933,6933,6933,6933,6934,2021-07-19 15:00:00+00:00,Unknown,311.0,184094,207.0,147028,17.0,19167,328.0,224.0,166195,203261,331122
6934,6934,6934,6934,6934,6934,6934,6934,6935,2021-07-20 15:00:00+00:00,Unknown,343.0,184437,193.0,147221,33.0,19200,376.0,226.0,166421,203637,331658
6935,6935,6935,6935,6935,6935,6935,6935,6936,2021-07-21 15:00:00+00:00,Unknown,280.0,184717,188.0,147409,24.0,19224,304.0,212.0,166633,203941,332126
6936,6936,6936,6936,6936,6936,6936,6936,6937,2021-07-22 15:00:00+00:00,Unknown,412.0,185129,209.0,147618,34.0,19258,446.0,243.0,166876,204387,332747
6937,6937,6937,6937,6937,6937,6937,6937,6938,2021-07-23 15:00:00+00:00,Unknown,397.0,185526,201.0,147819,21.0,19279,418.0,222.0,167098,204805,333345
6938,6938,6938,6938,6938,6938,6938,6938,6939,2021-07-24 15:00:00+00:00,Unknown,252.0,185778,129.0,147948,13.0,19292,265.0,142.0,167240,205070,333726
6939,6939,6939,6939,6939,6939,6939,6939,6940,2021-07-25 15:00:00+00:00,Unknown,221.0,185999,47.0,147995,5.0,19297,226.0,52.0,167292,205296,333994
6940,6940,6940,6940,6940,6940,6940,6940,6941,2021-07-26 15:00:00+00:00,Unknown,362.0,186361,175.0,148170,17.0,19314,379.0,192.0,167484,205675,334531
6941,6941,6941,6941,6941,6941,6941,6941,6942,2021-07-27 15:00:00+00:00,Unknown,372.0,186733,187.0,148357,24.0,19338,396.0,211.0,167695,206071,335090
6942,6942,6942,6942,6942,6942,6942,6942,6943,2021-07-28 15:00:00+00:00,Unknown,370.0,187103,190.0,148547,20.0,19358,390.0,210.0,167905,206461,335650
6943,6943,6943,6943,6943,6943,6943,6943,6944,2021-07-29 15:00:00+00:00,Unknown,386.0,187489,187.0,148734,18.0,19376,404.0,205.0,168110,206865,336223
6944,6944,6944,6944,6944,6944,6944,6944,6945,2021-07-30 15:00:00+00:00,Unknown,469.0,187958,210.0,148944,22.0,19398,491.0,232.0,168342,207356,336902
6945,6945,6945,6945,6945,6945,6945,6945,6946,2021-07-31 15:00:00+00:00,Unknown,241.0,188199,144.0,149088,10.0,19408,251.0,154.0,168496,207607,337287
6946,6946,6946,6946,6946,6946,6946,6946,6947,2021-08-01 15:00:00+00:00,Unknown,267.0,188466,96.0,149184,7.0,19415,274.0,103.0,168599,207881,337650
6947,6947,6947,6947,6947,6947,6947,6947,6948,2021-08-02 15:00:00+00:00,Unknown,400.0,188866,162.0,149346,29.0,19444,429.0,191.0,168790,208310,338212
6948,6948,6948,6948,6948,6948,6948,6948,6949,2021-08-03 15:00:00+00:00,Unknown,410.0,189276,161.0,149507,37.0,19481,447.0,198.0,168988,208757,338783
6949,6949,6949,6949,6949,6949,6949,6949,6950,2021-08-04 15:00:00+00:00,Unknown,435.0,189711,166.0,149673,31.0,19512,466.0,197.0,169185,209223,339384
6950,6950,6950,6950,6950,6950,6950,6950,6951,2021-08-05 15:00:00+00:00,Unknown,454.0,190165,173.0,149846,39.0,19551,493.0,212.0,169397,209716,340011
6951,6951,6951,6951,6951,6951,6951,6951,6952,2021-08-06 15:00:00+00:00,Unknown,481.0,190646,211.0,150057,39.0,19590,520.0,250.0,169647,210236,340703
6952,6952,6952,6952,6952,6952,6952,6952,6953,2021-08-07 15:00:00+00:00,Unknown,282.0,190928,114.0,150171,19.0,19609,301.0,133.0,169780,210537,341099
6953,6953,6953,6953,6953,6953,6953,6953,6954,2021-08-08 15:00:00+00:00,Unknown,273.0,191201,112.0,150283,10.0,19619,283.0,122.0,169902,210820,341484
6954,6954,6954,6954,6954,6954,6954,6954,6955,2021-08-09 15:00:00+00:00,Unknown,409.0,191610,174.0,150457,24.0,19643,433.0,198.0,170100,211253,342067
6955,6955,6955,6955,6955,6955,6955,6955,6956,2021-08-10 15:00:00+00:00,Unknown,425.0,192035,195.0,150652,21.0,19664,446.0,216.0,170316,211699,342687
6956,6956,6956,6956,6956,6956,6956,6956,6957,2021-02-13 15:00:00+00:00,Wicomico,23.0,14179,45.0,5436,,0,,,5436,14179,19615
6957,6957,6957,6957,6957,6957,6957,6957,6958,2021-02-14 15:00:00+00:00,Wicomico,16.0,14195,1.0,5437,,0,,,5437,14195,19632
6958,6958,6958,6958,6958,6958,6958,6958,6959,2021-02-15 15:00:00+00:00,Wicomico,38.0,14233,415.0,5852,,0,,,5852,14233,20085
6959,6959,6959,6959,6959,6959,6959,6959,6960,2021-02-16 15:00:00+00:00,Wicomico,265.0,14498,575.0,6427,,0,,,6427,14498,20925
6960,6960,6960,6960,6960,6960,6960,6960,6961,2021-02-17 15:00:00+00:00,Wicomico,356.0,14854,479.0,6906,,0,,,6906,14854,21760
6961,6961,6961,6961,6961,6961,6961,6961,6962,2021-02-18 15:00:00+00:00,Wicomico,131.0,14985,445.0,7351,,0,,,7351,14985,22336
6962,6962,6962,6962,6962,6962,6962,6962,6963,2021-02-19 15:00:00+00:00,Wicomico,258.0,15243,719.0,8070,,0,,,8070,15243,23313
6963,6963,6963,6963,6963,6963,6963,6963,6964,2021-02-20 15:00:00+00:00,Wicomico,361.0,15604,224.0,8294,,0,,,8294,15604,23898
6964,6964,6964,6964,6964,6964,6964,6964,6965,2021-02-21 15:00:00+00:00,Wicomico,28.0,15632,3.0,8297,,0,,,8297,15632,23929
6965,6965,6965,6965,6965,6965,6965,6965,6966,2021-02-22 15:00:00+00:00,Wicomico,61.0,15693,353.0,8650,,0,,,8650,15693,24343
6966,6966,6966,6966,6966,6966,6966,6966,6967,2021-02-23 15:00:00+00:00,Wicomico,15.0,15708,456.0,9106,,0,,,9106,15708,24814
6967,6967,6967,6967,6967,6967,6967,6967,6968,2021-02-24 15:00:00+00:00,Wicomico,213.0,15921,502.0,9608,,0,,,9608,15921,25529
6968,6968,6968,6968,6968,6968,6968,6968,6969,2021-02-25 15:00:00+00:00,Wicomico,256.0,16177,431.0,10039,,0,,,10039,16177,26216
6969,6969,6969,6969,6969,6969,6969,6969,6970,2021-02-26 15:00:00+00:00,Wicomico,362.0,16539,562.0,10601,,0,,,10601,16539,27140
6970,6970,6970,6970,6970,6970,6970,6970,6971,2021-02-27 15:00:00+00:00,Wicomico,79.0,16618,87.0,10688,,0,,,10688,16618,27306
6971,6971,6971,6971,6971,6971,6971,6971,6972,2021-02-28 15:00:00+00:00,Wicomico,37.0,16655,8.0,10696,,0,,,10696,16655,27351
6972,6972,6972,6972,6972,6972,6972,6972,6973,2021-03-01 15:00:00+00:00,Wicomico,233.0,16888,326.0,11022,,0,,,11022,16888,27910
6973,6973,6973,6973,6973,6973,6973,6973,6974,2021-03-02 15:00:00+00:00,Wicomico,223.0,17111,140.0,11162,,0,,,11162,17111,28273
6974,6974,6974,6974,6974,6974,6974,6974,6975,2021-03-03 15:00:00+00:00,Wicomico,378.0,17489,502.0,11664,,0,,,11664,17489,29153
6975,6975,6975,6975,6975,6975,6975,6975,6976,2021-03-04 15:00:00+00:00,Wicomico,218.0,17707,644.0,12308,2.0,2,220.0,646.0,12310,17709,30015
6976,6976,6976,6976,6976,6976,6976,6976,6977,2021-03-05 15:00:00+00:00,Wicomico,560.0,18267,317.0,12625,57.0,59,617.0,374.0,12684,18326,30892
6977,6977,6977,6977,6977,6977,6977,6977,6978,2021-03-06 15:00:00+00:00,Wicomico,35.0,18302,68.0,12693,12.0,71,47.0,80.0,12764,18373,30995
6978,6978,6978,6978,6978,6978,6978,6978,6979,2021-03-07 15:00:00+00:00,Wicomico,45.0,18347,8.0,12701,4.0,75,49.0,12.0,12776,18422,31048
6979,6979,6979,6979,6979,6979,6979,6979,6980,2021-03-08 15:00:00+00:00,Wicomico,516.0,18863,152.0,12853,9.0,84,525.0,161.0,12937,18947,31716
6980,6980,6980,6980,6980,6980,6980,6980,6981,2021-03-09 15:00:00+00:00,Wicomico,306.0,19169,296.0,13149,26.0,110,332.0,322.0,13259,19279,32318
6981,6981,6981,6981,6981,6981,6981,6981,6982,2021-03-10 15:00:00+00:00,Wicomico,504.0,19673,347.0,13496,7.0,117,511.0,354.0,13613,19790,33169
6982,6982,6982,6982,6982,6982,6982,6982,6983,2021-03-11 15:00:00+00:00,Wicomico,547.0,20220,357.0,13853,84.0,201,631.0,441.0,14054,20421,34073
6983,6983,6983,6983,6983,6983,6983,6983,6984,2021-03-12 15:00:00+00:00,Wicomico,646.0,20866,186.0,14039,25.0,226,671.0,211.0,14265,21092,34905
6984,6984,6984,6984,6984,6984,6984,6984,6985,2021-09-12 15:00:00+00:00,Washington,45.0,65036,48.0,59079,,11096,,,70175,76132,124115
6985,6985,6985,6985,6985,6985,6985,6985,6986,2021-09-13 15:00:00+00:00,Washington,112.0,65148,118.0,59197,12.0,11108,124.0,130.0,70305,76256,124345
6986,6986,6986,6986,6986,6986,6986,6986,6987,2021-09-14 15:00:00+00:00,Washington,78.0,65226,129.0,59326,18.0,11126,96.0,147.0,70452,76352,124552
6987,6987,6987,6987,6987,6987,6987,6987,6988,2021-09-15 15:00:00+00:00,Washington,252.0,65478,204.0,59530,22.0,11148,274.0,226.0,70678,76626,125008
6988,6988,6988,6988,6988,6988,6988,6988,6989,2021-09-16 15:00:00+00:00,Washington,118.0,65596,265.0,59795,8.0,11156,126.0,273.0,70951,76752,125391
6989,6989,6989,6989,6989,6989,6989,6989,6990,2021-09-17 15:00:00+00:00,Washington,90.0,65686,136.0,59931,19.0,11175,109.0,155.0,71106,76861,125617
6990,6990,6990,6990,6990,6990,6990,6990,6991,2021-09-18 15:00:00+00:00,Washington,52.0,65738,91.0,60022,1.0,11176,53.0,92.0,71198,76914,125760
6991,6991,6991,6991,6991,6991,6991,6991,6992,2021-09-19 15:00:00+00:00,Washington,28.0,65766,40.0,60062,1.0,11177,29.0,41.0,71239,76943,125828
6992,6992,6992,6992,6992,6992,6992,6992,6993,2021-09-20 15:00:00+00:00,Washington,94.0,65860,127.0,60189,16.0,11193,110.0,143.0,71382,77053,126049
6993,6993,6993,6993,6993,6993,6993,6993,6994,2021-09-21 15:00:00+00:00,Washington,76.0,65936,118.0,60307,21.0,11214,97.0,139.0,71521,77150,126243
6994,6994,6994,6994,6994,6994,6994,6994,6995,2021-09-22 15:00:00+00:00,Washington,103.0,66039,122.0,60429,14.0,11228,117.0,136.0,71657,77267,126468
6995,6995,6995,6995,6995,6995,6995,6995,6996,2021-09-23 15:00:00+00:00,Washington,82.0,66121,87.0,60516,9.0,11237,91.0,96.0,71753,77358,126637
6996,6996,6996,6996,6996,6996,6996,6996,6997,2021-09-24 15:00:00+00:00,Washington,93.0,66214,113.0,60629,12.0,11249,105.0,125.0,71878,77463,126843
6997,6997,6997,6997,6997,6997,6997,6997,6998,2021-09-25 15:00:00+00:00,Washington,60.0,66274,62.0,60691,1.0,11250,61.0,63.0,71941,77524,126965
6998,6998,6998,6998,6998,6998,6998,6998,6999,2021-09-26 15:00:00+00:00,Washington,18.0,66292,40.0,60731,,11250,,,71981,77542,127023
6999,6999,6999,6999,6999,6999,6999,6999,7000,2021-09-27 15:00:00+00:00,Washington,77.0,66369,63.0,60794,13.0,11263,90.0,76.0,72057,77632,127163
7000,7000,7000,7000,7000,7000,7000,7000,7001,2021-09-28 15:00:00+00:00,Washington,79.0,66448,69.0,60863,7.0,11270,86.0,76.0,72133,77718,127311
7001,7001,7001,7001,7001,7001,7001,7001,7002,2021-09-29 15:00:00+00:00,Washington,90.0,66538,98.0,60961,15.0,11285,105.0,113.0,72246,77823,127499
7002,7002,7002,7002,7002,7002,7002,7002,7003,2021-09-30 15:00:00+00:00,Washington,83.0,66621,133.0,61094,7.0,11292,90.0,140.0,72386,77913,127715
7003,7003,7003,7003,7003,7003,7003,7003,7004,2021-10-01 15:00:00+00:00,Washington,98.0,66719,128.0,61222,14.0,11306,112.0,142.0,72528,78025,127941
7004,7004,7004,7004,7004,7004,7004,7004,7005,2021-10-02 15:00:00+00:00,Washington,51.0,66770,64.0,61286,9.0,11315,60.0,73.0,72601,78085,128056
7005,7005,7005,7005,7005,7005,7005,7005,7006,2021-10-03 15:00:00+00:00,Washington,25.0,66795,39.0,61325,1.0,11316,26.0,40.0,72641,78111,128120
7006,7006,7006,7006,7006,7006,7006,7006,7007,2021-10-04 15:00:00+00:00,Washington,91.0,66886,77.0,61402,10.0,11326,101.0,87.0,72728,78212,128288
7007,7007,7007,7007,7007,7007,7007,7007,7008,2021-10-05 15:00:00+00:00,Washington,71.0,66957,64.0,61466,11.0,11337,82.0,75.0,72803,78294,128423
7008,7008,7008,7008,7008,7008,7008,7008,7009,2021-10-06 15:00:00+00:00,Washington,80.0,67037,109.0,61575,10.0,11347,90.0,119.0,72922,78384,128612
7009,7009,7009,7009,7009,7009,7009,7009,7010,2021-10-07 15:00:00+00:00,Washington,87.0,67124,104.0,61679,7.0,11354,94.0,111.0,73033,78478,128803
7010,7010,7010,7010,7010,7010,7010,7010,7011,2021-10-08 15:00:00+00:00,Washington,67.0,67191,97.0,61776,26.0,11380,93.0,123.0,73156,78571,128967
7011,7011,7011,7011,7011,7011,7011,7011,7012,2021-10-09 15:00:00+00:00,Washington,38.0,67229,50.0,61826,3.0,11383,41.0,53.0,73209,78612,129055
7012,7012,7012,7012,7012,7012,7012,7012,7013,2021-01-04 15:00:00+00:00,Montgomery,2663.0,12759,38.0,144,,0,,,144,12759,12903
7013,7013,7013,7013,7013,7013,7013,7013,7014,2021-01-05 15:00:00+00:00,Montgomery,1353.0,14112,109.0,253,,0,,,253,14112,14365
7014,7014,7014,7014,7014,7014,7014,7014,7015,2021-01-06 15:00:00+00:00,Montgomery,2141.0,16253,57.0,310,,0,,,310,16253,16563
7015,7015,7015,7015,7015,7015,7015,7015,7016,2021-01-07 15:00:00+00:00,Montgomery,2681.0,18934,285.0,595,,0,,,595,18934,19529
7016,7016,7016,7016,7016,7016,7016,7016,7017,2021-01-08 15:00:00+00:00,Montgomery,2806.0,21740,273.0,868,,0,,,868,21740,22608
7017,7017,7017,7017,7017,7017,7017,7017,7018,2021-01-09 15:00:00+00:00,Montgomery,757.0,22497,132.0,1000,,0,,,1000,22497,23497
7018,7018,7018,7018,7018,7018,7018,7018,7019,2021-01-10 15:00:00+00:00,Montgomery,684.0,23181,119.0,1119,,0,,,1119,23181,24300
7019,7019,7019,7019,7019,7019,7019,7019,7020,2021-01-11 15:00:00+00:00,Montgomery,1746.0,24927,479.0,1598,,0,,,1598,24927,26525
7020,7020,7020,7020,7020,7020,7020,7020,7021,2021-01-12 15:00:00+00:00,Montgomery,2597.0,27524,984.0,2582,,0,,,2582,27524,30106
7021,7021,7021,7021,7021,7021,7021,7021,7022,2021-01-13 15:00:00+00:00,Montgomery,2412.0,29936,454.0,3036,,0,,,3036,29936,32972
7022,7022,7022,7022,7022,7022,7022,7022,7023,2021-01-14 15:00:00+00:00,Montgomery,2337.0,32273,186.0,3222,,0,,,3222,32273,35495
7023,7023,7023,7023,7023,7023,7023,7023,7024,2021-01-15 15:00:00+00:00,Montgomery,2681.0,34954,306.0,3528,,0,,,3528,34954,38482
7024,7024,7024,7024,7024,7024,7024,7024,7025,2021-01-16 15:00:00+00:00,Montgomery,440.0,35394,77.0,3605,,0,,,3605,35394,38999
7025,7025,7025,7025,7025,7025,7025,7025,7026,2021-01-17 15:00:00+00:00,Montgomery,309.0,35703,82.0,3687,,0,,,3687,35703,39390
7026,7026,7026,7026,7026,7026,7026,7026,7027,2021-01-18 15:00:00+00:00,Montgomery,450.0,36153,581.0,4268,,0,,,4268,36153,40421
7027,7027,7027,7027,7027,7027,7027,7027,7028,2021-01-19 15:00:00+00:00,Montgomery,2668.0,38821,518.0,4786,,0,,,4786,38821,43607
7028,7028,7028,7028,7028,7028,7028,7028,7029,2021-01-20 15:00:00+00:00,Montgomery,3429.0,42250,547.0,5333,,0,,,5333,42250,47583
7029,7029,7029,7029,7029,7029,7029,7029,7030,2021-01-21 15:00:00+00:00,Montgomery,3459.0,45709,262.0,5595,,0,,,5595,45709,51304
7030,7030,7030,7030,7030,7030,7030,7030,7031,2021-01-22 15:00:00+00:00,Montgomery,4980.0,50689,683.0,6278,,0,,,6278,50689,56967
7031,7031,7031,7031,7031,7031,7031,7031,7032,2021-01-23 15:00:00+00:00,Montgomery,1914.0,52603,400.0,6678,,0,,,6678,52603,59281
7032,7032,7032,7032,7032,7032,7032,7032,7033,2021-01-24 15:00:00+00:00,Montgomery,661.0,53264,239.0,6917,,0,,,6917,53264,60181
7033,7033,7033,7033,7033,7033,7033,7033,7034,2021-01-25 15:00:00+00:00,Montgomery,2473.0,55737,1119.0,8036,,0,,,8036,55737,63773
7034,7034,7034,7034,7034,7034,7034,7034,7035,2021-01-26 15:00:00+00:00,Montgomery,3353.0,59090,768.0,8804,,0,,,8804,59090,67894
7035,7035,7035,7035,7035,7035,7035,7035,7036,2021-01-27 15:00:00+00:00,Montgomery,3467.0,62557,1782.0,10586,,0,,,10586,62557,73143
7036,7036,7036,7036,7036,7036,7036,7036,7037,2021-01-28 15:00:00+00:00,Montgomery,3848.0,66405,1476.0,12062,,0,,,12062,66405,78467
7037,7037,7037,7037,7037,7037,7037,7037,7038,2021-01-29 15:00:00+00:00,Montgomery,4570.0,70975,1000.0,13062,,0,,,13062,70975,84037
7038,7038,7038,7038,7038,7038,7038,7038,7039,2021-01-30 15:00:00+00:00,Montgomery,2771.0,73746,278.0,13340,,0,,,13340,73746,87086
7039,7039,7039,7039,7039,7039,7039,7039,7040,2021-01-31 15:00:00+00:00,Montgomery,1045.0,74791,188.0,13528,,0,,,13528,74791,88319
7040,7040,7040,7040,7040,7040,7040,7040,7041,2021-03-13 15:00:00+00:00,Wicomico,100.0,20966,328.0,14367,26.0,252,126.0,354.0,14619,21218,35333
7041,7041,7041,7041,7041,7041,7041,7041,7042,2021-03-14 15:00:00+00:00,Wicomico,32.0,20998,11.0,14378,15.0,267,47.0,26.0,14645,21265,35376
7042,7042,7042,7042,7042,7042,7042,7042,7043,2021-03-15 15:00:00+00:00,Wicomico,134.0,21132,34.0,14412,6.0,273,140.0,40.0,14685,21405,35544
7043,7043,7043,7043,7043,7043,7043,7043,7044,2021-03-16 15:00:00+00:00,Wicomico,580.0,21712,105.0,14517,,273,,,14790,21985,36229
7044,7044,7044,7044,7044,7044,7044,7044,7045,2021-03-17 15:00:00+00:00,Wicomico,221.0,21933,372.0,14889,43.0,316,264.0,415.0,15205,22249,36822
7045,7045,7045,7045,7045,7045,7045,7045,7046,2021-03-18 15:00:00+00:00,Wicomico,650.0,22583,122.0,15011,9.0,325,659.0,131.0,15336,22908,37594
7046,7046,7046,7046,7046,7046,7046,7046,7047,2021-03-19 15:00:00+00:00,Wicomico,309.0,22892,200.0,15211,25.0,350,334.0,225.0,15561,23242,38103
7047,7047,7047,7047,7047,7047,7047,7047,7048,2021-03-20 15:00:00+00:00,Wicomico,200.0,23092,16.0,15227,4.0,354,204.0,20.0,15581,23446,38319
7048,7048,7048,7048,7048,7048,7048,7048,7049,2021-03-21 15:00:00+00:00,Wicomico,224.0,23316,7.0,15234,,354,,,15588,23670,38550
7049,7049,7049,7049,7049,7049,7049,7049,7050,2021-03-22 15:00:00+00:00,Wicomico,586.0,23902,43.0,15277,26.0,380,612.0,69.0,15657,24282,39179
7050,7050,7050,7050,7050,7050,7050,7050,7051,2021-03-23 15:00:00+00:00,Wicomico,596.0,24498,75.0,15352,25.0,405,621.0,100.0,15757,24903,39850
7051,7051,7051,7051,7051,7051,7051,7051,7052,2021-03-24 15:00:00+00:00,Wicomico,667.0,25165,123.0,15475,28.0,433,695.0,151.0,15908,25598,40640
7052,7052,7052,7052,7052,7052,7052,7052,7053,2021-03-25 15:00:00+00:00,Wicomico,828.0,25993,348.0,15823,52.0,485,880.0,400.0,16308,26478,41816
7053,7053,7053,7053,7053,7053,7053,7053,7054,2021-03-26 15:00:00+00:00,Wicomico,699.0,26692,345.0,16168,72.0,557,771.0,417.0,16725,27249,42860
7054,7054,7054,7054,7054,7054,7054,7054,7055,2021-03-27 15:00:00+00:00,Wicomico,171.0,26863,52.0,16220,16.0,573,187.0,68.0,16793,27436,43083
7055,7055,7055,7055,7055,7055,7055,7055,7056,2021-03-28 15:00:00+00:00,Wicomico,113.0,26976,27.0,16247,2.0,575,115.0,29.0,16822,27551,43223
7056,7056,7056,7056,7056,7056,7056,7056,7057,2021-03-29 15:00:00+00:00,Wicomico,647.0,27623,156.0,16403,55.0,630,702.0,211.0,17033,28253,44026
7057,7057,7057,7057,7057,7057,7057,7057,7058,2021-03-30 15:00:00+00:00,Wicomico,478.0,28101,413.0,16816,94.0,724,572.0,507.0,17540,28825,44917
7058,7058,7058,7058,7058,7058,7058,7058,7059,2021-03-31 15:00:00+00:00,Wicomico,482.0,28583,542.0,17358,88.0,812,570.0,630.0,18170,29395,45941
7059,7059,7059,7059,7059,7059,7059,7059,7060,2021-04-01 15:00:00+00:00,Wicomico,481.0,29064,404.0,17762,104.0,916,585.0,508.0,18678,29980,46826
7060,7060,7060,7060,7060,7060,7060,7060,7061,2021-04-02 15:00:00+00:00,Wicomico,411.0,29475,537.0,18299,77.0,993,488.0,614.0,19292,30468,47774
7061,7061,7061,7061,7061,7061,7061,7061,7062,2021-04-03 15:00:00+00:00,Wicomico,212.0,29687,39.0,18338,22.0,1015,234.0,61.0,19353,30702,48025
7062,7062,7062,7062,7062,7062,7062,7062,7063,2021-04-04 15:00:00+00:00,Wicomico,25.0,29712,28.0,18366,1.0,1016,26.0,29.0,19382,30728,48078
7063,7063,7063,7063,7063,7063,7063,7063,7064,2021-04-05 15:00:00+00:00,Wicomico,315.0,30027,517.0,18883,121.0,1137,436.0,638.0,20020,31164,48910
7064,7064,7064,7064,7064,7064,7064,7064,7065,2021-04-06 15:00:00+00:00,Wicomico,467.0,30494,468.0,19351,148.0,1285,615.0,616.0,20636,31779,49845
7065,7065,7065,7065,7065,7065,7065,7065,7066,2021-04-07 15:00:00+00:00,Wicomico,267.0,30761,538.0,19889,237.0,1522,504.0,775.0,21411,32283,50650
7066,7066,7066,7066,7066,7066,7066,7066,7067,2021-04-08 15:00:00+00:00,Wicomico,264.0,31025,570.0,20459,489.0,2011,753.0,1059.0,22470,33036,51484
7067,7067,7067,7067,7067,7067,7067,7067,7068,2021-04-09 15:00:00+00:00,Wicomico,315.0,31340,471.0,20930,230.0,2241,545.0,701.0,23171,33581,52270
7068,7068,7068,7068,7068,7068,7068,7068,7069,2021-10-10 15:00:00+00:00,Washington,13.0,67242,53.0,61879,,11383,,,73262,78625,129121
7069,7069,7069,7069,7069,7069,7069,7069,7070,2021-10-11 15:00:00+00:00,Washington,80.0,67322,91.0,61970,16.0,11399,96.0,107.0,73369,78721,129292
7070,7070,7070,7070,7070,7070,7070,7070,7071,2021-10-12 15:00:00+00:00,Washington,54.0,67376,80.0,62050,27.0,11426,81.0,107.0,73476,78802,129426
7071,7071,7071,7071,7071,7071,7071,7071,7072,2021-10-13 15:00:00+00:00,Washington,58.0,67434,130.0,62180,24.0,11450,82.0,154.0,73630,78884,129614
7072,7072,7072,7072,7072,7072,7072,7072,7073,2021-10-14 15:00:00+00:00,Washington,82.0,67516,231.0,62411,3.0,11453,85.0,234.0,73864,78969,129927
7073,7073,7073,7073,7073,7073,7073,7073,7074,2021-10-15 15:00:00+00:00,Washington,67.0,67583,74.0,62485,11.0,11464,78.0,85.0,73949,79047,130068
7074,7074,7074,7074,7074,7074,7074,7074,7075,2021-10-16 15:00:00+00:00,Washington,38.0,67621,43.0,62528,5.0,11469,43.0,48.0,73997,79090,130149
7075,7075,7075,7075,7075,7075,7075,7075,7076,2021-10-17 15:00:00+00:00,Washington,19.0,67640,19.0,62547,,11469,,,74016,79109,130187
7076,7076,7076,7076,7076,7076,7076,7076,7077,2021-10-18 15:00:00+00:00,Washington,62.0,67702,78.0,62625,7.0,11476,69.0,85.0,74101,79178,130327
7077,7077,7077,7077,7077,7077,7077,7077,7078,2021-10-19 15:00:00+00:00,Washington,62.0,67764,76.0,62701,7.0,11483,69.0,83.0,74184,79247,130465
7078,7078,7078,7078,7078,7078,7078,7078,7079,2021-10-20 15:00:00+00:00,Washington,48.0,67812,83.0,62784,13.0,11496,61.0,96.0,74280,79308,130596
7079,7079,7079,7079,7079,7079,7079,7079,7080,2021-10-21 15:00:00+00:00,Washington,46.0,67858,81.0,62865,10.0,11506,56.0,91.0,74371,79364,130723
7080,7080,7080,7080,7080,7080,7080,7080,7081,2021-10-22 15:00:00+00:00,Washington,86.0,67944,141.0,63006,18.0,11524,104.0,159.0,74530,79468,130950
7081,7081,7081,7081,7081,7081,7081,7081,7082,2021-10-23 15:00:00+00:00,Washington,26.0,67970,55.0,63061,6.0,11530,32.0,61.0,74591,79500,131031
7082,7082,7082,7082,7082,7082,7082,7082,7083,2021-10-24 15:00:00+00:00,Washington,25.0,67995,39.0,63100,,11530,,,74630,79525,131095
7083,7083,7083,7083,7083,7083,7083,7083,7084,2021-10-25 15:00:00+00:00,Washington,69.0,68064,142.0,63242,18.0,11548,87.0,160.0,74790,79612,131306
7084,7084,7084,7084,7084,7084,7084,7084,7085,2021-10-26 15:00:00+00:00,Washington,83.0,68147,131.0,63373,11.0,11559,94.0,142.0,74932,79706,131520
7085,7085,7085,7085,7085,7085,7085,7085,7086,2021-10-27 15:00:00+00:00,Washington,100.0,68247,155.0,63528,15.0,11574,115.0,170.0,75102,79821,131775
7086,7086,7086,7086,7086,7086,7086,7086,7087,2021-10-28 15:00:00+00:00,Washington,89.0,68336,183.0,63711,12.0,11586,101.0,195.0,75297,79922,132047
7087,7087,7087,7087,7087,7087,7087,7087,7088,2021-10-29 15:00:00+00:00,Washington,101.0,68437,152.0,63863,22.0,11608,123.0,174.0,75471,80045,132300
7088,7088,7088,7088,7088,7088,7088,7088,7089,2021-10-30 15:00:00+00:00,Washington,30.0,68467,87.0,63950,1.0,11609,31.0,88.0,75559,80076,132417
7089,7089,7089,7089,7089,7089,7089,7089,7090,2021-10-31 15:00:00+00:00,Washington,21.0,68488,29.0,63979,,11609,,,75588,80097,132467
7090,7090,7090,7090,7090,7090,7090,7090,7091,2021-11-01 15:00:00+00:00,Washington,77.0,68565,145.0,64124,7.0,11616,84.0,152.0,75740,80181,132689
7091,7091,7091,7091,7091,7091,7091,7091,7092,2021-11-02 15:00:00+00:00,Washington,71.0,68636,142.0,64266,16.0,11632,87.0,158.0,75898,80268,132902
7092,7092,7092,7092,7092,7092,7092,7092,7093,2021-11-03 15:00:00+00:00,Washington,80.0,68716,141.0,64407,5.0,11637,85.0,146.0,76044,80353,133123
7093,7093,7093,7093,7093,7093,7093,7093,7094,2021-11-04 15:00:00+00:00,Washington,90.0,68806,145.0,64552,10.0,11647,100.0,155.0,76199,80453,133358
7094,7094,7094,7094,7094,7094,7094,7094,7095,2021-11-05 15:00:00+00:00,Washington,104.0,68910,179.0,64731,16.0,11663,120.0,195.0,76394,80573,133641
7095,7095,7095,7095,7095,7095,7095,7095,7096,2021-11-06 15:00:00+00:00,Washington,25.0,68935,30.0,64761,4.0,11667,29.0,34.0,76428,80602,133696
7096,7096,7096,7096,7096,7096,7096,7096,7097,2021-08-11 15:00:00+00:00,Unknown,416.0,192451,167.0,150819,21.0,19685,437.0,188.0,170504,212136,343270
7097,7097,7097,7097,7097,7097,7097,7097,7098,2021-08-12 15:00:00+00:00,Unknown,474.0,192925,183.0,151002,37.0,19722,511.0,220.0,170724,212647,343927
7098,7098,7098,7098,7098,7098,7098,7098,7099,2021-08-13 15:00:00+00:00,Unknown,455.0,193380,270.0,151272,14.0,19736,469.0,284.0,171008,213116,344652
7099,7099,7099,7099,7099,7099,7099,7099,7100,2021-08-14 15:00:00+00:00,Unknown,350.0,193730,121.0,151393,17.0,19753,367.0,138.0,171146,213483,345123
7100,7100,7100,7100,7100,7100,7100,7100,7101,2021-08-15 15:00:00+00:00,Unknown,254.0,193984,145.0,151538,5.0,19758,259.0,150.0,171296,213742,345522
7101,7101,7101,7101,7101,7101,7101,7101,7102,2021-08-16 15:00:00+00:00,Unknown,394.0,194378,235.0,151773,23.0,19781,417.0,258.0,171554,214159,346151
7102,7102,7102,7102,7102,7102,7102,7102,7103,2021-08-17 15:00:00+00:00,Unknown,520.0,194898,231.0,152004,39.0,19820,559.0,270.0,171824,214718,346902
7103,7103,7103,7103,7103,7103,7103,7103,7104,2021-08-18 15:00:00+00:00,Unknown,492.0,195390,224.0,152228,24.0,19844,516.0,248.0,172072,215234,347618
7104,7104,7104,7104,7104,7104,7104,7104,7105,2021-08-19 15:00:00+00:00,Unknown,456.0,195846,255.0,152483,35.0,19879,491.0,290.0,172362,215725,348329
7105,7105,7105,7105,7105,7105,7105,7105,7106,2021-08-20 15:00:00+00:00,Unknown,505.0,196351,311.0,152794,28.0,19907,533.0,339.0,172701,216258,349145
7106,7106,7106,7106,7106,7106,7106,7106,7107,2021-08-21 15:00:00+00:00,Unknown,284.0,196635,166.0,152960,15.0,19922,299.0,181.0,172882,216557,349595
7107,7107,7107,7107,7107,7107,7107,7107,7108,2021-08-22 15:00:00+00:00,Unknown,256.0,196891,161.0,153121,12.0,19934,268.0,173.0,173055,216825,350012
7108,7108,7108,7108,7108,7108,7108,7108,7109,2021-08-23 15:00:00+00:00,Unknown,452.0,197343,258.0,153379,27.0,19961,479.0,285.0,173340,217304,350722
7109,7109,7109,7109,7109,7109,7109,7109,7110,2021-08-24 15:00:00+00:00,Unknown,452.0,197795,279.0,153658,42.0,20003,494.0,321.0,173661,217798,351453
7110,7110,7110,7110,7110,7110,7110,7110,7111,2021-08-25 15:00:00+00:00,Unknown,448.0,198243,295.0,153953,34.0,20037,482.0,329.0,173990,218280,352196
7111,7111,7111,7111,7111,7111,7111,7111,7112,2021-08-26 15:00:00+00:00,Unknown,479.0,198722,288.0,154241,33.0,20070,512.0,321.0,174311,218792,352963
7112,7112,7112,7112,7112,7112,7112,7112,7113,2021-08-27 15:00:00+00:00,Unknown,469.0,199191,298.0,154539,37.0,20107,506.0,335.0,174646,219298,353730
7113,7113,7113,7113,7113,7113,7113,7113,7114,2021-08-28 15:00:00+00:00,Unknown,310.0,199501,174.0,154713,16.0,20123,326.0,190.0,174836,219624,354214
7114,7114,7114,7114,7114,7114,7114,7114,7115,2021-08-29 15:00:00+00:00,Unknown,284.0,199785,184.0,154897,3.0,20126,287.0,187.0,175023,219911,354682
7115,7115,7115,7115,7115,7115,7115,7115,7116,2021-08-30 15:00:00+00:00,Unknown,441.0,200226,313.0,155210,36.0,20162,477.0,349.0,175372,220388,355436
7116,7116,7116,7116,7116,7116,7116,7116,7117,2021-08-31 15:00:00+00:00,Unknown,463.0,200689,320.0,155530,35.0,20197,498.0,355.0,175727,220886,356219
7117,7117,7117,7117,7117,7117,7117,7117,7118,2021-09-01 15:00:00+00:00,Unknown,461.0,201150,284.0,155814,34.0,20231,495.0,318.0,176045,221381,356964
7118,7118,7118,7118,7118,7118,7118,7118,7119,2021-09-02 15:00:00+00:00,Unknown,414.0,201564,291.0,156105,45.0,20276,459.0,336.0,176381,221840,357669
7119,7119,7119,7119,7119,7119,7119,7119,7120,2021-09-03 15:00:00+00:00,Unknown,419.0,201983,309.0,156414,30.0,20306,449.0,339.0,176720,222289,358397
7120,7120,7120,7120,7120,7120,7120,7120,7121,2021-09-04 15:00:00+00:00,Unknown,299.0,202282,188.0,156602,17.0,20323,316.0,205.0,176925,222605,358884
7121,7121,7121,7121,7121,7121,7121,7121,7122,2021-09-05 15:00:00+00:00,Unknown,339.0,202621,146.0,156748,11.0,20334,350.0,157.0,177082,222955,359369
7122,7122,7122,7122,7122,7122,7122,7122,7123,2021-09-06 15:00:00+00:00,Unknown,75.0,202696,60.0,156808,2.0,20336,77.0,62.0,177144,223032,359504
7123,7123,7123,7123,7123,7123,7123,7123,7124,2021-09-07 15:00:00+00:00,Unknown,405.0,203101,305.0,157113,37.0,20373,442.0,342.0,177486,223474,360214
7124,7124,7124,7124,7124,7124,7124,7124,7125,2021-04-10 15:00:00+00:00,Wicomico,42.0,31382,188.0,21118,89.0,2330,131.0,277.0,23448,33712,52500
7125,7125,7125,7125,7125,7125,7125,7125,7126,2021-04-11 15:00:00+00:00,Wicomico,24.0,31406,149.0,21267,52.0,2382,76.0,201.0,23649,33788,52673
7126,7126,7126,7126,7126,7126,7126,7126,7127,2021-04-12 15:00:00+00:00,Wicomico,266.0,31672,305.0,21572,127.0,2509,393.0,432.0,24081,34181,53244
7127,7127,7127,7127,7127,7127,7127,7127,7128,2021-04-13 15:00:00+00:00,Wicomico,357.0,32029,558.0,22130,16.0,2525,373.0,574.0,24655,34554,54159
7128,7128,7128,7128,7128,7128,7128,7128,7129,2021-04-14 15:00:00+00:00,Wicomico,513.0,32542,648.0,22778,,2525,,,25303,35067,55320
7129,7129,7129,7129,7129,7129,7129,7129,7130,2021-04-15 15:00:00+00:00,Wicomico,303.0,32845,1028.0,23806,1.0,2526,304.0,1029.0,26332,35371,56651
7130,7130,7130,7130,7130,7130,7130,7130,7131,2021-04-16 15:00:00+00:00,Wicomico,410.0,33255,641.0,24447,1.0,2527,411.0,642.0,26974,35782,57702
7131,7131,7131,7131,7131,7131,7131,7131,7132,2021-04-17 15:00:00+00:00,Wicomico,110.0,33365,154.0,24601,,2527,,,27128,35892,57966
7132,7132,7132,7132,7132,7132,7132,7132,7133,2021-04-18 15:00:00+00:00,Wicomico,79.0,33444,116.0,24717,,2527,,,27244,35971,58161
7133,7133,7133,7133,7133,7133,7133,7133,7134,2021-04-19 15:00:00+00:00,Wicomico,123.0,33567,659.0,25376,,2527,,,27903,36094,58943
7134,7134,7134,7134,7134,7134,7134,7134,7135,2021-04-20 15:00:00+00:00,Wicomico,347.0,33914,391.0,25767,,2527,,,28294,36441,59681
7135,7135,7135,7135,7135,7135,7135,7135,7136,2021-04-21 15:00:00+00:00,Wicomico,187.0,34101,524.0,26291,,2527,,,28818,36628,60392
7136,7136,7136,7136,7136,7136,7136,7136,7137,2021-04-22 15:00:00+00:00,Wicomico,189.0,34290,407.0,26698,,2527,,,29225,36817,60988
7137,7137,7137,7137,7137,7137,7137,7137,7138,2021-04-23 15:00:00+00:00,Wicomico,174.0,34464,487.0,27185,,2527,,,29712,36991,61649
7138,7138,7138,7138,7138,7138,7138,7138,7139,2021-04-24 15:00:00+00:00,Wicomico,85.0,34549,186.0,27371,2.0,2529,87.0,188.0,29900,37078,61920
7139,7139,7139,7139,7139,7139,7139,7139,7140,2021-04-25 15:00:00+00:00,Wicomico,24.0,34573,17.0,27388,3.0,2532,27.0,20.0,29920,37105,61961
7140,7140,7140,7140,7140,7140,7140,7140,7141,2021-04-26 15:00:00+00:00,Wicomico,144.0,34717,438.0,27826,4.0,2536,148.0,442.0,30362,37253,62543
7141,7141,7141,7141,7141,7141,7141,7141,7142,2021-04-27 15:00:00+00:00,Wicomico,158.0,34875,356.0,28182,19.0,2555,177.0,375.0,30737,37430,63057
7142,7142,7142,7142,7142,7142,7142,7142,7143,2021-04-28 15:00:00+00:00,Wicomico,189.0,35064,413.0,28595,12.0,2567,201.0,425.0,31162,37631,63659
7143,7143,7143,7143,7143,7143,7143,7143,7144,2021-04-29 15:00:00+00:00,Wicomico,147.0,35211,272.0,28867,18.0,2585,165.0,290.0,31452,37796,64078
7144,7144,7144,7144,7144,7144,7144,7144,7145,2021-04-30 15:00:00+00:00,Wicomico,243.0,35454,458.0,29325,9.0,2594,252.0,467.0,31919,38048,64779
7145,7145,7145,7145,7145,7145,7145,7145,7146,2021-05-01 15:00:00+00:00,Wicomico,89.0,35543,33.0,29358,6.0,2600,95.0,39.0,31958,38143,64901
7146,7146,7146,7146,7146,7146,7146,7146,7147,2021-05-02 15:00:00+00:00,Wicomico,37.0,35580,17.0,29375,2.0,2602,39.0,19.0,31977,38182,64955
7147,7147,7147,7147,7147,7147,7147,7147,7148,2021-05-03 15:00:00+00:00,Wicomico,94.0,35674,177.0,29552,5.0,2607,99.0,182.0,32159,38281,65226
7148,7148,7148,7148,7148,7148,7148,7148,7149,2021-05-04 15:00:00+00:00,Wicomico,119.0,35793,345.0,29897,28.0,2635,147.0,373.0,32532,38428,65690
7149,7149,7149,7149,7149,7149,7149,7149,7150,2021-05-05 15:00:00+00:00,Wicomico,150.0,35943,347.0,30244,10.0,2645,160.0,357.0,32889,38588,66187
7150,7150,7150,7150,7150,7150,7150,7150,7151,2021-05-06 15:00:00+00:00,Wicomico,106.0,36049,316.0,30560,18.0,2663,124.0,334.0,33223,38712,66609
7151,7151,7151,7151,7151,7151,7151,7151,7152,2021-05-07 15:00:00+00:00,Wicomico,132.0,36181,437.0,30997,21.0,2684,153.0,458.0,33681,38865,67178
7152,7152,7152,7152,7152,7152,7152,7152,7153,2021-02-01 15:00:00+00:00,Montgomery,1355.0,76146,606.0,14134,,0,,,14134,76146,90280
7153,7153,7153,7153,7153,7153,7153,7153,7154,2021-02-02 15:00:00+00:00,Montgomery,3192.0,79338,2163.0,16297,,0,,,16297,79338,95635
7154,7154,7154,7154,7154,7154,7154,7154,7155,2021-02-03 15:00:00+00:00,Montgomery,3270.0,82608,1612.0,17909,,0,,,17909,82608,100517
7155,7155,7155,7155,7155,7155,7155,7155,7156,2021-02-04 15:00:00+00:00,Montgomery,3869.0,86477,2237.0,20146,,0,,,20146,86477,106623
7156,7156,7156,7156,7156,7156,7156,7156,7157,2021-02-05 15:00:00+00:00,Montgomery,4169.0,90646,2691.0,22837,,0,,,22837,90646,113483
7157,7157,7157,7157,7157,7157,7157,7157,7158,2021-02-06 15:00:00+00:00,Montgomery,2025.0,92671,362.0,23199,,0,,,23199,92671,115870
7158,7158,7158,7158,7158,7158,7158,7158,7159,2021-02-07 15:00:00+00:00,Montgomery,1058.0,93729,235.0,23434,,0,,,23434,93729,117163
7159,7159,7159,7159,7159,7159,7159,7159,7160,2021-02-08 15:00:00+00:00,Montgomery,2868.0,96597,2282.0,25716,,0,,,25716,96597,122313
7160,7160,7160,7160,7160,7160,7160,7160,7161,2021-02-09 15:00:00+00:00,Montgomery,3602.0,100199,2685.0,28401,,0,,,28401,100199,128600
7161,7161,7161,7161,7161,7161,7161,7161,7162,2021-02-10 15:00:00+00:00,Montgomery,3259.0,103458,4013.0,32414,,0,,,32414,103458,135872
7162,7162,7162,7162,7162,7162,7162,7162,7163,2021-02-11 15:00:00+00:00,Montgomery,4946.0,108404,3511.0,35925,,0,,,35925,108404,144329
7163,7163,7163,7163,7163,7163,7163,7163,7164,2021-02-12 15:00:00+00:00,Montgomery,4626.0,113030,3794.0,39719,,0,,,39719,113030,152749
7164,7164,7164,7164,7164,7164,7164,7164,7165,2021-02-13 15:00:00+00:00,Montgomery,1994.0,115024,656.0,40375,,0,,,40375,115024,155399
7165,7165,7165,7165,7165,7165,7165,7165,7166,2021-02-14 15:00:00+00:00,Montgomery,1932.0,116956,355.0,40730,,0,,,40730,116956,157686
7166,7166,7166,7166,7166,7166,7166,7166,7167,2021-02-15 15:00:00+00:00,Montgomery,2128.0,119084,2060.0,42790,,0,,,42790,119084,161874
7167,7167,7167,7167,7167,7167,7167,7167,7168,2021-02-16 15:00:00+00:00,Montgomery,3805.0,122889,2751.0,45541,,0,,,45541,122889,168430
7168,7168,7168,7168,7168,7168,7168,7168,7169,2021-02-17 15:00:00+00:00,Montgomery,4361.0,127250,3728.0,49269,,0,,,49269,127250,176519
7169,7169,7169,7169,7169,7169,7169,7169,7170,2021-02-18 15:00:00+00:00,Montgomery,677.0,127927,626.0,49895,,0,,,49895,127927,177822
7170,7170,7170,7170,7170,7170,7170,7170,7171,2021-02-19 15:00:00+00:00,Montgomery,2871.0,130798,3600.0,53495,,0,,,53495,130798,184293
7171,7171,7171,7171,7171,7171,7171,7171,7172,2021-02-20 15:00:00+00:00,Montgomery,2592.0,133390,2662.0,56157,,0,,,56157,133390,189547
7172,7172,7172,7172,7172,7172,7172,7172,7173,2021-02-21 15:00:00+00:00,Montgomery,2576.0,135966,2038.0,58195,,0,,,58195,135966,194161
7173,7173,7173,7173,7173,7173,7173,7173,7174,2021-02-22 15:00:00+00:00,Montgomery,1952.0,137918,2794.0,60989,,0,,,60989,137918,198907
7174,7174,7174,7174,7174,7174,7174,7174,7175,2021-02-23 15:00:00+00:00,Montgomery,2653.0,140571,2878.0,63867,,0,,,63867,140571,204438
7175,7175,7175,7175,7175,7175,7175,7175,7176,2021-02-24 15:00:00+00:00,Montgomery,3539.0,144110,4753.0,68620,,0,,,68620,144110,212730
7176,7176,7176,7176,7176,7176,7176,7176,7177,2021-02-25 15:00:00+00:00,Montgomery,4400.0,148510,4682.0,73302,,0,,,73302,148510,221812
7177,7177,7177,7177,7177,7177,7177,7177,7178,2021-02-26 15:00:00+00:00,Montgomery,4791.0,153301,4864.0,78166,,0,,,78166,153301,231467
7178,7178,7178,7178,7178,7178,7178,7178,7179,2021-02-27 15:00:00+00:00,Montgomery,3427.0,156728,2375.0,80541,,0,,,80541,156728,237269
7179,7179,7179,7179,7179,7179,7179,7179,7180,2021-02-28 15:00:00+00:00,Montgomery,3444.0,160172,1402.0,81943,,0,,,81943,160172,242115
7180,7180,7180,7180,7180,7180,7180,7180,7181,2021-05-08 15:00:00+00:00,Wicomico,85.0,36266,122.0,31119,6.0,2690,91.0,128.0,33809,38956,67385
7181,7181,7181,7181,7181,7181,7181,7181,7182,2021-05-09 15:00:00+00:00,Wicomico,9.0,36275,13.0,31132,3.0,2693,12.0,16.0,33825,38968,67407
7182,7182,7182,7182,7182,7182,7182,7182,7183,2021-05-10 15:00:00+00:00,Wicomico,123.0,36398,199.0,31331,13.0,2706,136.0,212.0,34037,39104,67729
7183,7183,7183,7183,7183,7183,7183,7183,7184,2021-05-11 15:00:00+00:00,Wicomico,163.0,36561,290.0,31621,15.0,2721,178.0,305.0,34342,39282,68182
7184,7184,7184,7184,7184,7184,7184,7184,7185,2021-05-12 15:00:00+00:00,Wicomico,127.0,36688,485.0,32106,30.0,2751,157.0,515.0,34857,39439,68794
7185,7185,7185,7185,7185,7185,7185,7185,7186,2021-05-13 15:00:00+00:00,Wicomico,152.0,36840,124.0,32230,17.0,2768,169.0,141.0,34998,39608,69070
7186,7186,7186,7186,7186,7186,7186,7186,7187,2021-05-14 15:00:00+00:00,Wicomico,244.0,37084,186.0,32416,36.0,2804,280.0,222.0,35220,39888,69500
7187,7187,7187,7187,7187,7187,7187,7187,7188,2021-05-15 15:00:00+00:00,Wicomico,106.0,37190,97.0,32513,18.0,2822,124.0,115.0,35335,40012,69703
7188,7188,7188,7188,7188,7188,7188,7188,7189,2021-05-16 15:00:00+00:00,Wicomico,20.0,37210,20.0,32533,10.0,2832,30.0,30.0,35365,40042,69743
7189,7189,7189,7189,7189,7189,7189,7189,7190,2021-05-17 15:00:00+00:00,Wicomico,243.0,37453,84.0,32617,41.0,2873,284.0,125.0,35490,40326,70070
7190,7190,7190,7190,7190,7190,7190,7190,7191,2021-05-18 15:00:00+00:00,Wicomico,351.0,37804,204.0,32821,43.0,2916,394.0,247.0,35737,40720,70625
7191,7191,7191,7191,7191,7191,7191,7191,7192,2021-05-19 15:00:00+00:00,Wicomico,271.0,38075,151.0,32972,56.0,2972,327.0,207.0,35944,41047,71047
7192,7192,7192,7192,7192,7192,7192,7192,7193,2021-05-20 15:00:00+00:00,Wicomico,249.0,38324,106.0,33078,28.0,3000,277.0,134.0,36078,41324,71402
7193,7193,7193,7193,7193,7193,7193,7193,7194,2021-05-21 15:00:00+00:00,Wicomico,320.0,38644,334.0,33412,37.0,3037,357.0,371.0,36449,41681,72056
7194,7194,7194,7194,7194,7194,7194,7194,7195,2021-05-22 15:00:00+00:00,Wicomico,159.0,38803,71.0,33483,11.0,3048,170.0,82.0,36531,41851,72286
7195,7195,7195,7195,7195,7195,7195,7195,7196,2021-05-23 15:00:00+00:00,Wicomico,37.0,38840,26.0,33509,8.0,3056,45.0,34.0,36565,41896,72349
7196,7196,7196,7196,7196,7196,7196,7196,7197,2021-05-24 15:00:00+00:00,Wicomico,182.0,39022,62.0,33571,24.0,3080,206.0,86.0,36651,42102,72593
7197,7197,7197,7197,7197,7197,7197,7197,7198,2021-05-25 15:00:00+00:00,Wicomico,241.0,39263,161.0,33732,22.0,3102,263.0,183.0,36834,42365,72995
7198,7198,7198,7198,7198,7198,7198,7198,7199,2021-05-26 15:00:00+00:00,Wicomico,131.0,39394,121.0,33853,30.0,3132,161.0,151.0,36985,42526,73247
7199,7199,7199,7199,7199,7199,7199,7199,7200,2021-05-27 15:00:00+00:00,Wicomico,153.0,39547,178.0,34031,22.0,3154,175.0,200.0,37185,42701,73578
7200,7200,7200,7200,7200,7200,7200,7200,7201,2021-05-28 15:00:00+00:00,Wicomico,193.0,39740,137.0,34168,25.0,3179,218.0,162.0,37347,42919,73908
7201,7201,7201,7201,7201,7201,7201,7201,7202,2021-05-29 15:00:00+00:00,Wicomico,88.0,39828,82.0,34250,6.0,3185,94.0,88.0,37435,43013,74078
7202,7202,7202,7202,7202,7202,7202,7202,7203,2021-05-30 15:00:00+00:00,Wicomico,18.0,39846,16.0,34266,5.0,3190,23.0,21.0,37456,43036,74112
7203,7203,7203,7203,7203,7203,7203,7203,7204,2021-05-31 15:00:00+00:00,Wicomico,21.0,39867,28.0,34294,4.0,3194,25.0,32.0,37488,43061,74161
7204,7204,7204,7204,7204,7204,7204,7204,7205,2021-06-01 15:00:00+00:00,Wicomico,115.0,39982,150.0,34444,30.0,3224,145.0,180.0,37668,43206,74426
7205,7205,7205,7205,7205,7205,7205,7205,7206,2021-06-02 15:00:00+00:00,Wicomico,89.0,40071,188.0,34632,28.0,3252,117.0,216.0,37884,43323,74703
7206,7206,7206,7206,7206,7206,7206,7206,7207,2021-06-03 15:00:00+00:00,Wicomico,50.0,40121,170.0,34802,22.0,3274,72.0,192.0,38076,43395,74923
7207,7207,7207,7207,7207,7207,7207,7207,7208,2021-06-04 15:00:00+00:00,Wicomico,74.0,40195,177.0,34979,22.0,3296,96.0,199.0,38275,43491,75174
7208,7208,7208,7208,7208,7208,7208,7208,7209,2021-03-01 15:00:00+00:00,Montgomery,5989.0,166161,2987.0,84930,,0,,,84930,166161,251091
7209,7209,7209,7209,7209,7209,7209,7209,7210,2021-03-02 15:00:00+00:00,Montgomery,4680.0,170841,2324.0,87254,8.0,8,4688.0,2332.0,87262,170849,258095
7210,7210,7210,7210,7210,7210,7210,7210,7211,2021-03-03 15:00:00+00:00,Montgomery,4799.0,175640,3496.0,90750,15.0,23,4814.0,3511.0,90773,175663,266390
7211,7211,7211,7211,7211,7211,7211,7211,7212,2021-03-04 15:00:00+00:00,Montgomery,5962.0,181602,2136.0,92886,476.0,499,6438.0,2612.0,93385,182101,274488
7212,7212,7212,7212,7212,7212,7212,7212,7213,2021-03-05 15:00:00+00:00,Montgomery,5443.0,187045,2830.0,95716,697.0,1196,6140.0,3527.0,96912,188241,282761
7213,7213,7213,7213,7213,7213,7213,7213,7214,2021-03-06 15:00:00+00:00,Montgomery,3336.0,190381,1001.0,96717,1670.0,2866,5006.0,2671.0,99583,193247,287098
7214,7214,7214,7214,7214,7214,7214,7214,7215,2021-03-07 15:00:00+00:00,Montgomery,3062.0,193443,1532.0,98249,1215.0,4081,4277.0,2747.0,102330,197524,291692
7215,7215,7215,7215,7215,7215,7215,7215,7216,2021-03-08 15:00:00+00:00,Montgomery,5929.0,199372,1888.0,100137,1359.0,5440,7288.0,3247.0,105577,204812,299509
7216,7216,7216,7216,7216,7216,7216,7216,7217,2021-03-09 15:00:00+00:00,Montgomery,5557.0,204929,2276.0,102413,1638.0,7078,7195.0,3914.0,109491,212007,307342
7217,7217,7217,7217,7217,7217,7217,7217,7218,2021-03-10 15:00:00+00:00,Montgomery,4536.0,209465,2843.0,105256,1778.0,8856,6314.0,4621.0,114112,218321,314721
7218,7218,7218,7218,7218,7218,7218,7218,7219,2021-03-11 15:00:00+00:00,Montgomery,5278.0,214743,3610.0,108866,629.0,9485,5907.0,4239.0,118351,224228,323609
7219,7219,7219,7219,7219,7219,7219,7219,7220,2021-03-12 15:00:00+00:00,Montgomery,6186.0,220929,4487.0,113353,445.0,9930,6631.0,4932.0,123283,230859,334282
7220,7220,7220,7220,7220,7220,7220,7220,7221,2021-03-13 15:00:00+00:00,Montgomery,4415.0,225344,2552.0,115905,315.0,10245,4730.0,2867.0,126150,235589,341249
7221,7221,7221,7221,7221,7221,7221,7221,7222,2021-03-14 15:00:00+00:00,Montgomery,4774.0,230118,1801.0,117706,110.0,10355,4884.0,1911.0,128061,240473,347824
7222,7222,7222,7222,7222,7222,7222,7222,7223,2021-03-15 15:00:00+00:00,Montgomery,5984.0,236102,2114.0,119820,178.0,10533,6162.0,2292.0,130353,246635,355922
7223,7223,7223,7223,7223,7223,7223,7223,7224,2021-03-16 15:00:00+00:00,Montgomery,6099.0,242201,3738.0,123558,48.0,10581,6147.0,3786.0,134139,252782,365759
7224,7224,7224,7224,7224,7224,7224,7224,7225,2021-03-17 15:00:00+00:00,Montgomery,6057.0,248258,4397.0,127955,111.0,10692,6168.0,4508.0,138647,258950,376213
7225,7225,7225,7225,7225,7225,7225,7225,7226,2021-03-18 15:00:00+00:00,Montgomery,7160.0,255418,2263.0,130218,180.0,10872,7340.0,2443.0,141090,266290,385636
7226,7226,7226,7226,7226,7226,7226,7226,7227,2021-03-19 15:00:00+00:00,Montgomery,7372.0,262790,3687.0,133905,167.0,11039,7539.0,3854.0,144944,273829,396695
7227,7227,7227,7227,7227,7227,7227,7227,7228,2021-03-20 15:00:00+00:00,Montgomery,6180.0,268970,2725.0,136630,103.0,11142,6283.0,2828.0,147772,280112,405600
7228,7228,7228,7228,7228,7228,7228,7228,7229,2021-03-21 15:00:00+00:00,Montgomery,4529.0,273499,2715.0,139345,39.0,11181,4568.0,2754.0,150526,284680,412844
7229,7229,7229,7229,7229,7229,7229,7229,7230,2021-03-22 15:00:00+00:00,Montgomery,5853.0,279352,3462.0,142807,90.0,11271,5943.0,3552.0,154078,290623,422159
7230,7230,7230,7230,7230,7230,7230,7230,7231,2021-03-23 15:00:00+00:00,Montgomery,7726.0,287078,2905.0,145712,108.0,11379,7834.0,3013.0,157091,298457,432790
7231,7231,7231,7231,7231,7231,7231,7231,7232,2021-03-24 15:00:00+00:00,Montgomery,9097.0,296175,4161.0,149873,135.0,11514,9232.0,4296.0,161387,307689,446048
7232,7232,7232,7232,7232,7232,7232,7232,7233,2021-03-25 15:00:00+00:00,Montgomery,7897.0,304072,4461.0,154334,407.0,11921,8304.0,4868.0,166255,315993,458406
7233,7233,7233,7233,7233,7233,7233,7233,7234,2021-03-26 15:00:00+00:00,Montgomery,7328.0,311400,4633.0,158967,535.0,12456,7863.0,5168.0,171423,323856,470367
7234,7234,7234,7234,7234,7234,7234,7234,7235,2021-03-27 15:00:00+00:00,Montgomery,5360.0,316760,4133.0,163100,651.0,13107,6011.0,4784.0,176207,329867,479860
7235,7235,7235,7235,7235,7235,7235,7235,7236,2021-03-28 15:00:00+00:00,Montgomery,3723.0,320483,3668.0,166768,603.0,13710,4326.0,4271.0,180478,334193,487251
7236,7236,7236,7236,7236,7236,7236,7236,7237,2021-09-08 15:00:00+00:00,Unknown,413.0,203514,273.0,157386,36.0,20409,449.0,309.0,177795,223923,360900
7237,7237,7237,7237,7237,7237,7237,7237,7238,2021-09-09 15:00:00+00:00,Unknown,447.0,203961,268.0,157654,34.0,20443,481.0,302.0,178097,224404,361615
7238,7238,7238,7238,7238,7238,7238,7238,7239,2021-09-10 15:00:00+00:00,Unknown,519.0,204480,323.0,157977,33.0,20476,552.0,356.0,178453,224956,362457
7239,7239,7239,7239,7239,7239,7239,7239,7240,2021-09-11 15:00:00+00:00,Unknown,306.0,204786,163.0,158140,13.0,20489,319.0,176.0,178629,225275,362926
7240,7240,7240,7240,7240,7240,7240,7240,7241,2021-09-12 15:00:00+00:00,Unknown,247.0,205033,147.0,158287,13.0,20502,260.0,160.0,178789,225535,363320
7241,7241,7241,7241,7241,7241,7241,7241,7242,2021-09-13 15:00:00+00:00,Unknown,418.0,205451,236.0,158523,21.0,20523,439.0,257.0,179046,225974,363974
7242,7242,7242,7242,7242,7242,7242,7242,7243,2021-09-14 15:00:00+00:00,Unknown,393.0,205844,275.0,158798,31.0,20554,424.0,306.0,179352,226398,364642
7243,7243,7243,7243,7243,7243,7243,7243,7244,2021-09-15 15:00:00+00:00,Unknown,367.0,206211,251.0,159049,34.0,20588,401.0,285.0,179637,226799,365260
7244,7244,7244,7244,7244,7244,7244,7244,7245,2021-09-16 15:00:00+00:00,Unknown,407.0,206618,240.0,159289,36.0,20624,443.0,276.0,179913,227242,365907
7245,7245,7245,7245,7245,7245,7245,7245,7246,2021-09-17 15:00:00+00:00,Unknown,409.0,207027,294.0,159583,38.0,20662,447.0,332.0,180245,227689,366610
7246,7246,7246,7246,7246,7246,7246,7246,7247,2021-09-18 15:00:00+00:00,Unknown,296.0,207323,164.0,159747,13.0,20675,309.0,177.0,180422,227998,367070
7247,7247,7247,7247,7247,7247,7247,7247,7248,2021-09-19 15:00:00+00:00,Unknown,220.0,207543,136.0,159883,1.0,20676,221.0,137.0,180559,228219,367426
7248,7248,7248,7248,7248,7248,7248,7248,7249,2021-09-20 15:00:00+00:00,Unknown,341.0,207884,232.0,160115,28.0,20704,369.0,260.0,180819,228588,367999
7249,7249,7249,7249,7249,7249,7249,7249,7250,2021-09-21 15:00:00+00:00,Unknown,317.0,208201,256.0,160371,20.0,20724,337.0,276.0,181095,228925,368572
7250,7250,7250,7250,7250,7250,7250,7250,7251,2021-09-22 15:00:00+00:00,Unknown,340.0,208541,248.0,160619,21.0,20745,361.0,269.0,181364,229286,369160
7251,7251,7251,7251,7251,7251,7251,7251,7252,2021-09-23 15:00:00+00:00,Unknown,320.0,208861,220.0,160839,25.0,20770,345.0,245.0,181609,229631,369700
7252,7252,7252,7252,7252,7252,7252,7252,7253,2021-09-24 15:00:00+00:00,Unknown,513.0,209374,309.0,161148,23.0,20793,536.0,332.0,181941,230167,370522
7253,7253,7253,7253,7253,7253,7253,7253,7254,2021-09-25 15:00:00+00:00,Unknown,401.0,209775,158.0,161306,4.0,20797,405.0,162.0,182103,230572,371081
7254,7254,7254,7254,7254,7254,7254,7254,7255,2021-09-26 15:00:00+00:00,Unknown,285.0,210060,116.0,161422,4.0,20801,289.0,120.0,182223,230861,371482
7255,7255,7255,7255,7255,7255,7255,7255,7256,2021-09-27 15:00:00+00:00,Unknown,609.0,210669,138.0,161560,19.0,20820,628.0,157.0,182380,231489,372229
7256,7256,7256,7256,7256,7256,7256,7256,7257,2021-09-28 15:00:00+00:00,Unknown,608.0,211277,259.0,161819,18.0,20838,626.0,277.0,182657,232115,373096
7257,7257,7257,7257,7257,7257,7257,7257,7258,2021-09-29 15:00:00+00:00,Unknown,550.0,211827,284.0,162103,36.0,20874,586.0,320.0,182977,232701,373930
7258,7258,7258,7258,7258,7258,7258,7258,7259,2021-09-30 15:00:00+00:00,Unknown,532.0,212359,262.0,162365,10.0,20884,542.0,272.0,183249,233243,374724
7259,7259,7259,7259,7259,7259,7259,7259,7260,2021-10-01 15:00:00+00:00,Unknown,683.0,213042,310.0,162675,26.0,20910,709.0,336.0,183585,233952,375717
7260,7260,7260,7260,7260,7260,7260,7260,7261,2021-10-02 15:00:00+00:00,Unknown,400.0,213442,153.0,162828,8.0,20918,408.0,161.0,183746,234360,376270
7261,7261,7261,7261,7261,7261,7261,7261,7262,2021-10-03 15:00:00+00:00,Unknown,258.0,213700,132.0,162960,3.0,20921,261.0,135.0,183881,234621,376660
7262,7262,7262,7262,7262,7262,7262,7262,7263,2021-10-04 15:00:00+00:00,Unknown,533.0,214233,202.0,163162,18.0,20939,551.0,220.0,184101,235172,377395
7263,7263,7263,7263,7263,7263,7263,7263,7264,2021-10-05 15:00:00+00:00,Unknown,515.0,214748,182.0,163344,18.0,20957,533.0,200.0,184301,235705,378092
7264,7264,7264,7264,7264,7264,7264,7264,7265,2021-06-05 15:00:00+00:00,Wicomico,59.0,40254,104.0,35083,15.0,3311,74.0,119.0,38394,43565,75337
7265,7265,7265,7265,7265,7265,7265,7265,7266,2021-06-06 15:00:00+00:00,Wicomico,16.0,40270,18.0,35101,6.0,3317,22.0,24.0,38418,43587,75371
7266,7266,7266,7266,7266,7266,7266,7266,7267,2021-06-07 15:00:00+00:00,Wicomico,75.0,40345,210.0,35311,9.0,3326,84.0,219.0,38637,43671,75656
7267,7267,7267,7267,7267,7267,7267,7267,7268,2021-06-08 15:00:00+00:00,Wicomico,61.0,40406,333.0,35644,15.0,3341,76.0,348.0,38985,43747,76050
7268,7268,7268,7268,7268,7268,7268,7268,7269,2021-06-09 15:00:00+00:00,Wicomico,75.0,40481,229.0,35873,11.0,3352,86.0,240.0,39225,43833,76354
7269,7269,7269,7269,7269,7269,7269,7269,7270,2021-06-10 15:00:00+00:00,Wicomico,57.0,40538,210.0,36083,21.0,3373,78.0,231.0,39456,43911,76621
7270,7270,7270,7270,7270,7270,7270,7270,7271,2021-06-11 15:00:00+00:00,Wicomico,75.0,40613,254.0,36337,21.0,3394,96.0,275.0,39731,44007,76950
7271,7271,7271,7271,7271,7271,7271,7271,7272,2021-06-12 15:00:00+00:00,Wicomico,32.0,40645,146.0,36483,10.0,3404,42.0,156.0,39887,44049,77128
7272,7272,7272,7272,7272,7272,7272,7272,7273,2021-06-13 15:00:00+00:00,Wicomico,16.0,40661,26.0,36509,4.0,3408,20.0,30.0,39917,44069,77170
7273,7273,7273,7273,7273,7273,7273,7273,7274,2021-06-14 15:00:00+00:00,Wicomico,64.0,40725,180.0,36689,7.0,3415,71.0,187.0,40104,44140,77414
7274,7274,7274,7274,7274,7274,7274,7274,7275,2021-06-15 15:00:00+00:00,Wicomico,70.0,40795,308.0,36997,36.0,3451,106.0,344.0,40448,44246,77792
7275,7275,7275,7275,7275,7275,7275,7275,7276,2021-06-16 15:00:00+00:00,Wicomico,53.0,40848,148.0,37145,11.0,3462,64.0,159.0,40607,44310,77993
7276,7276,7276,7276,7276,7276,7276,7276,7277,2021-06-17 15:00:00+00:00,Wicomico,43.0,40891,144.0,37289,24.0,3486,67.0,168.0,40775,44377,78180
7277,7277,7277,7277,7277,7277,7277,7277,7278,2021-06-18 15:00:00+00:00,Wicomico,64.0,40955,205.0,37494,24.0,3510,88.0,229.0,41004,44465,78449
7278,7278,7278,7278,7278,7278,7278,7278,7279,2021-06-19 15:00:00+00:00,Wicomico,70.0,41025,91.0,37585,16.0,3526,86.0,107.0,41111,44551,78610
7279,7279,7279,7279,7279,7279,7279,7279,7280,2021-06-20 15:00:00+00:00,Wicomico,12.0,41037,17.0,37602,2.0,3528,14.0,19.0,41130,44565,78639
7280,7280,7280,7280,7280,7280,7280,7280,7281,2021-06-21 15:00:00+00:00,Wicomico,61.0,41098,114.0,37716,10.0,3538,71.0,124.0,41254,44636,78814
7281,7281,7281,7281,7281,7281,7281,7281,7282,2021-06-22 15:00:00+00:00,Wicomico,75.0,41173,110.0,37826,13.0,3551,88.0,123.0,41377,44724,78999
7282,7282,7282,7282,7282,7282,7282,7282,7283,2021-06-23 15:00:00+00:00,Wicomico,94.0,41267,86.0,37912,9.0,3560,103.0,95.0,41472,44827,79179
7283,7283,7283,7283,7283,7283,7283,7283,7284,2021-06-24 15:00:00+00:00,Wicomico,45.0,41312,83.0,37995,18.0,3578,63.0,101.0,41573,44890,79307
7284,7284,7284,7284,7284,7284,7284,7284,7285,2021-06-25 15:00:00+00:00,Wicomico,51.0,41363,61.0,38056,11.0,3589,62.0,72.0,41645,44952,79419
7285,7285,7285,7285,7285,7285,7285,7285,7286,2021-06-26 15:00:00+00:00,Wicomico,21.0,41384,47.0,38103,5.0,3594,26.0,52.0,41697,44978,79487
7286,7286,7286,7286,7286,7286,7286,7286,7287,2021-06-27 15:00:00+00:00,Wicomico,17.0,41401,20.0,38123,2.0,3596,19.0,22.0,41719,44997,79524
7287,7287,7287,7287,7287,7287,7287,7287,7288,2021-06-28 15:00:00+00:00,Wicomico,50.0,41451,66.0,38189,5.0,3601,55.0,71.0,41790,45052,79640
7288,7288,7288,7288,7288,7288,7288,7288,7289,2021-06-29 15:00:00+00:00,Wicomico,75.0,41526,86.0,38275,3.0,3604,78.0,89.0,41879,45130,79801
7289,7289,7289,7289,7289,7289,7289,7289,7290,2021-06-30 15:00:00+00:00,Wicomico,52.0,41578,50.0,38325,5.0,3609,57.0,55.0,41934,45187,79903
7290,7290,7290,7290,7290,7290,7290,7290,7291,2021-07-01 15:00:00+00:00,Wicomico,49.0,41627,40.0,38365,12.0,3621,61.0,52.0,41986,45248,79992
7291,7291,7291,7291,7291,7291,7291,7291,7292,2021-07-02 15:00:00+00:00,Wicomico,67.0,41694,78.0,38443,16.0,3637,83.0,94.0,42080,45331,80137
7292,7292,7292,7292,7292,7292,7292,7292,7293,2021-03-29 15:00:00+00:00,Montgomery,5926.0,326409,5981.0,172749,153.0,13863,6079.0,6134.0,186612,340272,499158
7293,7293,7293,7293,7293,7293,7293,7293,7294,2021-03-30 15:00:00+00:00,Montgomery,7702.0,334111,5838.0,178587,153.0,14016,7855.0,5991.0,192603,348127,512698
7294,7294,7294,7294,7294,7294,7294,7294,7295,2021-03-31 15:00:00+00:00,Montgomery,8081.0,342192,4998.0,183585,1629.0,15645,9710.0,6627.0,199230,357837,525777
7295,7295,7295,7295,7295,7295,7295,7295,7296,2021-04-01 15:00:00+00:00,Montgomery,8044.0,350236,6884.0,190469,1023.0,16668,9067.0,7907.0,207137,366904,540705
7296,7296,7296,7296,7296,7296,7296,7296,7297,2021-04-02 15:00:00+00:00,Montgomery,8595.0,358831,6571.0,197040,963.0,17631,9558.0,7534.0,214671,376462,555871
7297,7297,7297,7297,7297,7297,7297,7297,7298,2021-04-03 15:00:00+00:00,Montgomery,6020.0,364851,3700.0,200740,738.0,18369,6758.0,4438.0,219109,383220,565591
7298,7298,7298,7298,7298,7298,7298,7298,7299,2021-04-04 15:00:00+00:00,Montgomery,2003.0,366854,2426.0,203166,51.0,18420,2054.0,2477.0,221586,385274,570020
7299,7299,7299,7299,7299,7299,7299,7299,7300,2021-04-05 15:00:00+00:00,Montgomery,6966.0,373820,5703.0,208869,824.0,19244,7790.0,6527.0,228113,393064,582689
7300,7300,7300,7300,7300,7300,7300,7300,7301,2021-04-06 15:00:00+00:00,Montgomery,8719.0,382539,5794.0,214663,1678.0,20922,10397.0,7472.0,235585,403461,597202
7301,7301,7301,7301,7301,7301,7301,7301,7302,2021-04-07 15:00:00+00:00,Montgomery,8808.0,391347,5788.0,220451,1570.0,22492,10378.0,7358.0,242943,413839,611798
7302,7302,7302,7302,7302,7302,7302,7302,7303,2021-04-08 15:00:00+00:00,Montgomery,8262.0,399609,5697.0,226148,2217.0,24709,10479.0,7914.0,250857,424318,625757
7303,7303,7303,7303,7303,7303,7303,7303,7304,2021-04-09 15:00:00+00:00,Montgomery,7822.0,407431,6090.0,232238,3252.0,27961,11074.0,9342.0,260199,435392,639669
7304,7304,7304,7304,7304,7304,7304,7304,7305,2021-04-10 15:00:00+00:00,Montgomery,6308.0,413739,4872.0,237110,1143.0,29104,7451.0,6015.0,266214,442843,650849
7305,7305,7305,7305,7305,7305,7305,7305,7306,2021-04-11 15:00:00+00:00,Montgomery,4228.0,417967,3395.0,240505,1205.0,30309,5433.0,4600.0,270814,448276,658472
7306,7306,7306,7306,7306,7306,7306,7306,7307,2021-04-12 15:00:00+00:00,Montgomery,4673.0,422640,6103.0,246608,2833.0,33142,7506.0,8936.0,279750,455782,669248
7307,7307,7307,7307,7307,7307,7307,7307,7308,2021-04-13 15:00:00+00:00,Montgomery,8551.0,431191,7363.0,253971,50.0,33192,8601.0,7413.0,287163,464383,685162
7308,7308,7308,7308,7308,7308,7308,7308,7309,2021-04-14 15:00:00+00:00,Montgomery,9229.0,440420,7041.0,261012,92.0,33284,9321.0,7133.0,294296,473704,701432
7309,7309,7309,7309,7309,7309,7309,7309,7310,2021-04-15 15:00:00+00:00,Montgomery,8502.0,448922,5931.0,266943,41.0,33325,8543.0,5972.0,300268,482247,715865
7310,7310,7310,7310,7310,7310,7310,7310,7311,2021-04-16 15:00:00+00:00,Montgomery,7688.0,456610,8291.0,275234,1.0,33326,7689.0,8292.0,308560,489936,731844
7311,7311,7311,7311,7311,7311,7311,7311,7312,2021-04-17 15:00:00+00:00,Montgomery,5643.0,462253,5148.0,280382,1.0,33327,5644.0,5149.0,313709,495580,742635
7312,7312,7312,7312,7312,7312,7312,7312,7313,2021-04-18 15:00:00+00:00,Montgomery,4248.0,466501,3767.0,284149,4.0,33331,4252.0,3771.0,317480,499832,750650
7313,7313,7313,7313,7313,7313,7313,7313,7314,2021-04-19 15:00:00+00:00,Montgomery,7627.0,474128,6253.0,290402,11.0,33342,7638.0,6264.0,323744,507470,764530
7314,7314,7314,7314,7314,7314,7314,7314,7315,2021-04-20 15:00:00+00:00,Montgomery,6480.0,480608,8467.0,298869,,33342,,,332211,513950,779477
7315,7315,7315,7315,7315,7315,7315,7315,7316,2021-04-21 15:00:00+00:00,Montgomery,8807.0,489415,9655.0,308524,4.0,33346,8811.0,9659.0,341870,522761,797939
7316,7316,7316,7316,7316,7316,7316,7316,7317,2021-04-22 15:00:00+00:00,Montgomery,7062.0,496477,8901.0,317425,1.0,33347,7063.0,8902.0,350772,529824,813902
7317,7317,7317,7317,7317,7317,7317,7317,7318,2021-04-23 15:00:00+00:00,Montgomery,5899.0,502376,11188.0,328613,,33347,,,361960,535723,830989
7318,7318,7318,7318,7318,7318,7318,7318,7319,2021-04-24 15:00:00+00:00,Montgomery,5707.0,508083,6618.0,335231,5.0,33352,5712.0,6623.0,368583,541435,843314
7319,7319,7319,7319,7319,7319,7319,7319,7320,2021-04-25 15:00:00+00:00,Montgomery,4085.0,512168,2665.0,337896,2.0,33354,4087.0,2667.0,371250,545522,850064
7320,7320,7320,7320,7320,7320,7320,7320,7321,2021-07-03 15:00:00+00:00,Wicomico,20.0,41714,37.0,38480,5.0,3642,25.0,42.0,42122,45356,80194
7321,7321,7321,7321,7321,7321,7321,7321,7322,2021-07-04 15:00:00+00:00,Wicomico,2.0,41716,3.0,38483,,3642,,,42125,45358,80199
7322,7322,7322,7322,7322,7322,7322,7322,7323,2021-07-05 15:00:00+00:00,Wicomico,30.0,41746,51.0,38534,6.0,3648,36.0,57.0,42182,45394,80280
7323,7323,7323,7323,7323,7323,7323,7323,7324,2021-07-06 15:00:00+00:00,Wicomico,64.0,41810,51.0,38585,5.0,3653,69.0,56.0,42238,45463,80395
7324,7324,7324,7324,7324,7324,7324,7324,7325,2021-07-07 15:00:00+00:00,Wicomico,45.0,41855,83.0,38668,8.0,3661,53.0,91.0,42329,45516,80523
7325,7325,7325,7325,7325,7325,7325,7325,7326,2021-07-08 15:00:00+00:00,Wicomico,48.0,41903,38.0,38706,6.0,3667,54.0,44.0,42373,45570,80609
7326,7326,7326,7326,7326,7326,7326,7326,7327,2021-07-09 15:00:00+00:00,Wicomico,58.0,41961,69.0,38775,16.0,3683,74.0,85.0,42458,45644,80736
7327,7327,7327,7327,7327,7327,7327,7327,7328,2021-07-10 15:00:00+00:00,Wicomico,20.0,41981,74.0,38849,2.0,3685,22.0,76.0,42534,45666,80830
7328,7328,7328,7328,7328,7328,7328,7328,7329,2021-07-11 15:00:00+00:00,Wicomico,21.0,42002,10.0,38859,3.0,3688,24.0,13.0,42547,45690,80861
7329,7329,7329,7329,7329,7329,7329,7329,7330,2021-07-12 15:00:00+00:00,Wicomico,92.0,42094,53.0,38912,7.0,3695,99.0,60.0,42607,45789,81006
7330,7330,7330,7330,7330,7330,7330,7330,7331,2021-07-13 15:00:00+00:00,Wicomico,105.0,42199,85.0,38997,18.0,3713,123.0,103.0,42710,45912,81196
7331,7331,7331,7331,7331,7331,7331,7331,7332,2021-07-14 15:00:00+00:00,Wicomico,61.0,42260,65.0,39062,10.0,3723,71.0,75.0,42785,45983,81322
7332,7332,7332,7332,7332,7332,7332,7332,7333,2021-07-15 15:00:00+00:00,Wicomico,52.0,42312,58.0,39120,3.0,3726,55.0,61.0,42846,46038,81432
7333,7333,7333,7333,7333,7333,7333,7333,7334,2021-07-16 15:00:00+00:00,Wicomico,60.0,42372,39.0,39159,8.0,3734,68.0,47.0,42893,46106,81531
7334,7334,7334,7334,7334,7334,7334,7334,7335,2021-07-17 15:00:00+00:00,Wicomico,19.0,42391,21.0,39180,1.0,3735,20.0,22.0,42915,46126,81571
7335,7335,7335,7335,7335,7335,7335,7335,7336,2021-07-18 15:00:00+00:00,Wicomico,25.0,42416,19.0,39199,,3735,,,42934,46151,81615
7336,7336,7336,7336,7336,7336,7336,7336,7337,2021-07-19 15:00:00+00:00,Wicomico,118.0,42534,61.0,39260,10.0,3745,128.0,71.0,43005,46279,81794
7337,7337,7337,7337,7337,7337,7337,7337,7338,2021-07-20 15:00:00+00:00,Wicomico,84.0,42618,69.0,39329,14.0,3759,98.0,83.0,43088,46377,81947
7338,7338,7338,7338,7338,7338,7338,7338,7339,2021-07-21 15:00:00+00:00,Wicomico,73.0,42691,39.0,39368,10.0,3769,83.0,49.0,43137,46460,82059
7339,7339,7339,7339,7339,7339,7339,7339,7340,2021-07-22 15:00:00+00:00,Wicomico,85.0,42776,54.0,39422,10.0,3779,95.0,64.0,43201,46555,82198
7340,7340,7340,7340,7340,7340,7340,7340,7341,2021-07-23 15:00:00+00:00,Wicomico,63.0,42839,32.0,39454,5.0,3784,68.0,37.0,43238,46623,82293
7341,7341,7341,7341,7341,7341,7341,7341,7342,2021-07-24 15:00:00+00:00,Wicomico,46.0,42885,15.0,39469,7.0,3791,53.0,22.0,43260,46676,82354
7342,7342,7342,7342,7342,7342,7342,7342,7343,2021-07-25 15:00:00+00:00,Wicomico,31.0,42916,11.0,39480,4.0,3795,35.0,15.0,43275,46711,82396
7343,7343,7343,7343,7343,7343,7343,7343,7344,2021-07-26 15:00:00+00:00,Wicomico,114.0,43030,54.0,39534,9.0,3804,123.0,63.0,43338,46834,82564
7344,7344,7344,7344,7344,7344,7344,7344,7345,2021-07-27 15:00:00+00:00,Wicomico,130.0,43160,49.0,39583,5.0,3809,135.0,54.0,43392,46969,82743
7345,7345,7345,7345,7345,7345,7345,7345,7346,2021-07-28 15:00:00+00:00,Wicomico,135.0,43295,61.0,39644,12.0,3821,147.0,73.0,43465,47116,82939
7346,7346,7346,7346,7346,7346,7346,7346,7347,2021-07-29 15:00:00+00:00,Wicomico,77.0,43372,42.0,39686,15.0,3836,92.0,57.0,43522,47208,83058
7347,7347,7347,7347,7347,7347,7347,7347,7348,2021-07-30 15:00:00+00:00,Wicomico,125.0,43497,54.0,39740,16.0,3852,141.0,70.0,43592,47349,83237
7348,7348,7348,7348,7348,7348,7348,7348,7349,2021-10-06 15:00:00+00:00,Unknown,608.0,215356,207.0,163551,21.0,20978,629.0,228.0,184529,236334,378907
7349,7349,7349,7349,7349,7349,7349,7349,7350,2021-10-07 15:00:00+00:00,Unknown,566.0,215922,211.0,163762,15.0,20993,581.0,226.0,184755,236915,379684
7350,7350,7350,7350,7350,7350,7350,7350,7351,2021-10-08 15:00:00+00:00,Unknown,596.0,216518,250.0,164012,23.0,21016,619.0,273.0,185028,237534,380530
7351,7351,7351,7351,7351,7351,7351,7351,7352,2021-10-09 15:00:00+00:00,Unknown,360.0,216878,170.0,164182,9.0,21025,369.0,179.0,185207,237903,381060
7352,7352,7352,7352,7352,7352,7352,7352,7353,2021-10-10 15:00:00+00:00,Unknown,285.0,217163,106.0,164288,4.0,21029,289.0,110.0,185317,238192,381451
7353,7353,7353,7353,7353,7353,7353,7353,7354,2021-10-11 15:00:00+00:00,Unknown,583.0,217746,188.0,164476,27.0,21056,610.0,215.0,185532,238802,382222
7354,7354,7354,7354,7354,7354,7354,7354,7355,2021-10-12 15:00:00+00:00,Unknown,480.0,218226,217.0,164693,29.0,21085,509.0,246.0,185778,239311,382919
7355,7355,7355,7355,7355,7355,7355,7355,7356,2021-10-13 15:00:00+00:00,Unknown,519.0,218745,211.0,164904,38.0,21123,557.0,249.0,186027,239868,383649
7356,7356,7356,7356,7356,7356,7356,7356,7357,2021-10-14 15:00:00+00:00,Unknown,491.0,219236,184.0,165088,20.0,21143,511.0,204.0,186231,240379,384324
7357,7357,7357,7357,7357,7357,7357,7357,7358,2021-10-15 15:00:00+00:00,Unknown,571.0,219807,231.0,165319,36.0,21179,607.0,267.0,186498,240986,385126
7358,7358,7358,7358,7358,7358,7358,7358,7359,2021-10-16 15:00:00+00:00,Unknown,281.0,220088,161.0,165480,11.0,21190,292.0,172.0,186670,241278,385568
7359,7359,7359,7359,7359,7359,7359,7359,7360,2021-10-17 15:00:00+00:00,Unknown,192.0,220280,89.0,165569,2.0,21192,194.0,91.0,186761,241472,385849
7360,7360,7360,7360,7360,7360,7360,7360,7361,2021-10-18 15:00:00+00:00,Unknown,532.0,220812,209.0,165778,26.0,21218,558.0,235.0,186996,242030,386590
7361,7361,7361,7361,7361,7361,7361,7361,7362,2021-10-19 15:00:00+00:00,Unknown,460.0,221272,194.0,165972,24.0,21242,484.0,218.0,187214,242514,387244
7362,7362,7362,7362,7362,7362,7362,7362,7363,2021-10-20 15:00:00+00:00,Unknown,459.0,221731,185.0,166157,25.0,21267,484.0,210.0,187424,242998,387888
7363,7363,7363,7363,7363,7363,7363,7363,7364,2021-10-21 15:00:00+00:00,Unknown,463.0,222194,189.0,166346,18.0,21285,481.0,207.0,187631,243479,388540
7364,7364,7364,7364,7364,7364,7364,7364,7365,2021-10-22 15:00:00+00:00,Unknown,816.0,223010,320.0,166666,37.0,21322,853.0,357.0,187988,244332,389676
7365,7365,7365,7365,7365,7365,7365,7365,7366,2021-10-23 15:00:00+00:00,Unknown,535.0,223545,190.0,166856,12.0,21334,547.0,202.0,188190,244879,390401
7366,7366,7366,7366,7366,7366,7366,7366,7367,2021-10-24 15:00:00+00:00,Unknown,382.0,223927,130.0,166986,11.0,21345,393.0,141.0,188331,245272,390913
7367,7367,7367,7367,7367,7367,7367,7367,7368,2021-10-25 15:00:00+00:00,Unknown,940.0,224867,302.0,167288,37.0,21382,977.0,339.0,188670,246249,392155
7368,7368,7368,7368,7368,7368,7368,7368,7369,2021-10-26 15:00:00+00:00,Unknown,874.0,225741,262.0,167550,28.0,21410,902.0,290.0,188960,247151,393291
7369,7369,7369,7369,7369,7369,7369,7369,7370,2021-10-27 15:00:00+00:00,Unknown,930.0,226671,269.0,167819,43.0,21453,973.0,312.0,189272,248124,394490
7370,7370,7370,7370,7370,7370,7370,7370,7371,2021-10-28 15:00:00+00:00,Unknown,862.0,227533,261.0,168080,34.0,21487,896.0,295.0,189567,249020,395613
7371,7371,7371,7371,7371,7371,7371,7371,7372,2021-10-29 15:00:00+00:00,Unknown,910.0,228443,293.0,168373,43.0,21530,953.0,336.0,189903,249973,396816
7372,7372,7372,7372,7372,7372,7372,7372,7373,2021-10-30 15:00:00+00:00,Unknown,453.0,228896,137.0,168510,11.0,21541,464.0,148.0,190051,250437,397406
7373,7373,7373,7373,7373,7373,7373,7373,7374,2021-10-31 15:00:00+00:00,Unknown,330.0,229226,105.0,168615,5.0,21546,335.0,110.0,190161,250772,397841
7374,7374,7374,7374,7374,7374,7374,7374,7375,2021-11-01 15:00:00+00:00,Unknown,821.0,230047,299.0,168914,23.0,21569,844.0,322.0,190483,251616,398961
7375,7375,7375,7375,7375,7375,7375,7375,7376,2021-11-02 15:00:00+00:00,Unknown,843.0,230890,268.0,169182,49.0,21618,892.0,317.0,190800,252508,400072
7376,7376,7376,7376,7376,7376,7376,7376,7377,2021-04-26 15:00:00+00:00,Montgomery,6810.0,518978,6322.0,344218,28.0,33382,6838.0,6350.0,377600,552360,863196
7377,7377,7377,7377,7377,7377,7377,7377,7378,2021-04-27 15:00:00+00:00,Montgomery,6120.0,525098,7796.0,352014,237.0,33619,6357.0,8033.0,385633,558717,877112
7378,7378,7378,7378,7378,7378,7378,7378,7379,2021-04-28 15:00:00+00:00,Montgomery,5528.0,530626,9894.0,361908,251.0,33870,5779.0,10145.0,395778,564496,892534
7379,7379,7379,7379,7379,7379,7379,7379,7380,2021-04-29 15:00:00+00:00,Montgomery,6185.0,536811,8390.0,370298,246.0,34116,6431.0,8636.0,404414,570927,907109
7380,7380,7380,7380,7380,7380,7380,7380,7381,2021-04-30 15:00:00+00:00,Montgomery,5799.0,542610,7989.0,378287,298.0,34414,6097.0,8287.0,412701,577024,920897
7381,7381,7381,7381,7381,7381,7381,7381,7382,2021-05-01 15:00:00+00:00,Montgomery,3656.0,546266,6865.0,385152,181.0,34595,3837.0,7046.0,419747,580861,931418
7382,7382,7382,7382,7382,7382,7382,7382,7383,2021-05-02 15:00:00+00:00,Montgomery,2269.0,548535,3564.0,388716,143.0,34738,2412.0,3707.0,423454,583273,937251
7383,7383,7383,7383,7383,7383,7383,7383,7384,2021-05-03 15:00:00+00:00,Montgomery,2765.0,551300,5089.0,393805,637.0,35375,3402.0,5726.0,429180,586675,945105
7384,7384,7384,7384,7384,7384,7384,7384,7385,2021-05-04 15:00:00+00:00,Montgomery,2664.0,553964,8528.0,402333,222.0,35597,2886.0,8750.0,437930,589561,956297
7385,7385,7385,7385,7385,7385,7385,7385,7386,2021-05-05 15:00:00+00:00,Montgomery,3350.0,557314,8306.0,410639,300.0,35897,3650.0,8606.0,446536,593211,967953
7386,7386,7386,7386,7386,7386,7386,7386,7387,2021-05-06 15:00:00+00:00,Montgomery,3206.0,560520,8222.0,418861,219.0,36116,3425.0,8441.0,454977,596636,979381
7387,7387,7387,7387,7387,7387,7387,7387,7388,2021-05-07 15:00:00+00:00,Montgomery,3416.0,563936,8057.0,426918,258.0,36374,3674.0,8315.0,463292,600310,990854
7388,7388,7388,7388,7388,7388,7388,7388,7389,2021-05-08 15:00:00+00:00,Montgomery,2552.0,566488,5957.0,432875,171.0,36545,2723.0,6128.0,469420,603033,999363
7389,7389,7389,7389,7389,7389,7389,7389,7390,2021-05-09 15:00:00+00:00,Montgomery,1200.0,567688,2761.0,435636,139.0,36684,1339.0,2900.0,472320,604372,1003324
7390,7390,7390,7390,7390,7390,7390,7390,7391,2021-05-10 15:00:00+00:00,Montgomery,1727.0,569415,7069.0,442705,181.0,36865,1908.0,7250.0,479570,606280,1012120
7391,7391,7391,7391,7391,7391,7391,7391,7392,2021-05-11 15:00:00+00:00,Montgomery,1749.0,571164,6346.0,449051,182.0,37047,1931.0,6528.0,486098,608211,1020215
7392,7392,7392,7392,7392,7392,7392,7392,7393,2021-05-12 15:00:00+00:00,Montgomery,2422.0,573586,8488.0,457539,250.0,37297,2672.0,8738.0,494836,610883,1031125
7393,7393,7393,7393,7393,7393,7393,7393,7394,2021-05-13 15:00:00+00:00,Montgomery,5887.0,579473,6806.0,464345,122.0,37419,6009.0,6928.0,501764,616892,1043818
7394,7394,7394,7394,7394,7394,7394,7394,7395,2021-05-14 15:00:00+00:00,Montgomery,6133.0,585606,5816.0,470161,184.0,37603,6317.0,6000.0,507764,623209,1055767
7395,7395,7395,7395,7395,7395,7395,7395,7396,2021-05-15 15:00:00+00:00,Montgomery,6741.0,592347,4987.0,475148,205.0,37808,6946.0,5192.0,512956,630155,1067495
7396,7396,7396,7396,7396,7396,7396,7396,7397,2021-05-16 15:00:00+00:00,Montgomery,1926.0,594273,3435.0,478583,143.0,37951,2069.0,3578.0,516534,632224,1072856
7397,7397,7397,7397,7397,7397,7397,7397,7398,2021-05-17 15:00:00+00:00,Montgomery,3338.0,597611,5968.0,484551,201.0,38152,3539.0,6169.0,522703,635763,1082162
7398,7398,7398,7398,7398,7398,7398,7398,7399,2021-05-18 15:00:00+00:00,Montgomery,3964.0,601575,6046.0,490597,255.0,38407,4219.0,6301.0,529004,639982,1092172
7399,7399,7399,7399,7399,7399,7399,7399,7400,2021-05-19 15:00:00+00:00,Montgomery,5362.0,606937,5722.0,496319,199.0,38606,5561.0,5921.0,534925,645543,1103256
7400,7400,7400,7400,7400,7400,7400,7400,7401,2021-05-20 15:00:00+00:00,Montgomery,3677.0,610614,6626.0,502945,221.0,38827,3898.0,6847.0,541772,649441,1113559
7401,7401,7401,7401,7401,7401,7401,7401,7402,2021-05-21 15:00:00+00:00,Montgomery,3403.0,614017,6101.0,509046,252.0,39079,3655.0,6353.0,548125,653096,1123063
7402,7402,7402,7402,7402,7402,7402,7402,7403,2021-05-22 15:00:00+00:00,Montgomery,3041.0,617058,3703.0,512749,222.0,39301,3263.0,3925.0,552050,656359,1129807
7403,7403,7403,7403,7403,7403,7403,7403,7404,2021-05-23 15:00:00+00:00,Montgomery,1596.0,618654,2612.0,515361,190.0,39491,1786.0,2802.0,554852,658145,1134015
7404,7404,7404,7404,7404,7404,7404,7404,7405,2021-11-03 15:00:00+00:00,Unknown,833.0,231723,246.0,169428,37.0,21655,870.0,283.0,191083,253378,401151
7405,7405,7405,7405,7405,7405,7405,7405,7406,2021-11-04 15:00:00+00:00,Unknown,784.0,232507,255.0,169683,31.0,21686,815.0,286.0,191369,254193,402190
7406,7406,7406,7406,7406,7406,7406,7406,7407,2021-11-05 15:00:00+00:00,Unknown,901.0,233408,284.0,169967,57.0,21743,958.0,341.0,191710,255151,403375
7407,7407,7407,7407,7407,7407,7407,7407,7408,2021-11-06 15:00:00+00:00,Unknown,170.0,233578,66.0,170033,10.0,21753,180.0,76.0,191786,255331,403611
7408,7408,7408,7408,7408,7408,7408,7408,7409,2021-07-31 15:00:00+00:00,Wicomico,36.0,43533,19.0,39759,1.0,3853,37.0,20.0,43612,47386,83292
7409,7409,7409,7409,7409,7409,7409,7409,7410,2021-08-01 15:00:00+00:00,Wicomico,37.0,43570,9.0,39768,2.0,3855,39.0,11.0,43623,47425,83338
7410,7410,7410,7410,7410,7410,7410,7410,7411,2021-08-02 15:00:00+00:00,Wicomico,106.0,43676,48.0,39816,13.0,3868,119.0,61.0,43684,47544,83492
7411,7411,7411,7411,7411,7411,7411,7411,7412,2021-08-03 15:00:00+00:00,Wicomico,134.0,43810,92.0,39908,16.0,3884,150.0,108.0,43792,47694,83718
7412,7412,7412,7412,7412,7412,7412,7412,7413,2021-08-04 15:00:00+00:00,Wicomico,127.0,43937,47.0,39955,11.0,3895,138.0,58.0,43850,47832,83892
7413,7413,7413,7413,7413,7413,7413,7413,7414,2021-08-05 15:00:00+00:00,Wicomico,185.0,44122,46.0,40001,29.0,3924,214.0,75.0,43925,48046,84123
7414,7414,7414,7414,7414,7414,7414,7414,7415,2021-08-06 15:00:00+00:00,Wicomico,143.0,44265,49.0,40050,15.0,3939,158.0,64.0,43989,48204,84315
7415,7415,7415,7415,7415,7415,7415,7415,7416,2021-08-07 15:00:00+00:00,Wicomico,62.0,44327,26.0,40076,1.0,3940,63.0,27.0,44016,48267,84403
7416,7416,7416,7416,7416,7416,7416,7416,7417,2021-08-08 15:00:00+00:00,Wicomico,43.0,44370,35.0,40111,1.0,3941,44.0,36.0,44052,48311,84481
7417,7417,7417,7417,7417,7417,7417,7417,7418,2021-08-09 15:00:00+00:00,Wicomico,184.0,44554,96.0,40207,11.0,3952,195.0,107.0,44159,48506,84761
7418,7418,7418,7418,7418,7418,7418,7418,7419,2021-08-10 15:00:00+00:00,Wicomico,90.0,44644,54.0,40261,12.0,3964,102.0,66.0,44225,48608,84905
7419,7419,7419,7419,7419,7419,7419,7419,7420,2021-08-11 15:00:00+00:00,Wicomico,115.0,44759,52.0,40313,10.0,3974,125.0,62.0,44287,48733,85072
7420,7420,7420,7420,7420,7420,7420,7420,7421,2021-08-12 15:00:00+00:00,Wicomico,86.0,44845,46.0,40359,6.0,3980,92.0,52.0,44339,48825,85204
7421,7421,7421,7421,7421,7421,7421,7421,7422,2021-08-13 15:00:00+00:00,Wicomico,137.0,44982,65.0,40424,7.0,3987,144.0,72.0,44411,48969,85406
7422,7422,7422,7422,7422,7422,7422,7422,7423,2021-08-14 15:00:00+00:00,Wicomico,63.0,45045,26.0,40450,5.0,3992,68.0,31.0,44442,49037,85495
7423,7423,7423,7423,7423,7423,7423,7423,7424,2021-08-15 15:00:00+00:00,Wicomico,50.0,45095,17.0,40467,,3992,,,44459,49087,85562
7424,7424,7424,7424,7424,7424,7424,7424,7425,2021-08-16 15:00:00+00:00,Wicomico,73.0,45168,98.0,40565,6.0,3998,79.0,104.0,44563,49166,85733
7425,7425,7425,7425,7425,7425,7425,7425,7426,2021-08-17 15:00:00+00:00,Wicomico,128.0,45296,97.0,40662,5.0,4003,133.0,102.0,44665,49299,85958
7426,7426,7426,7426,7426,7426,7426,7426,7427,2021-08-18 15:00:00+00:00,Wicomico,92.0,45388,96.0,40758,13.0,4016,105.0,109.0,44774,49404,86146
7427,7427,7427,7427,7427,7427,7427,7427,7428,2021-08-19 15:00:00+00:00,Wicomico,64.0,45452,59.0,40817,7.0,4023,71.0,66.0,44840,49475,86269
7428,7428,7428,7428,7428,7428,7428,7428,7429,2021-08-20 15:00:00+00:00,Wicomico,126.0,45578,70.0,40887,5.0,4028,131.0,75.0,44915,49606,86465
7429,7429,7429,7429,7429,7429,7429,7429,7430,2021-08-21 15:00:00+00:00,Wicomico,76.0,45654,41.0,40928,2.0,4030,78.0,43.0,44958,49684,86582
7430,7430,7430,7430,7430,7430,7430,7430,7431,2021-08-22 15:00:00+00:00,Wicomico,61.0,45715,42.0,40970,2.0,4032,63.0,44.0,45002,49747,86685
7431,7431,7431,7431,7431,7431,7431,7431,7432,2021-08-23 15:00:00+00:00,Wicomico,91.0,45806,110.0,41080,5.0,4037,96.0,115.0,45117,49843,86886
7432,7432,7432,7432,7432,7432,7432,7432,7433,2021-08-24 15:00:00+00:00,Wicomico,106.0,45912,93.0,41173,16.0,4053,122.0,109.0,45226,49965,87085
7433,7433,7433,7433,7433,7433,7433,7433,7434,2021-08-25 15:00:00+00:00,Wicomico,95.0,46007,84.0,41257,10.0,4063,105.0,94.0,45320,50070,87264
7434,7434,7434,7434,7434,7434,7434,7434,7435,2021-08-26 15:00:00+00:00,Wicomico,80.0,46087,103.0,41360,10.0,4073,90.0,113.0,45433,50160,87447
7435,7435,7435,7435,7435,7435,7435,7435,7436,2021-08-27 15:00:00+00:00,Wicomico,102.0,46189,146.0,41506,10.0,4083,112.0,156.0,45589,50272,87695
7436,7436,7436,7436,7436,7436,7436,7436,7437,2021-05-24 15:00:00+00:00,Montgomery,2128.0,620782,3698.0,519059,209.0,39700,2337.0,3907.0,558759,660482,1139841
7437,7437,7437,7437,7437,7437,7437,7437,7438,2021-05-25 15:00:00+00:00,Montgomery,2303.0,623085,3442.0,522501,156.0,39856,2459.0,3598.0,562357,662941,1145586
7438,7438,7438,7438,7438,7438,7438,7438,7439,2021-05-26 15:00:00+00:00,Montgomery,3208.0,626293,3374.0,525875,174.0,40030,3382.0,3548.0,565905,666323,1152168
7439,7439,7439,7439,7439,7439,7439,7439,7440,2021-05-27 15:00:00+00:00,Montgomery,2002.0,628295,3940.0,529815,141.0,40171,2143.0,4081.0,569986,668466,1158110
7440,7440,7440,7440,7440,7440,7440,7440,7441,2021-05-28 15:00:00+00:00,Montgomery,2181.0,630476,3946.0,533761,189.0,40360,2370.0,4135.0,574121,670836,1164237
7441,7441,7441,7441,7441,7441,7441,7441,7442,2021-05-29 15:00:00+00:00,Montgomery,2128.0,632604,2485.0,536246,145.0,40505,2273.0,2630.0,576751,673109,1168850
7442,7442,7442,7442,7442,7442,7442,7442,7443,2021-05-30 15:00:00+00:00,Montgomery,1133.0,633737,1295.0,537541,99.0,40604,1232.0,1394.0,578145,674341,1171278
7443,7443,7443,7443,7443,7443,7443,7443,7444,2021-05-31 15:00:00+00:00,Montgomery,251.0,633988,827.0,538368,34.0,40638,285.0,861.0,579006,674626,1172356
7444,7444,7444,7444,7444,7444,7444,7444,7445,2021-06-01 15:00:00+00:00,Montgomery,1844.0,635832,2472.0,540840,132.0,40770,1976.0,2604.0,581610,676602,1176672
7445,7445,7445,7445,7445,7445,7445,7445,7446,2021-06-02 15:00:00+00:00,Montgomery,1957.0,637789,2453.0,543293,119.0,40889,2076.0,2572.0,584182,678678,1181082
7446,7446,7446,7446,7446,7446,7446,7446,7447,2021-06-03 15:00:00+00:00,Montgomery,1418.0,639207,5408.0,548701,123.0,41012,1541.0,5531.0,589713,680219,1187908
7447,7447,7447,7447,7447,7447,7447,7447,7448,2021-06-04 15:00:00+00:00,Montgomery,1570.0,640777,5506.0,554207,125.0,41137,1695.0,5631.0,595344,681914,1194984
7448,7448,7448,7448,7448,7448,7448,7448,7449,2021-06-05 15:00:00+00:00,Montgomery,1581.0,642358,5819.0,560026,101.0,41238,1682.0,5920.0,601264,683596,1202384
7449,7449,7449,7449,7449,7449,7449,7449,7450,2021-06-06 15:00:00+00:00,Montgomery,752.0,643110,1862.0,561888,51.0,41289,803.0,1913.0,603177,684399,1204998
7450,7450,7450,7450,7450,7450,7450,7450,7451,2021-06-07 15:00:00+00:00,Montgomery,1324.0,644434,3827.0,565715,118.0,41407,1442.0,3945.0,607122,685841,1210149
7451,7451,7451,7451,7451,7451,7451,7451,7452,2021-06-08 15:00:00+00:00,Montgomery,1257.0,645691,3643.0,569358,94.0,41501,1351.0,3737.0,610859,687192,1215049
7452,7452,7452,7452,7452,7452,7452,7452,7453,2021-06-09 15:00:00+00:00,Montgomery,1922.0,647613,4719.0,574077,122.0,41623,2044.0,4841.0,615700,689236,1221690
7453,7453,7453,7453,7453,7453,7453,7453,7454,2021-06-10 15:00:00+00:00,Montgomery,1220.0,648833,3338.0,577415,101.0,41724,1321.0,3439.0,619139,690557,1226248
7454,7454,7454,7454,7454,7454,7454,7454,7455,2021-06-11 15:00:00+00:00,Montgomery,1328.0,650161,3238.0,580653,148.0,41872,1476.0,3386.0,622525,692033,1230814
7455,7455,7455,7455,7455,7455,7455,7455,7456,2021-06-12 15:00:00+00:00,Montgomery,990.0,651151,2965.0,583618,98.0,41970,1088.0,3063.0,625588,693121,1234769
7456,7456,7456,7456,7456,7456,7456,7456,7457,2021-06-13 15:00:00+00:00,Montgomery,436.0,651587,1491.0,585109,78.0,42048,514.0,1569.0,627157,693635,1236696
7457,7457,7457,7457,7457,7457,7457,7457,7458,2021-06-14 15:00:00+00:00,Montgomery,1084.0,652671,2205.0,587314,75.0,42123,1159.0,2280.0,629437,694794,1239985
7458,7458,7458,7458,7458,7458,7458,7458,7459,2021-06-15 15:00:00+00:00,Montgomery,985.0,653656,2405.0,589719,133.0,42256,1118.0,2538.0,631975,695912,1243375
7459,7459,7459,7459,7459,7459,7459,7459,7460,2021-06-16 15:00:00+00:00,Montgomery,1399.0,655055,3106.0,592825,111.0,42367,1510.0,3217.0,635192,697422,1247880
7460,7460,7460,7460,7460,7460,7460,7460,7461,2021-06-17 15:00:00+00:00,Montgomery,1235.0,656290,2320.0,595145,106.0,42473,1341.0,2426.0,637618,698763,1251435
7461,7461,7461,7461,7461,7461,7461,7461,7462,2021-06-18 15:00:00+00:00,Montgomery,1115.0,657405,2354.0,597499,88.0,42561,1203.0,2442.0,640060,699966,1254904
7462,7462,7462,7462,7462,7462,7462,7462,7463,2021-06-19 15:00:00+00:00,Montgomery,871.0,658276,1956.0,599455,138.0,42699,1009.0,2094.0,642154,700975,1257731
7463,7463,7463,7463,7463,7463,7463,7463,7464,2021-06-20 15:00:00+00:00,Montgomery,587.0,658863,1093.0,600548,74.0,42773,661.0,1167.0,643321,701636,1259411
7464,7464,7464,7464,7464,7464,7464,7464,7465,2021-08-28 15:00:00+00:00,Wicomico,44.0,46233,58.0,41564,,4083,,,45647,50316,87797
7465,7465,7465,7465,7465,7465,7465,7465,7466,2021-08-29 15:00:00+00:00,Wicomico,37.0,46270,42.0,41606,,4083,,,45689,50353,87876
7466,7466,7466,7466,7466,7466,7466,7466,7467,2021-08-30 15:00:00+00:00,Wicomico,89.0,46359,116.0,41722,7.0,4090,96.0,123.0,45812,50449,88081
7467,7467,7467,7467,7467,7467,7467,7467,7468,2021-08-31 15:00:00+00:00,Wicomico,108.0,46467,71.0,41793,7.0,4097,115.0,78.0,45890,50564,88260
7468,7468,7468,7468,7468,7468,7468,7468,7469,2021-09-01 15:00:00+00:00,Wicomico,105.0,46572,119.0,41912,23.0,4120,128.0,142.0,46032,50692,88484
7469,7469,7469,7469,7469,7469,7469,7469,7470,2021-09-02 15:00:00+00:00,Wicomico,93.0,46665,89.0,42001,10.0,4130,103.0,99.0,46131,50795,88666
7470,7470,7470,7470,7470,7470,7470,7470,7471,2021-09-03 15:00:00+00:00,Wicomico,90.0,46755,148.0,42149,12.0,4142,102.0,160.0,46291,50897,88904
7471,7471,7471,7471,7471,7471,7471,7471,7472,2021-09-04 15:00:00+00:00,Wicomico,32.0,46787,45.0,42194,,4142,,,46336,50929,88981
7472,7472,7472,7472,7472,7472,7472,7472,7473,2021-09-05 15:00:00+00:00,Wicomico,39.0,46826,42.0,42236,,4142,,,46378,50968,89062
7473,7473,7473,7473,7473,7473,7473,7473,7474,2021-09-06 15:00:00+00:00,Wicomico,41.0,46867,31.0,42267,1.0,4143,42.0,32.0,46410,51010,89134
7474,7474,7474,7474,7474,7474,7474,7474,7475,2021-09-07 15:00:00+00:00,Wicomico,59.0,46926,115.0,42382,6.0,4149,65.0,121.0,46531,51075,89308
7475,7475,7475,7475,7475,7475,7475,7475,7476,2021-09-08 15:00:00+00:00,Wicomico,72.0,46998,126.0,42508,5.0,4154,77.0,131.0,46662,51152,89506
7476,7476,7476,7476,7476,7476,7476,7476,7477,2021-09-09 15:00:00+00:00,Wicomico,69.0,47067,97.0,42605,3.0,4157,72.0,100.0,46762,51224,89672
7477,7477,7477,7477,7477,7477,7477,7477,7478,2021-09-10 15:00:00+00:00,Wicomico,105.0,47172,144.0,42749,20.0,4177,125.0,164.0,46926,51349,89921
7478,7478,7478,7478,7478,7478,7478,7478,7479,2021-09-11 15:00:00+00:00,Wicomico,50.0,47222,58.0,42807,,4177,,,46984,51399,90029
7479,7479,7479,7479,7479,7479,7479,7479,7480,2021-09-12 15:00:00+00:00,Wicomico,44.0,47266,66.0,42873,,4177,,,47050,51443,90139
7480,7480,7480,7480,7480,7480,7480,7480,7481,2021-09-13 15:00:00+00:00,Wicomico,74.0,47340,109.0,42982,9.0,4186,83.0,118.0,47168,51526,90322
7481,7481,7481,7481,7481,7481,7481,7481,7482,2021-09-14 15:00:00+00:00,Wicomico,64.0,47404,92.0,43074,2.0,4188,66.0,94.0,47262,51592,90478
7482,7482,7482,7482,7482,7482,7482,7482,7483,2021-09-15 15:00:00+00:00,Wicomico,58.0,47462,79.0,43153,2.0,4190,60.0,81.0,47343,51652,90615
7483,7483,7483,7483,7483,7483,7483,7483,7484,2021-09-16 15:00:00+00:00,Wicomico,87.0,47549,87.0,43240,12.0,4202,99.0,99.0,47442,51751,90789
7484,7484,7484,7484,7484,7484,7484,7484,7485,2021-09-17 15:00:00+00:00,Wicomico,58.0,47607,62.0,43302,11.0,4213,69.0,73.0,47515,51820,90909
7485,7485,7485,7485,7485,7485,7485,7485,7486,2021-09-18 15:00:00+00:00,Wicomico,31.0,47638,47.0,43349,2.0,4215,33.0,49.0,47564,51853,90987
7486,7486,7486,7486,7486,7486,7486,7486,7487,2021-09-19 15:00:00+00:00,Wicomico,28.0,47666,48.0,43397,,4215,,,47612,51881,91063
7487,7487,7487,7487,7487,7487,7487,7487,7488,2021-09-20 15:00:00+00:00,Wicomico,41.0,47707,87.0,43484,5.0,4220,46.0,92.0,47704,51927,91191
7488,7488,7488,7488,7488,7488,7488,7488,7489,2021-09-21 15:00:00+00:00,Wicomico,48.0,47755,94.0,43578,2.0,4222,50.0,96.0,47800,51977,91333
7489,7489,7489,7489,7489,7489,7489,7489,7490,2021-09-22 15:00:00+00:00,Wicomico,43.0,47798,72.0,43650,8.0,4230,51.0,80.0,47880,52028,91448
7490,7490,7490,7490,7490,7490,7490,7490,7491,2021-09-23 15:00:00+00:00,Wicomico,40.0,47838,66.0,43716,2.0,4232,42.0,68.0,47948,52070,91554
7491,7491,7491,7491,7491,7491,7491,7491,7492,2021-09-24 15:00:00+00:00,Wicomico,73.0,47911,92.0,43808,9.0,4241,82.0,101.0,48049,52152,91719
7492,7492,7492,7492,7492,7492,7492,7492,7493,2021-06-21 15:00:00+00:00,Montgomery,1155.0,660018,843.0,601391,100.0,42873,1255.0,943.0,644264,702891,1261409
7493,7493,7493,7493,7493,7493,7493,7493,7494,2021-06-22 15:00:00+00:00,Montgomery,879.0,660897,1538.0,602929,79.0,42952,958.0,1617.0,645881,703849,1263826
7494,7494,7494,7494,7494,7494,7494,7494,7495,2021-06-23 15:00:00+00:00,Montgomery,1174.0,662071,1855.0,604784,96.0,43048,1270.0,1951.0,647832,705119,1266855
7495,7495,7495,7495,7495,7495,7495,7495,7496,2021-06-24 15:00:00+00:00,Montgomery,1029.0,663100,1390.0,606174,87.0,43135,1116.0,1477.0,649309,706235,1269274
7496,7496,7496,7496,7496,7496,7496,7496,7497,2021-06-25 15:00:00+00:00,Montgomery,995.0,664095,1633.0,607807,100.0,43235,1095.0,1733.0,651042,707330,1271902
7497,7497,7497,7497,7497,7497,7497,7497,7498,2021-06-26 15:00:00+00:00,Montgomery,787.0,664882,1420.0,609227,94.0,43329,881.0,1514.0,652556,708211,1274109
7498,7498,7498,7498,7498,7498,7498,7498,7499,2021-06-27 15:00:00+00:00,Montgomery,675.0,665557,727.0,609954,52.0,43381,727.0,779.0,653335,708938,1275511
7499,7499,7499,7499,7499,7499,7499,7499,7500,2021-06-28 15:00:00+00:00,Montgomery,867.0,666424,1187.0,611141,47.0,43428,914.0,1234.0,654569,709852,1277565
7500,7500,7500,7500,7500,7500,7500,7500,7501,2021-06-29 15:00:00+00:00,Montgomery,826.0,667250,1216.0,612357,85.0,43513,911.0,1301.0,655870,710763,1279607
7501,7501,7501,7501,7501,7501,7501,7501,7502,2021-06-30 15:00:00+00:00,Montgomery,982.0,668232,1632.0,613989,79.0,43592,1061.0,1711.0,657581,711824,1282221
7502,7502,7502,7502,7502,7502,7502,7502,7503,2021-07-01 15:00:00+00:00,Montgomery,881.0,669113,1103.0,615092,61.0,43653,942.0,1164.0,658745,712766,1284205
7503,7503,7503,7503,7503,7503,7503,7503,7504,2021-07-02 15:00:00+00:00,Montgomery,948.0,670061,1294.0,616386,102.0,43755,1050.0,1396.0,660141,713816,1286447
7504,7504,7504,7504,7504,7504,7504,7504,7505,2021-07-03 15:00:00+00:00,Montgomery,625.0,670686,642.0,617028,72.0,43827,697.0,714.0,660855,714513,1287714
7505,7505,7505,7505,7505,7505,7505,7505,7506,2021-07-04 15:00:00+00:00,Montgomery,79.0,670765,112.0,617140,8.0,43835,87.0,120.0,660975,714600,1287905
7506,7506,7506,7506,7506,7506,7506,7506,7507,2021-07-05 15:00:00+00:00,Montgomery,696.0,671461,723.0,617863,20.0,43855,716.0,743.0,661718,715316,1289324
7507,7507,7507,7507,7507,7507,7507,7507,7508,2021-07-06 15:00:00+00:00,Montgomery,732.0,672193,1097.0,618960,72.0,43927,804.0,1169.0,662887,716120,1291153
7508,7508,7508,7508,7508,7508,7508,7508,7509,2021-07-07 15:00:00+00:00,Montgomery,805.0,672998,1253.0,620213,65.0,43992,870.0,1318.0,664205,716990,1293211
7509,7509,7509,7509,7509,7509,7509,7509,7510,2021-07-08 15:00:00+00:00,Montgomery,783.0,673781,1125.0,621338,67.0,44059,850.0,1192.0,665397,717840,1295119
7510,7510,7510,7510,7510,7510,7510,7510,7511,2021-07-09 15:00:00+00:00,Montgomery,849.0,674630,1081.0,622419,76.0,44135,925.0,1157.0,666554,718765,1297049
7511,7511,7511,7511,7511,7511,7511,7511,7512,2021-07-10 15:00:00+00:00,Montgomery,577.0,675207,725.0,623144,55.0,44190,632.0,780.0,667334,719397,1298351
7512,7512,7512,7512,7512,7512,7512,7512,7513,2021-07-11 15:00:00+00:00,Montgomery,505.0,675712,528.0,623672,48.0,44238,553.0,576.0,667910,719950,1299384
7513,7513,7513,7513,7513,7513,7513,7513,7514,2021-07-12 15:00:00+00:00,Montgomery,713.0,676425,1064.0,624736,40.0,44278,753.0,1104.0,669014,720703,1301161
7514,7514,7514,7514,7514,7514,7514,7514,7515,2021-07-13 15:00:00+00:00,Montgomery,795.0,677220,766.0,625502,48.0,44326,843.0,814.0,669828,721546,1302722
7515,7515,7515,7515,7515,7515,7515,7515,7516,2021-07-14 15:00:00+00:00,Montgomery,715.0,677935,967.0,626469,48.0,44374,763.0,1015.0,670843,722309,1304404
7516,7516,7516,7516,7516,7516,7516,7516,7517,2021-07-15 15:00:00+00:00,Montgomery,796.0,678731,878.0,627347,32.0,44406,828.0,910.0,671753,723137,1306078
7517,7517,7517,7517,7517,7517,7517,7517,7518,2021-07-16 15:00:00+00:00,Montgomery,735.0,679466,943.0,628290,42.0,44448,777.0,985.0,672738,723914,1307756
7518,7518,7518,7518,7518,7518,7518,7518,7519,2021-07-17 15:00:00+00:00,Montgomery,572.0,680038,665.0,628955,48.0,44496,620.0,713.0,673451,724534,1308993
7519,7519,7519,7519,7519,7519,7519,7519,7520,2021-07-18 15:00:00+00:00,Montgomery,418.0,680456,512.0,629467,20.0,44516,438.0,532.0,673983,724972,1309923
7520,7520,7520,7520,7520,7520,7520,7520,7521,2021-09-25 15:00:00+00:00,Wicomico,41.0,47952,39.0,43847,1.0,4242,42.0,40.0,48089,52194,91799
7521,7521,7521,7521,7521,7521,7521,7521,7522,2021-09-26 15:00:00+00:00,Wicomico,18.0,47970,25.0,43872,1.0,4243,19.0,26.0,48115,52213,91842
7522,7522,7522,7522,7522,7522,7522,7522,7523,2021-09-27 15:00:00+00:00,Wicomico,48.0,48018,58.0,43930,5.0,4248,53.0,63.0,48178,52266,91948
7523,7523,7523,7523,7523,7523,7523,7523,7524,2021-09-28 15:00:00+00:00,Wicomico,26.0,48044,57.0,43987,2.0,4250,28.0,59.0,48237,52294,92031
7524,7524,7524,7524,7524,7524,7524,7524,7525,2021-09-29 15:00:00+00:00,Wicomico,64.0,48108,98.0,44085,9.0,4259,73.0,107.0,48344,52367,92193
7525,7525,7525,7525,7525,7525,7525,7525,7526,2021-09-30 15:00:00+00:00,Wicomico,44.0,48152,67.0,44152,1.0,4260,45.0,68.0,48412,52412,92304
7526,7526,7526,7526,7526,7526,7526,7526,7527,2021-10-01 15:00:00+00:00,Wicomico,54.0,48206,81.0,44233,5.0,4265,59.0,86.0,48498,52471,92439
7527,7527,7527,7527,7527,7527,7527,7527,7528,2021-10-02 15:00:00+00:00,Wicomico,38.0,48244,47.0,44280,4.0,4269,42.0,51.0,48549,52513,92524
7528,7528,7528,7528,7528,7528,7528,7528,7529,2021-10-03 15:00:00+00:00,Wicomico,6.0,48250,22.0,44302,,4269,,,48571,52519,92552
7529,7529,7529,7529,7529,7529,7529,7529,7530,2021-10-04 15:00:00+00:00,Wicomico,76.0,48326,59.0,44361,7.0,4276,83.0,66.0,48637,52602,92687
7530,7530,7530,7530,7530,7530,7530,7530,7531,2021-10-05 15:00:00+00:00,Wicomico,54.0,48380,38.0,44399,3.0,4279,57.0,41.0,48678,52659,92779
7531,7531,7531,7531,7531,7531,7531,7531,7532,2021-10-06 15:00:00+00:00,Wicomico,66.0,48446,65.0,44464,8.0,4287,74.0,73.0,48751,52733,92910
7532,7532,7532,7532,7532,7532,7532,7532,7533,2021-10-07 15:00:00+00:00,Wicomico,50.0,48496,45.0,44509,3.0,4290,53.0,48.0,48799,52786,93005
7533,7533,7533,7533,7533,7533,7533,7533,7534,2021-10-08 15:00:00+00:00,Wicomico,56.0,48552,80.0,44589,4.0,4294,60.0,84.0,48883,52846,93141
7534,7534,7534,7534,7534,7534,7534,7534,7535,2021-10-09 15:00:00+00:00,Wicomico,35.0,48587,34.0,44623,1.0,4295,36.0,35.0,48918,52882,93210
7535,7535,7535,7535,7535,7535,7535,7535,7536,2021-10-10 15:00:00+00:00,Wicomico,5.0,48592,13.0,44636,,4295,,,48931,52887,93228
7536,7536,7536,7536,7536,7536,7536,7536,7537,2021-10-11 15:00:00+00:00,Wicomico,39.0,48631,38.0,44674,1.0,4296,40.0,39.0,48970,52927,93305
7537,7537,7537,7537,7537,7537,7537,7537,7538,2021-10-12 15:00:00+00:00,Wicomico,23.0,48654,38.0,44712,3.0,4299,26.0,41.0,49011,52953,93366
7538,7538,7538,7538,7538,7538,7538,7538,7539,2021-10-13 15:00:00+00:00,Wicomico,39.0,48693,50.0,44762,6.0,4305,45.0,56.0,49067,52998,93455
7539,7539,7539,7539,7539,7539,7539,7539,7540,2021-10-14 15:00:00+00:00,Wicomico,24.0,48717,37.0,44799,4.0,4309,28.0,41.0,49108,53026,93516
7540,7540,7540,7540,7540,7540,7540,7540,7541,2021-10-15 15:00:00+00:00,Wicomico,48.0,48765,69.0,44868,7.0,4316,55.0,76.0,49184,53081,93633
7541,7541,7541,7541,7541,7541,7541,7541,7542,2021-10-16 15:00:00+00:00,Wicomico,25.0,48790,36.0,44904,,4316,,,49220,53106,93694
7542,7542,7542,7542,7542,7542,7542,7542,7543,2021-10-17 15:00:00+00:00,Wicomico,12.0,48802,18.0,44922,,4316,,,49238,53118,93724
7543,7543,7543,7543,7543,7543,7543,7543,7544,2021-10-18 15:00:00+00:00,Wicomico,52.0,48854,62.0,44984,8.0,4324,60.0,70.0,49308,53178,93838
7544,7544,7544,7544,7544,7544,7544,7544,7545,2021-10-19 15:00:00+00:00,Wicomico,29.0,48883,33.0,45017,4.0,4328,33.0,37.0,49345,53211,93900
7545,7545,7545,7545,7545,7545,7545,7545,7546,2021-10-20 15:00:00+00:00,Wicomico,43.0,48926,39.0,45056,1.0,4329,44.0,40.0,49385,53255,93982
7546,7546,7546,7546,7546,7546,7546,7546,7547,2021-10-21 15:00:00+00:00,Wicomico,24.0,48950,28.0,45084,6.0,4335,30.0,34.0,49419,53285,94034
7547,7547,7547,7547,7547,7547,7547,7547,7548,2021-10-22 15:00:00+00:00,Wicomico,36.0,48986,51.0,45135,2.0,4337,38.0,53.0,49472,53323,94121
7548,7548,7548,7548,7548,7548,7548,7548,7549,2021-07-19 15:00:00+00:00,Montgomery,839.0,681295,805.0,630272,29.0,44545,868.0,834.0,674817,725840,1311567
7549,7549,7549,7549,7549,7549,7549,7549,7550,2021-07-20 15:00:00+00:00,Montgomery,845.0,682140,756.0,631028,57.0,44602,902.0,813.0,675630,726742,1313168
7550,7550,7550,7550,7550,7550,7550,7550,7551,2021-07-21 15:00:00+00:00,Montgomery,758.0,682898,889.0,631917,38.0,44640,796.0,927.0,676557,727538,1314815
7551,7551,7551,7551,7551,7551,7551,7551,7552,2021-07-22 15:00:00+00:00,Montgomery,829.0,683727,801.0,632718,34.0,44674,863.0,835.0,677392,728401,1316445
7552,7552,7552,7552,7552,7552,7552,7552,7553,2021-07-23 15:00:00+00:00,Montgomery,917.0,684644,847.0,633565,45.0,44719,962.0,892.0,678284,729363,1318209
7553,7553,7553,7553,7553,7553,7553,7553,7554,2021-07-24 15:00:00+00:00,Montgomery,704.0,685348,632.0,634197,30.0,44749,734.0,662.0,678946,730097,1319545
7554,7554,7554,7554,7554,7554,7554,7554,7555,2021-07-25 15:00:00+00:00,Montgomery,541.0,685889,228.0,634425,31.0,44780,572.0,259.0,679205,730669,1320314
7555,7555,7555,7555,7555,7555,7555,7555,7556,2021-07-26 15:00:00+00:00,Montgomery,908.0,686797,684.0,635109,26.0,44806,934.0,710.0,679915,731603,1321906
7556,7556,7556,7556,7556,7556,7556,7556,7557,2021-07-27 15:00:00+00:00,Montgomery,861.0,687658,616.0,635725,43.0,44849,904.0,659.0,680574,732507,1323383
7557,7557,7557,7557,7557,7557,7557,7557,7558,2021-07-28 15:00:00+00:00,Montgomery,824.0,688482,698.0,636423,55.0,44904,879.0,753.0,681327,733386,1324905
7558,7558,7558,7558,7558,7558,7558,7558,7559,2021-07-29 15:00:00+00:00,Montgomery,836.0,689318,686.0,637109,47.0,44951,883.0,733.0,682060,734269,1326427
7559,7559,7559,7559,7559,7559,7559,7559,7560,2021-07-30 15:00:00+00:00,Montgomery,940.0,690258,749.0,637858,52.0,45003,992.0,801.0,682861,735261,1328116
7560,7560,7560,7560,7560,7560,7560,7560,7561,2021-07-31 15:00:00+00:00,Montgomery,713.0,690971,548.0,638406,51.0,45054,764.0,599.0,683460,736025,1329377
7561,7561,7561,7561,7561,7561,7561,7561,7562,2021-08-01 15:00:00+00:00,Montgomery,633.0,691604,427.0,638833,35.0,45089,668.0,462.0,683922,736693,1330437
7562,7562,7562,7562,7562,7562,7562,7562,7563,2021-08-02 15:00:00+00:00,Montgomery,975.0,692579,593.0,639426,21.0,45110,996.0,614.0,684536,737689,1332005
7563,7563,7563,7563,7563,7563,7563,7563,7564,2021-08-03 15:00:00+00:00,Montgomery,887.0,693466,607.0,640033,45.0,45155,932.0,652.0,685188,738621,1333499
7564,7564,7564,7564,7564,7564,7564,7564,7565,2021-08-04 15:00:00+00:00,Montgomery,892.0,694358,594.0,640627,54.0,45209,946.0,648.0,685836,739567,1334985
7565,7565,7565,7565,7565,7565,7565,7565,7566,2021-08-05 15:00:00+00:00,Montgomery,944.0,695302,616.0,641243,32.0,45241,976.0,648.0,686484,740543,1336545
7566,7566,7566,7566,7566,7566,7566,7566,7567,2021-08-06 15:00:00+00:00,Montgomery,1106.0,696408,739.0,641982,36.0,45277,1142.0,775.0,687259,741685,1338390
7567,7567,7567,7567,7567,7567,7567,7567,7568,2021-08-07 15:00:00+00:00,Montgomery,842.0,697250,533.0,642515,31.0,45308,873.0,564.0,687823,742558,1339765
7568,7568,7568,7568,7568,7568,7568,7568,7569,2021-08-08 15:00:00+00:00,Montgomery,676.0,697926,395.0,642910,23.0,45331,699.0,418.0,688241,743257,1340836
7569,7569,7569,7569,7569,7569,7569,7569,7570,2021-08-09 15:00:00+00:00,Montgomery,946.0,698872,748.0,643658,25.0,45356,971.0,773.0,689014,744228,1342530
7570,7570,7570,7570,7570,7570,7570,7570,7571,2021-08-10 15:00:00+00:00,Montgomery,907.0,699779,724.0,644382,37.0,45393,944.0,761.0,689775,745172,1344161
7571,7571,7571,7571,7571,7571,7571,7571,7572,2021-08-11 15:00:00+00:00,Montgomery,909.0,700688,664.0,645046,29.0,45422,938.0,693.0,690468,746110,1345734
7572,7572,7572,7572,7572,7572,7572,7572,7573,2021-08-12 15:00:00+00:00,Montgomery,815.0,701503,649.0,645695,32.0,45454,847.0,681.0,691149,746957,1347198
7573,7573,7573,7573,7573,7573,7573,7573,7574,2021-08-13 15:00:00+00:00,Montgomery,896.0,702399,772.0,646467,31.0,45485,927.0,803.0,691952,747884,1348866
7574,7574,7574,7574,7574,7574,7574,7574,7575,2021-08-14 15:00:00+00:00,Montgomery,709.0,703108,590.0,647057,33.0,45518,742.0,623.0,692575,748626,1350165
7575,7575,7575,7575,7575,7575,7575,7575,7576,2021-08-15 15:00:00+00:00,Montgomery,534.0,703642,471.0,647528,26.0,45544,560.0,497.0,693072,749186,1351170
7576,7576,7576,7576,7576,7576,7576,7576,7577,2021-10-23 15:00:00+00:00,Wicomico,24.0,49010,50.0,45185,,4337,,,49522,53347,94195
7577,7577,7577,7577,7577,7577,7577,7577,7578,2021-10-24 15:00:00+00:00,Wicomico,19.0,49029,13.0,45198,2.0,4339,21.0,15.0,49537,53368,94227
7578,7578,7578,7578,7578,7578,7578,7578,7579,2021-10-25 15:00:00+00:00,Wicomico,57.0,49086,72.0,45270,6.0,4345,63.0,78.0,49615,53431,94356
7579,7579,7579,7579,7579,7579,7579,7579,7580,2021-10-26 15:00:00+00:00,Wicomico,46.0,49132,100.0,45370,,4345,,,49715,53477,94502
7580,7580,7580,7580,7580,7580,7580,7580,7581,2021-10-27 15:00:00+00:00,Wicomico,57.0,49189,74.0,45444,2.0,4347,59.0,76.0,49791,53536,94633
7581,7581,7581,7581,7581,7581,7581,7581,7582,2021-10-28 15:00:00+00:00,Wicomico,34.0,49223,44.0,45488,3.0,4350,37.0,47.0,49838,53573,94711
7582,7582,7582,7582,7582,7582,7582,7582,7583,2021-10-29 15:00:00+00:00,Wicomico,42.0,49265,60.0,45548,6.0,4356,48.0,66.0,49904,53621,94813
7583,7583,7583,7583,7583,7583,7583,7583,7584,2021-10-30 15:00:00+00:00,Wicomico,30.0,49295,37.0,45585,5.0,4361,35.0,42.0,49946,53656,94880
7584,7584,7584,7584,7584,7584,7584,7584,7585,2021-10-31 15:00:00+00:00,Wicomico,14.0,49309,12.0,45597,2.0,4363,16.0,14.0,49960,53672,94906
7585,7585,7585,7585,7585,7585,7585,7585,7586,2021-11-01 15:00:00+00:00,Wicomico,42.0,49351,44.0,45641,3.0,4366,45.0,47.0,50007,53717,94992
7586,7586,7586,7586,7586,7586,7586,7586,7587,2021-11-02 15:00:00+00:00,Wicomico,30.0,49381,35.0,45676,3.0,4369,33.0,38.0,50045,53750,95057
7587,7587,7587,7587,7587,7587,7587,7587,7588,2021-11-03 15:00:00+00:00,Wicomico,54.0,49435,48.0,45724,7.0,4376,61.0,55.0,50100,53811,95159
7588,7588,7588,7588,7588,7588,7588,7588,7589,2021-11-04 15:00:00+00:00,Wicomico,41.0,49476,46.0,45770,6.0,4382,47.0,52.0,50152,53858,95246
7589,7589,7589,7589,7589,7589,7589,7589,7590,2021-11-05 15:00:00+00:00,Wicomico,46.0,49522,54.0,45824,4.0,4386,50.0,58.0,50210,53908,95346
7590,7590,7590,7590,7590,7590,7590,7590,7591,2021-11-06 15:00:00+00:00,Wicomico,10.0,49532,9.0,45833,1.0,4387,11.0,10.0,50220,53919,95365
7591,7591,7591,7591,7591,7591,7591,7591,7592,2020-12-15 15:00:00+00:00,Worcester,4.0,4,,0,,0,,,0,4,4
7592,7592,7592,7592,7592,7592,7592,7592,7593,2020-12-16 15:00:00+00:00,Worcester,2.0,6,,0,,0,,,0,6,6
7593,7593,7593,7593,7593,7593,7593,7593,7594,2020-12-17 15:00:00+00:00,Worcester,28.0,34,,0,,0,,,0,34,34
7594,7594,7594,7594,7594,7594,7594,7594,7595,2020-12-18 15:00:00+00:00,Worcester,156.0,190,3.0,3,,0,,,3,190,193
7595,7595,7595,7595,7595,7595,7595,7595,7596,2020-12-19 15:00:00+00:00,Worcester,41.0,231,,3,,0,,,3,231,234
7596,7596,7596,7596,7596,7596,7596,7596,7597,2020-12-21 15:00:00+00:00,Worcester,56.0,287,1.0,4,,0,,,4,287,291
7597,7597,7597,7597,7597,7597,7597,7597,7598,2020-12-22 15:00:00+00:00,Worcester,83.0,370,1.0,5,,0,,,5,370,375
7598,7598,7598,7598,7598,7598,7598,7598,7599,2020-12-23 15:00:00+00:00,Worcester,78.0,448,,5,,0,,,5,448,453
7599,7599,7599,7599,7599,7599,7599,7599,7600,2020-12-24 15:00:00+00:00,Worcester,33.0,481,,5,,0,,,5,481,486
7600,7600,7600,7600,7600,7600,7600,7600,7601,2020-12-26 15:00:00+00:00,Worcester,2.0,483,,5,,0,,,5,483,488
7601,7601,7601,7601,7601,7601,7601,7601,7602,2020-12-27 15:00:00+00:00,Worcester,49.0,532,,5,,0,,,5,532,537
7602,7602,7602,7602,7602,7602,7602,7602,7603,2020-12-28 15:00:00+00:00,Worcester,66.0,598,,5,,0,,,5,598,603
7603,7603,7603,7603,7603,7603,7603,7603,7604,2020-12-29 15:00:00+00:00,Worcester,247.0,845,1.0,6,,0,,,6,845,851
7604,7604,7604,7604,7604,7604,7604,7604,7605,2021-08-16 15:00:00+00:00,Montgomery,802.0,704444,738.0,648266,19.0,45563,821.0,757.0,693829,750007,1352710
7605,7605,7605,7605,7605,7605,7605,7605,7606,2021-08-17 15:00:00+00:00,Montgomery,885.0,705329,707.0,648973,31.0,45594,916.0,738.0,694567,750923,1354302
7606,7606,7606,7606,7606,7606,7606,7606,7607,2021-08-18 15:00:00+00:00,Montgomery,805.0,706134,688.0,649661,27.0,45621,832.0,715.0,695282,751755,1355795
7607,7607,7607,7607,7607,7607,7607,7607,7608,2021-08-19 15:00:00+00:00,Montgomery,729.0,706863,687.0,650348,27.0,45648,756.0,714.0,695996,752511,1357211
7608,7608,7608,7608,7608,7608,7608,7608,7609,2021-08-20 15:00:00+00:00,Montgomery,924.0,707787,809.0,651157,37.0,45685,961.0,846.0,696842,753472,1358944
7609,7609,7609,7609,7609,7609,7609,7609,7610,2021-08-21 15:00:00+00:00,Montgomery,769.0,708556,606.0,651763,23.0,45708,792.0,629.0,697471,754264,1360319
7610,7610,7610,7610,7610,7610,7610,7610,7611,2021-08-22 15:00:00+00:00,Montgomery,432.0,708988,522.0,652285,25.0,45733,457.0,547.0,698018,754721,1361273
7611,7611,7611,7611,7611,7611,7611,7611,7612,2021-08-23 15:00:00+00:00,Montgomery,866.0,709854,925.0,653210,23.0,45756,889.0,948.0,698966,755610,1363064
7612,7612,7612,7612,7612,7612,7612,7612,7613,2021-08-24 15:00:00+00:00,Montgomery,887.0,710741,806.0,654016,31.0,45787,918.0,837.0,699803,756528,1364757
7613,7613,7613,7613,7613,7613,7613,7613,7614,2021-08-25 15:00:00+00:00,Montgomery,938.0,711679,751.0,654767,38.0,45825,976.0,789.0,700592,757504,1366446
7614,7614,7614,7614,7614,7614,7614,7614,7615,2021-08-26 15:00:00+00:00,Montgomery,852.0,712531,788.0,655555,21.0,45846,873.0,809.0,701401,758377,1368086
7615,7615,7615,7615,7615,7615,7615,7615,7616,2021-08-27 15:00:00+00:00,Montgomery,921.0,713452,931.0,656486,21.0,45867,942.0,952.0,702353,759319,1369938
7616,7616,7616,7616,7616,7616,7616,7616,7617,2021-08-28 15:00:00+00:00,Montgomery,711.0,714163,757.0,657243,33.0,45900,744.0,790.0,703143,760063,1371406
7617,7617,7617,7617,7617,7617,7617,7617,7618,2021-08-29 15:00:00+00:00,Montgomery,491.0,714654,585.0,657828,11.0,45911,502.0,596.0,703739,760565,1372482
7618,7618,7618,7618,7618,7618,7618,7618,7619,2021-08-30 15:00:00+00:00,Montgomery,685.0,715339,775.0,658603,19.0,45930,704.0,794.0,704533,761269,1373942
7619,7619,7619,7619,7619,7619,7619,7619,7620,2021-08-31 15:00:00+00:00,Montgomery,616.0,715955,758.0,659361,18.0,45948,634.0,776.0,705309,761903,1375316
7620,7620,7620,7620,7620,7620,7620,7620,7621,2021-09-01 15:00:00+00:00,Montgomery,612.0,716567,712.0,660073,25.0,45973,637.0,737.0,706046,762540,1376640
7621,7621,7621,7621,7621,7621,7621,7621,7622,2021-09-02 15:00:00+00:00,Montgomery,579.0,717146,718.0,660791,29.0,46002,608.0,747.0,706793,763148,1377937
7622,7622,7622,7622,7622,7622,7622,7622,7623,2021-09-03 15:00:00+00:00,Montgomery,736.0,717882,837.0,661628,18.0,46020,754.0,855.0,707648,763902,1379510
7623,7623,7623,7623,7623,7623,7623,7623,7624,2021-09-04 15:00:00+00:00,Montgomery,629.0,718511,632.0,662260,19.0,46039,648.0,651.0,708299,764550,1380771
7624,7624,7624,7624,7624,7624,7624,7624,7625,2021-09-05 15:00:00+00:00,Montgomery,401.0,718912,374.0,662634,7.0,46046,408.0,381.0,708680,764958,1381546
7625,7625,7625,7625,7625,7625,7625,7625,7626,2021-09-06 15:00:00+00:00,Montgomery,117.0,719029,127.0,662761,6.0,46052,123.0,133.0,708813,765081,1381790
7626,7626,7626,7626,7626,7626,7626,7626,7627,2021-09-07 15:00:00+00:00,Montgomery,657.0,719686,967.0,663728,40.0,46092,697.0,1007.0,709820,765778,1383414
7627,7627,7627,7627,7627,7627,7627,7627,7628,2021-09-08 15:00:00+00:00,Montgomery,503.0,720189,658.0,664386,24.0,46116,527.0,682.0,710502,766305,1384575
7628,7628,7628,7628,7628,7628,7628,7628,7629,2021-09-09 15:00:00+00:00,Montgomery,539.0,720728,619.0,665005,19.0,46135,558.0,638.0,711140,766863,1385733
7629,7629,7629,7629,7629,7629,7629,7629,7630,2021-09-10 15:00:00+00:00,Montgomery,682.0,721410,771.0,665776,42.0,46177,724.0,813.0,711953,767587,1387186
7630,7630,7630,7630,7630,7630,7630,7630,7631,2021-09-11 15:00:00+00:00,Montgomery,488.0,721898,597.0,666373,27.0,46204,515.0,624.0,712577,768102,1388271
7631,7631,7631,7631,7631,7631,7631,7631,7632,2021-09-12 15:00:00+00:00,Montgomery,307.0,722205,369.0,666742,13.0,46217,320.0,382.0,712959,768422,1388947
7632,7632,7632,7632,7632,7632,7632,7632,7633,2020-12-30 15:00:00+00:00,Worcester,93.0,938,,6,,0,,,6,938,944
7633,7633,7633,7633,7633,7633,7633,7633,7634,2020-12-31 15:00:00+00:00,Worcester,62.0,1000,,6,,0,,,6,1000,1006
7634,7634,7634,7634,7634,7634,7634,7634,7635,2021-01-01 15:00:00+00:00,Worcester,46.0,1046,3.0,9,,0,,,9,1046,1055
7635,7635,7635,7635,7635,7635,7635,7635,7636,2021-01-02 15:00:00+00:00,Worcester,8.0,1054,1.0,10,,0,,,10,1054,1064
7636,7636,7636,7636,7636,7636,7636,7636,7637,2021-01-03 15:00:00+00:00,Worcester,10.0,1064,,10,,0,,,10,1064,1074
7637,7637,7637,7637,7637,7637,7637,7637,7638,2021-01-04 15:00:00+00:00,Worcester,85.0,1149,1.0,11,,0,,,11,1149,1160
7638,7638,7638,7638,7638,7638,7638,7638,7639,2021-01-05 15:00:00+00:00,Worcester,283.0,1432,2.0,13,,0,,,13,1432,1445
7639,7639,7639,7639,7639,7639,7639,7639,7640,2021-01-06 15:00:00+00:00,Worcester,93.0,1525,3.0,16,,0,,,16,1525,1541
7640,7640,7640,7640,7640,7640,7640,7640,7641,2021-01-07 15:00:00+00:00,Worcester,78.0,1603,34.0,50,,0,,,50,1603,1653
7641,7641,7641,7641,7641,7641,7641,7641,7642,2021-01-08 15:00:00+00:00,Worcester,84.0,1687,151.0,201,,0,,,201,1687,1888
7642,7642,7642,7642,7642,7642,7642,7642,7643,2021-01-09 15:00:00+00:00,Worcester,83.0,1770,42.0,243,,0,,,243,1770,2013
7643,7643,7643,7643,7643,7643,7643,7643,7644,2021-01-10 15:00:00+00:00,Worcester,5.0,1775,,243,,0,,,243,1775,2018
7644,7644,7644,7644,7644,7644,7644,7644,7645,2021-01-11 15:00:00+00:00,Worcester,45.0,1820,1.0,244,,0,,,244,1820,2064
7645,7645,7645,7645,7645,7645,7645,7645,7646,2021-01-12 15:00:00+00:00,Worcester,246.0,2066,115.0,359,,0,,,359,2066,2425
7646,7646,7646,7646,7646,7646,7646,7646,7647,2021-01-13 15:00:00+00:00,Worcester,28.0,2094,60.0,419,,0,,,419,2094,2513
7647,7647,7647,7647,7647,7647,7647,7647,7648,2021-01-14 15:00:00+00:00,Worcester,124.0,2218,28.0,447,,0,,,447,2218,2665
7648,7648,7648,7648,7648,7648,7648,7648,7649,2021-01-15 15:00:00+00:00,Worcester,185.0,2403,9.0,456,,0,,,456,2403,2859
7649,7649,7649,7649,7649,7649,7649,7649,7650,2021-01-16 15:00:00+00:00,Worcester,679.0,3082,12.0,468,,0,,,468,3082,3550
7650,7650,7650,7650,7650,7650,7650,7650,7651,2021-01-17 15:00:00+00:00,Worcester,14.0,3096,44.0,512,,0,,,512,3096,3608
7651,7651,7651,7651,7651,7651,7651,7651,7652,2021-01-18 15:00:00+00:00,Worcester,94.0,3190,8.0,520,,0,,,520,3190,3710
7652,7652,7652,7652,7652,7652,7652,7652,7653,2021-01-19 15:00:00+00:00,Worcester,565.0,3755,109.0,629,,0,,,629,3755,4384
7653,7653,7653,7653,7653,7653,7653,7653,7654,2021-01-20 15:00:00+00:00,Worcester,183.0,3938,10.0,639,,0,,,639,3938,4577
7654,7654,7654,7654,7654,7654,7654,7654,7655,2021-01-21 15:00:00+00:00,Worcester,527.0,4465,20.0,659,,0,,,659,4465,5124
7655,7655,7655,7655,7655,7655,7655,7655,7656,2021-01-22 15:00:00+00:00,Worcester,225.0,4690,21.0,680,,0,,,680,4690,5370
7656,7656,7656,7656,7656,7656,7656,7656,7657,2021-01-23 15:00:00+00:00,Worcester,233.0,4923,7.0,687,,0,,,687,4923,5610
7657,7657,7657,7657,7657,7657,7657,7657,7658,2021-01-24 15:00:00+00:00,Worcester,4.0,4927,7.0,694,,0,,,694,4927,5621
7658,7658,7658,7658,7658,7658,7658,7658,7659,2021-01-25 15:00:00+00:00,Worcester,194.0,5121,51.0,745,,0,,,745,5121,5866
7659,7659,7659,7659,7659,7659,7659,7659,7660,2021-01-26 15:00:00+00:00,Worcester,440.0,5561,135.0,880,,0,,,880,5561,6441
7660,7660,7660,7660,7660,7660,7660,7660,7661,2021-09-13 15:00:00+00:00,Montgomery,529.0,722734,631.0,667373,24.0,46241,553.0,655.0,713614,768975,1390107
7661,7661,7661,7661,7661,7661,7661,7661,7662,2021-09-14 15:00:00+00:00,Montgomery,529.0,723263,581.0,667954,23.0,46264,552.0,604.0,714218,769527,1391217
7662,7662,7662,7662,7662,7662,7662,7662,7663,2021-09-15 15:00:00+00:00,Montgomery,516.0,723779,627.0,668581,30.0,46294,546.0,657.0,714875,770073,1392360
7663,7663,7663,7663,7663,7663,7663,7663,7664,2021-09-16 15:00:00+00:00,Montgomery,503.0,724282,585.0,669166,9.0,46303,512.0,594.0,715469,770585,1393448
7664,7664,7664,7664,7664,7664,7664,7664,7665,2021-09-17 15:00:00+00:00,Montgomery,589.0,724871,745.0,669911,34.0,46337,623.0,779.0,716248,771208,1394782
7665,7665,7665,7665,7665,7665,7665,7665,7666,2021-09-18 15:00:00+00:00,Montgomery,481.0,725352,574.0,670485,7.0,46344,488.0,581.0,716829,771696,1395837
7666,7666,7666,7666,7666,7666,7666,7666,7667,2021-09-19 15:00:00+00:00,Montgomery,340.0,725692,396.0,670881,26.0,46370,366.0,422.0,717251,772062,1396573
7667,7667,7667,7667,7667,7667,7667,7667,7668,2021-09-20 15:00:00+00:00,Montgomery,496.0,726188,527.0,671408,18.0,46388,514.0,545.0,717796,772576,1397596
7668,7668,7668,7668,7668,7668,7668,7668,7669,2021-09-21 15:00:00+00:00,Montgomery,431.0,726619,521.0,671929,40.0,46428,471.0,561.0,718357,773047,1398548
7669,7669,7669,7669,7669,7669,7669,7669,7670,2021-09-22 15:00:00+00:00,Montgomery,545.0,727164,499.0,672428,14.0,46442,559.0,513.0,718870,773606,1399592
7670,7670,7670,7670,7670,7670,7670,7670,7671,2021-09-23 15:00:00+00:00,Montgomery,531.0,727695,527.0,672955,32.0,46474,563.0,559.0,719429,774169,1400650
7671,7671,7671,7671,7671,7671,7671,7671,7672,2021-09-24 15:00:00+00:00,Montgomery,619.0,728314,603.0,673558,10.0,46484,629.0,613.0,720042,774798,1401872
7672,7672,7672,7672,7672,7672,7672,7672,7673,2021-09-25 15:00:00+00:00,Montgomery,571.0,728885,542.0,674100,8.0,46492,579.0,550.0,720592,775377,1402985
7673,7673,7673,7673,7673,7673,7673,7673,7674,2021-09-26 15:00:00+00:00,Montgomery,364.0,729249,337.0,674437,21.0,46513,385.0,358.0,720950,775762,1403686
7674,7674,7674,7674,7674,7674,7674,7674,7675,2021-09-27 15:00:00+00:00,Montgomery,628.0,729877,347.0,674784,20.0,46533,648.0,367.0,721317,776410,1404661
7675,7675,7675,7675,7675,7675,7675,7675,7676,2021-09-28 15:00:00+00:00,Montgomery,664.0,730541,534.0,675318,27.0,46560,691.0,561.0,721878,777101,1405859
7676,7676,7676,7676,7676,7676,7676,7676,7677,2021-09-29 15:00:00+00:00,Montgomery,653.0,731194,472.0,675790,21.0,46581,674.0,493.0,722371,777775,1406984
7677,7677,7677,7677,7677,7677,7677,7677,7678,2021-09-30 15:00:00+00:00,Montgomery,664.0,731858,458.0,676248,31.0,46612,695.0,489.0,722860,778470,1408106
7678,7678,7678,7678,7678,7678,7678,7678,7679,2021-10-01 15:00:00+00:00,Montgomery,697.0,732555,561.0,676809,25.0,46637,722.0,586.0,723446,779192,1409364
7679,7679,7679,7679,7679,7679,7679,7679,7680,2021-10-02 15:00:00+00:00,Montgomery,496.0,733051,425.0,677234,6.0,46643,502.0,431.0,723877,779694,1410285
7680,7680,7680,7680,7680,7680,7680,7680,7681,2021-10-03 15:00:00+00:00,Montgomery,368.0,733419,287.0,677521,23.0,46666,391.0,310.0,724187,780085,1410940
7681,7681,7681,7681,7681,7681,7681,7681,7682,2021-10-04 15:00:00+00:00,Montgomery,619.0,734038,419.0,677940,15.0,46681,634.0,434.0,724621,780719,1411978
7682,7682,7682,7682,7682,7682,7682,7682,7683,2021-10-05 15:00:00+00:00,Montgomery,565.0,734603,445.0,678385,32.0,46713,597.0,477.0,725098,781316,1412988
7683,7683,7683,7683,7683,7683,7683,7683,7684,2021-10-06 15:00:00+00:00,Montgomery,527.0,735130,397.0,678782,14.0,46727,541.0,411.0,725509,781857,1413912
7684,7684,7684,7684,7684,7684,7684,7684,7685,2021-10-07 15:00:00+00:00,Montgomery,628.0,735758,397.0,679179,30.0,46757,658.0,427.0,725936,782515,1414937
7685,7685,7685,7685,7685,7685,7685,7685,7686,2021-10-08 15:00:00+00:00,Montgomery,643.0,736401,509.0,679688,35.0,46792,678.0,544.0,726480,783193,1416089
7686,7686,7686,7686,7686,7686,7686,7686,7687,2021-10-09 15:00:00+00:00,Montgomery,440.0,736841,363.0,680051,12.0,46804,452.0,375.0,726855,783645,1416892
7687,7687,7687,7687,7687,7687,7687,7687,7688,2021-10-10 15:00:00+00:00,Montgomery,321.0,737162,287.0,680338,5.0,46809,326.0,292.0,727147,783971,1417500
7688,7688,7688,7688,7688,7688,7688,7688,7689,2021-01-27 15:00:00+00:00,Worcester,299.0,5860,88.0,968,,0,,,968,5860,6828
7689,7689,7689,7689,7689,7689,7689,7689,7690,2021-01-28 15:00:00+00:00,Worcester,299.0,6159,55.0,1023,,0,,,1023,6159,7182
7690,7690,7690,7690,7690,7690,7690,7690,7691,2021-01-29 15:00:00+00:00,Worcester,421.0,6580,41.0,1064,,0,,,1064,6580,7644
7691,7691,7691,7691,7691,7691,7691,7691,7692,2021-01-30 15:00:00+00:00,Worcester,178.0,6758,24.0,1088,,0,,,1088,6758,7846
7692,7692,7692,7692,7692,7692,7692,7692,7693,2021-01-31 15:00:00+00:00,Worcester,3.0,6761,3.0,1091,,0,,,1091,6761,7852
7693,7693,7693,7693,7693,7693,7693,7693,7694,2021-02-01 15:00:00+00:00,Worcester,216.0,6977,31.0,1122,,0,,,1122,6977,8099
7694,7694,7694,7694,7694,7694,7694,7694,7695,2021-02-02 15:00:00+00:00,Worcester,245.0,7222,349.0,1471,,0,,,1471,7222,8693
7695,7695,7695,7695,7695,7695,7695,7695,7696,2021-02-03 15:00:00+00:00,Worcester,267.0,7489,81.0,1552,,0,,,1552,7489,9041
7696,7696,7696,7696,7696,7696,7696,7696,7697,2021-02-04 15:00:00+00:00,Worcester,269.0,7758,113.0,1665,,0,,,1665,7758,9423
7697,7697,7697,7697,7697,7697,7697,7697,7698,2021-02-05 15:00:00+00:00,Worcester,155.0,7913,134.0,1799,,0,,,1799,7913,9712
7698,7698,7698,7698,7698,7698,7698,7698,7699,2021-02-06 15:00:00+00:00,Worcester,150.0,8063,49.0,1848,,0,,,1848,8063,9911
7699,7699,7699,7699,7699,7699,7699,7699,7700,2021-02-07 15:00:00+00:00,Worcester,23.0,8086,10.0,1858,,0,,,1858,8086,9944
7700,7700,7700,7700,7700,7700,7700,7700,7701,2021-02-08 15:00:00+00:00,Worcester,152.0,8238,58.0,1916,,0,,,1916,8238,10154
7701,7701,7701,7701,7701,7701,7701,7701,7702,2021-02-09 15:00:00+00:00,Worcester,376.0,8614,236.0,2152,,0,,,2152,8614,10766
7702,7702,7702,7702,7702,7702,7702,7702,7703,2021-02-10 15:00:00+00:00,Worcester,244.0,8858,91.0,2243,,0,,,2243,8858,11101
7703,7703,7703,7703,7703,7703,7703,7703,7704,2021-02-11 15:00:00+00:00,Worcester,335.0,9193,172.0,2415,,0,,,2415,9193,11608
7704,7704,7704,7704,7704,7704,7704,7704,7705,2021-02-12 15:00:00+00:00,Worcester,109.0,9302,98.0,2513,,0,,,2513,9302,11815
7705,7705,7705,7705,7705,7705,7705,7705,7706,2021-02-13 15:00:00+00:00,Worcester,35.0,9337,642.0,3155,,0,,,3155,9337,12492
7706,7706,7706,7706,7706,7706,7706,7706,7707,2021-02-14 15:00:00+00:00,Worcester,41.0,9378,,3155,,0,,,3155,9378,12533
7707,7707,7707,7707,7707,7707,7707,7707,7708,2021-02-15 15:00:00+00:00,Worcester,52.0,9430,94.0,3249,,0,,,3249,9430,12679
7708,7708,7708,7708,7708,7708,7708,7708,7709,2021-02-16 15:00:00+00:00,Worcester,258.0,9688,580.0,3829,,0,,,3829,9688,13517
7709,7709,7709,7709,7709,7709,7709,7709,7710,2021-02-17 15:00:00+00:00,Worcester,178.0,9866,189.0,4018,,0,,,4018,9866,13884
7710,7710,7710,7710,7710,7710,7710,7710,7711,2021-02-18 15:00:00+00:00,Worcester,92.0,9958,439.0,4457,,0,,,4457,9958,14415
7711,7711,7711,7711,7711,7711,7711,7711,7712,2021-02-19 15:00:00+00:00,Worcester,195.0,10153,223.0,4680,,0,,,4680,10153,14833
7712,7712,7712,7712,7712,7712,7712,7712,7713,2021-02-20 15:00:00+00:00,Worcester,65.0,10218,249.0,4929,,0,,,4929,10218,15147
7713,7713,7713,7713,7713,7713,7713,7713,7714,2021-02-21 15:00:00+00:00,Worcester,18.0,10236,6.0,4935,,0,,,4935,10236,15171
7714,7714,7714,7714,7714,7714,7714,7714,7715,2021-02-22 15:00:00+00:00,Worcester,56.0,10292,84.0,5019,,0,,,5019,10292,15311
7715,7715,7715,7715,7715,7715,7715,7715,7716,2021-02-23 15:00:00+00:00,Worcester,30.0,10322,426.0,5445,,0,,,5445,10322,15767
7716,7716,7716,7716,7716,7716,7716,7716,7717,2021-02-24 15:00:00+00:00,Worcester,49.0,10371,329.0,5774,,0,,,5774,10371,16145
7717,7717,7717,7717,7717,7717,7717,7717,7718,2021-02-25 15:00:00+00:00,Worcester,135.0,10506,543.0,6317,,0,,,6317,10506,16823
7718,7718,7718,7718,7718,7718,7718,7718,7719,2021-02-26 15:00:00+00:00,Worcester,199.0,10705,461.0,6778,,0,,,6778,10705,17483
7719,7719,7719,7719,7719,7719,7719,7719,7720,2021-02-27 15:00:00+00:00,Worcester,334.0,11039,149.0,6927,,0,,,6927,11039,17966
7720,7720,7720,7720,7720,7720,7720,7720,7721,2021-02-28 15:00:00+00:00,Worcester,142.0,11181,81.0,7008,,0,,,7008,11181,18189
7721,7721,7721,7721,7721,7721,7721,7721,7722,2021-03-01 15:00:00+00:00,Worcester,190.0,11371,128.0,7136,,0,,,7136,11371,18507
7722,7722,7722,7722,7722,7722,7722,7722,7723,2021-03-02 15:00:00+00:00,Worcester,172.0,11543,372.0,7508,,0,,,7508,11543,19051
7723,7723,7723,7723,7723,7723,7723,7723,7724,2021-03-03 15:00:00+00:00,Worcester,262.0,11805,222.0,7730,,0,,,7730,11805,19535
7724,7724,7724,7724,7724,7724,7724,7724,7725,2021-03-04 15:00:00+00:00,Worcester,418.0,12223,209.0,7939,1.0,1,419.0,210.0,7940,12224,20162
7725,7725,7725,7725,7725,7725,7725,7725,7726,2021-03-05 15:00:00+00:00,Worcester,417.0,12640,165.0,8104,15.0,16,432.0,180.0,8120,12656,20744
7726,7726,7726,7726,7726,7726,7726,7726,7727,2021-03-06 15:00:00+00:00,Worcester,181.0,12821,87.0,8191,19.0,35,200.0,106.0,8226,12856,21012
7727,7727,7727,7727,7727,7727,7727,7727,7728,2021-03-07 15:00:00+00:00,Worcester,79.0,12900,3.0,8194,11.0,46,90.0,14.0,8240,12946,21094
7728,7728,7728,7728,7728,7728,7728,7728,7729,2021-03-08 15:00:00+00:00,Worcester,191.0,13091,105.0,8299,25.0,71,216.0,130.0,8370,13162,21390
7729,7729,7729,7729,7729,7729,7729,7729,7730,2021-03-09 15:00:00+00:00,Worcester,334.0,13425,464.0,8763,73.0,144,407.0,537.0,8907,13569,22188
7730,7730,7730,7730,7730,7730,7730,7730,7731,2021-03-10 15:00:00+00:00,Worcester,238.0,13663,204.0,8967,25.0,169,263.0,229.0,9136,13832,22630
7731,7731,7731,7731,7731,7731,7731,7731,7732,2021-03-11 15:00:00+00:00,Worcester,392.0,14055,230.0,9197,40.0,209,432.0,270.0,9406,14264,23252
7732,7732,7732,7732,7732,7732,7732,7732,7733,2021-03-12 15:00:00+00:00,Worcester,288.0,14343,237.0,9434,82.0,291,370.0,319.0,9725,14634,23777
7733,7733,7733,7733,7733,7733,7733,7733,7734,2021-03-13 15:00:00+00:00,Worcester,193.0,14536,74.0,9508,11.0,302,204.0,85.0,9810,14838,24044
7734,7734,7734,7734,7734,7734,7734,7734,7735,2021-03-14 15:00:00+00:00,Worcester,71.0,14607,49.0,9557,1.0,303,72.0,50.0,9860,14910,24164
7735,7735,7735,7735,7735,7735,7735,7735,7736,2021-03-15 15:00:00+00:00,Worcester,106.0,14713,89.0,9646,1.0,304,107.0,90.0,9950,15017,24359
7736,7736,7736,7736,7736,7736,7736,7736,7737,2021-03-16 15:00:00+00:00,Worcester,343.0,15056,141.0,9787,,304,,,10091,15360,24843
7737,7737,7737,7737,7737,7737,7737,7737,7738,2021-03-17 15:00:00+00:00,Worcester,210.0,15266,95.0,9882,2.0,306,212.0,97.0,10188,15572,25148
7738,7738,7738,7738,7738,7738,7738,7738,7739,2021-03-18 15:00:00+00:00,Worcester,445.0,15711,47.0,9929,6.0,312,451.0,53.0,10241,16023,25640
7739,7739,7739,7739,7739,7739,7739,7739,7740,2021-03-19 15:00:00+00:00,Worcester,323.0,16034,97.0,10026,2.0,314,325.0,99.0,10340,16348,26060
7740,7740,7740,7740,7740,7740,7740,7740,7741,2021-03-20 15:00:00+00:00,Worcester,135.0,16169,8.0,10034,2.0,316,137.0,10.0,10350,16485,26203
7741,7741,7741,7741,7741,7741,7741,7741,7742,2021-03-21 15:00:00+00:00,Worcester,156.0,16325,57.0,10091,,316,,,10407,16641,26416
7742,7742,7742,7742,7742,7742,7742,7742,7743,2021-03-22 15:00:00+00:00,Worcester,283.0,16608,26.0,10117,4.0,320,287.0,30.0,10437,16928,26725
7743,7743,7743,7743,7743,7743,7743,7743,7744,2021-03-23 15:00:00+00:00,Worcester,424.0,17032,58.0,10175,5.0,325,429.0,63.0,10500,17357,27207
7744,7744,7744,7744,7744,7744,7744,7744,7745,2021-10-11 15:00:00+00:00,Montgomery,666.0,737828,369.0,680707,17.0,46826,683.0,386.0,727533,784654,1418535
7745,7745,7745,7745,7745,7745,7745,7745,7746,2021-10-12 15:00:00+00:00,Montgomery,564.0,738392,387.0,681094,28.0,46854,592.0,415.0,727948,785246,1419486
7746,7746,7746,7746,7746,7746,7746,7746,7747,2021-10-13 15:00:00+00:00,Montgomery,566.0,738958,466.0,681560,18.0,46872,584.0,484.0,728432,785830,1420518
7747,7747,7747,7747,7747,7747,7747,7747,7748,2021-10-14 15:00:00+00:00,Montgomery,477.0,739435,398.0,681958,28.0,46900,505.0,426.0,728858,786335,1421393
7748,7748,7748,7748,7748,7748,7748,7748,7749,2021-10-15 15:00:00+00:00,Montgomery,577.0,740012,474.0,682432,33.0,46933,610.0,507.0,729365,786945,1422444
7749,7749,7749,7749,7749,7749,7749,7749,7750,2021-10-16 15:00:00+00:00,Montgomery,354.0,740366,305.0,682737,15.0,46948,369.0,320.0,729685,787314,1423103
7750,7750,7750,7750,7750,7750,7750,7750,7751,2021-10-17 15:00:00+00:00,Montgomery,341.0,740707,228.0,682965,13.0,46961,354.0,241.0,729926,787668,1423672
7751,7751,7751,7751,7751,7751,7751,7751,7752,2021-10-18 15:00:00+00:00,Montgomery,614.0,741321,407.0,683372,30.0,46991,644.0,437.0,730363,788312,1424693
7752,7752,7752,7752,7752,7752,7752,7752,7753,2021-10-19 15:00:00+00:00,Montgomery,482.0,741803,364.0,683736,10.0,47001,492.0,374.0,730737,788804,1425539
7753,7753,7753,7753,7753,7753,7753,7753,7754,2021-10-20 15:00:00+00:00,Montgomery,440.0,742243,384.0,684120,17.0,47018,457.0,401.0,731138,789261,1426363
7754,7754,7754,7754,7754,7754,7754,7754,7755,2021-10-21 15:00:00+00:00,Montgomery,424.0,742667,418.0,684538,16.0,47034,440.0,434.0,731572,789701,1427205
7755,7755,7755,7755,7755,7755,7755,7755,7756,2021-10-22 15:00:00+00:00,Montgomery,611.0,743278,850.0,685388,32.0,47066,643.0,882.0,732454,790344,1428666
7756,7756,7756,7756,7756,7756,7756,7756,7757,2021-10-23 15:00:00+00:00,Montgomery,501.0,743779,711.0,686099,10.0,47076,511.0,721.0,733175,790855,1429878
7757,7757,7757,7757,7757,7757,7757,7757,7758,2021-10-24 15:00:00+00:00,Montgomery,340.0,744119,502.0,686601,15.0,47091,355.0,517.0,733692,791210,1430720
7758,7758,7758,7758,7758,7758,7758,7758,7759,2021-10-25 15:00:00+00:00,Montgomery,651.0,744770,1123.0,687724,29.0,47120,680.0,1152.0,734844,791890,1432494
7759,7759,7759,7759,7759,7759,7759,7759,7760,2021-10-26 15:00:00+00:00,Montgomery,671.0,745441,1145.0,688869,29.0,47149,700.0,1174.0,736018,792590,1434310
7760,7760,7760,7760,7760,7760,7760,7760,7761,2021-10-27 15:00:00+00:00,Montgomery,660.0,746101,949.0,689818,54.0,47203,714.0,1003.0,737021,793304,1435919
7761,7761,7761,7761,7761,7761,7761,7761,7762,2021-10-28 15:00:00+00:00,Montgomery,652.0,746753,1013.0,690831,29.0,47232,681.0,1042.0,738063,793985,1437584
7762,7762,7762,7762,7762,7762,7762,7762,7763,2021-10-29 15:00:00+00:00,Montgomery,702.0,747455,1073.0,691904,32.0,47264,734.0,1105.0,739168,794719,1439359
7763,7763,7763,7763,7763,7763,7763,7763,7764,2021-10-30 15:00:00+00:00,Montgomery,479.0,747934,632.0,692536,19.0,47283,498.0,651.0,739819,795217,1440470
7764,7764,7764,7764,7764,7764,7764,7764,7765,2021-10-31 15:00:00+00:00,Montgomery,336.0,748270,420.0,692956,14.0,47297,350.0,434.0,740253,795567,1441226
7765,7765,7765,7765,7765,7765,7765,7765,7766,2021-11-01 15:00:00+00:00,Montgomery,654.0,748924,886.0,693842,24.0,47321,678.0,910.0,741163,796245,1442766
7766,7766,7766,7766,7766,7766,7766,7766,7767,2021-11-02 15:00:00+00:00,Montgomery,568.0,749492,889.0,694731,21.0,47342,589.0,910.0,742073,796834,1444223
7767,7767,7767,7767,7767,7767,7767,7767,7768,2021-11-03 15:00:00+00:00,Montgomery,578.0,750070,834.0,695565,39.0,47381,617.0,873.0,742946,797451,1445635
7768,7768,7768,7768,7768,7768,7768,7768,7769,2021-11-04 15:00:00+00:00,Montgomery,595.0,750665,772.0,696337,22.0,47403,617.0,794.0,743740,798068,1447002
7769,7769,7769,7769,7769,7769,7769,7769,7770,2021-11-05 15:00:00+00:00,Montgomery,649.0,751314,851.0,697188,21.0,47424,670.0,872.0,744612,798738,1448502
7770,7770,7770,7770,7770,7770,7770,7770,7771,2021-11-06 15:00:00+00:00,Montgomery,207.0,751521,210.0,697398,11.0,47435,218.0,221.0,744833,798956,1448919
7771,7771,7771,7771,7771,7771,7771,7771,7772,2020-12-14 15:00:00+00:00,Prince George's,1.0,1,,0,,0,,,0,1,1
7772,7772,7772,7772,7772,7772,7772,7772,7773,2021-03-24 15:00:00+00:00,Worcester,255.0,17287,125.0,10300,3.0,328,258.0,128.0,10628,17615,27587
7773,7773,7773,7773,7773,7773,7773,7773,7774,2021-03-25 15:00:00+00:00,Worcester,674.0,17961,111.0,10411,89.0,417,763.0,200.0,10828,18378,28372
7774,7774,7774,7774,7774,7774,7774,7774,7775,2021-03-26 15:00:00+00:00,Worcester,435.0,18396,226.0,10637,29.0,446,464.0,255.0,11083,18842,29033
7775,7775,7775,7775,7775,7775,7775,7775,7776,2021-03-27 15:00:00+00:00,Worcester,168.0,18564,308.0,10945,9.0,455,177.0,317.0,11400,19019,29509
7776,7776,7776,7776,7776,7776,7776,7776,7777,2021-03-28 15:00:00+00:00,Worcester,109.0,18673,58.0,11003,,455,,,11458,19128,29676
7777,7777,7777,7777,7777,7777,7777,7777,7778,2021-03-29 15:00:00+00:00,Worcester,306.0,18979,161.0,11164,7.0,462,313.0,168.0,11626,19441,30143
7778,7778,7778,7778,7778,7778,7778,7778,7779,2021-03-30 15:00:00+00:00,Worcester,325.0,19304,231.0,11395,18.0,480,343.0,249.0,11875,19784,30699
7779,7779,7779,7779,7779,7779,7779,7779,7780,2021-03-31 15:00:00+00:00,Worcester,259.0,19563,282.0,11677,28.0,508,287.0,310.0,12185,20071,31240
7780,7780,7780,7780,7780,7780,7780,7780,7781,2021-04-01 15:00:00+00:00,Worcester,404.0,19967,416.0,12093,54.0,562,458.0,470.0,12655,20529,32060
7781,7781,7781,7781,7781,7781,7781,7781,7782,2021-04-02 15:00:00+00:00,Worcester,223.0,20190,377.0,12470,33.0,595,256.0,410.0,13065,20785,32660
7782,7782,7782,7782,7782,7782,7782,7782,7783,2021-04-03 15:00:00+00:00,Worcester,82.0,20272,67.0,12537,2.0,597,84.0,69.0,13134,20869,32809
7783,7783,7783,7783,7783,7783,7783,7783,7784,2021-04-04 15:00:00+00:00,Worcester,23.0,20295,59.0,12596,,597,,,13193,20892,32891
7784,7784,7784,7784,7784,7784,7784,7784,7785,2021-04-05 15:00:00+00:00,Worcester,234.0,20529,172.0,12768,79.0,676,313.0,251.0,13444,21205,33297
7785,7785,7785,7785,7785,7785,7785,7785,7786,2021-04-06 15:00:00+00:00,Worcester,253.0,20782,472.0,13240,176.0,852,429.0,648.0,14092,21634,34022
7786,7786,7786,7786,7786,7786,7786,7786,7787,2021-04-07 15:00:00+00:00,Worcester,116.0,20898,238.0,13478,176.0,1028,292.0,414.0,14506,21926,34376
7787,7787,7787,7787,7787,7787,7787,7787,7788,2021-04-08 15:00:00+00:00,Worcester,270.0,21168,410.0,13888,327.0,1355,597.0,737.0,15243,22523,35056
7788,7788,7788,7788,7788,7788,7788,7788,7789,2021-04-09 15:00:00+00:00,Worcester,160.0,21328,304.0,14192,164.0,1519,324.0,468.0,15711,22847,35520
7789,7789,7789,7789,7789,7789,7789,7789,7790,2021-04-10 15:00:00+00:00,Worcester,32.0,21360,254.0,14446,39.0,1558,71.0,293.0,16004,22918,35806
7790,7790,7790,7790,7790,7790,7790,7790,7791,2021-04-11 15:00:00+00:00,Worcester,21.0,21381,123.0,14569,21.0,1579,42.0,144.0,16148,22960,35950
7791,7791,7791,7791,7791,7791,7791,7791,7792,2021-04-12 15:00:00+00:00,Worcester,148.0,21529,241.0,14810,46.0,1625,194.0,287.0,16435,23154,36339
7792,7792,7792,7792,7792,7792,7792,7792,7793,2021-04-13 15:00:00+00:00,Worcester,246.0,21775,394.0,15204,8.0,1633,254.0,402.0,16837,23408,36979
7793,7793,7793,7793,7793,7793,7793,7793,7794,2021-04-14 15:00:00+00:00,Worcester,270.0,22045,333.0,15537,,1633,,,17170,23678,37582
7794,7794,7794,7794,7794,7794,7794,7794,7795,2021-04-15 15:00:00+00:00,Worcester,247.0,22292,664.0,16201,6.0,1639,253.0,670.0,17840,23931,38493
7795,7795,7795,7795,7795,7795,7795,7795,7796,2021-04-16 15:00:00+00:00,Worcester,168.0,22460,400.0,16601,,1639,,,18240,24099,39061
7796,7796,7796,7796,7796,7796,7796,7796,7797,2021-04-17 15:00:00+00:00,Worcester,48.0,22508,100.0,16701,,1639,,,18340,24147,39209
7797,7797,7797,7797,7797,7797,7797,7797,7798,2021-04-18 15:00:00+00:00,Worcester,58.0,22566,80.0,16781,,1639,,,18420,24205,39347
7798,7798,7798,7798,7798,7798,7798,7798,7799,2021-04-19 15:00:00+00:00,Worcester,193.0,22759,308.0,17089,,1639,,,18728,24398,39848
7799,7799,7799,7799,7799,7799,7799,7799,7800,2021-04-20 15:00:00+00:00,Worcester,181.0,22940,447.0,17536,,1639,,,19175,24579,40476
7800,7800,7800,7800,7800,7800,7800,7800,7801,2020-12-15 15:00:00+00:00,Prince George's,3.0,4,,0,,0,,,0,4,4
7801,7801,7801,7801,7801,7801,7801,7801,7802,2020-12-16 15:00:00+00:00,Prince George's,18.0,22,,0,,0,,,0,22,22
7802,7802,7802,7802,7802,7802,7802,7802,7803,2020-12-17 15:00:00+00:00,Prince George's,21.0,43,,0,,0,,,0,43,43
7803,7803,7803,7803,7803,7803,7803,7803,7804,2020-12-18 15:00:00+00:00,Prince George's,60.0,103,,0,,0,,,0,103,103
7804,7804,7804,7804,7804,7804,7804,7804,7805,2020-12-19 15:00:00+00:00,Prince George's,19.0,122,,0,,0,,,0,122,122
7805,7805,7805,7805,7805,7805,7805,7805,7806,2020-12-20 15:00:00+00:00,Prince George's,14.0,136,,0,,0,,,0,136,136
7806,7806,7806,7806,7806,7806,7806,7806,7807,2020-12-21 15:00:00+00:00,Prince George's,167.0,303,,0,,0,,,0,303,303
7807,7807,7807,7807,7807,7807,7807,7807,7808,2020-12-22 15:00:00+00:00,Prince George's,540.0,843,,0,,0,,,0,843,843
7808,7808,7808,7808,7808,7808,7808,7808,7809,2020-12-23 15:00:00+00:00,Prince George's,280.0,1123,1.0,1,,0,,,1,1123,1124
7809,7809,7809,7809,7809,7809,7809,7809,7810,2020-12-24 15:00:00+00:00,Prince George's,194.0,1317,,1,,0,,,1,1317,1318
7810,7810,7810,7810,7810,7810,7810,7810,7811,2020-12-25 15:00:00+00:00,Prince George's,168.0,1485,1.0,2,,0,,,2,1485,1487
7811,7811,7811,7811,7811,7811,7811,7811,7812,2020-12-26 15:00:00+00:00,Prince George's,333.0,1818,1.0,3,,0,,,3,1818,1821
7812,7812,7812,7812,7812,7812,7812,7812,7813,2020-12-27 15:00:00+00:00,Prince George's,102.0,1920,,3,,0,,,3,1920,1923
7813,7813,7813,7813,7813,7813,7813,7813,7814,2020-12-28 15:00:00+00:00,Prince George's,357.0,2277,2.0,5,,0,,,5,2277,2282
7814,7814,7814,7814,7814,7814,7814,7814,7815,2020-12-29 15:00:00+00:00,Prince George's,585.0,2862,4.0,9,,0,,,9,2862,2871
7815,7815,7815,7815,7815,7815,7815,7815,7816,2020-12-30 15:00:00+00:00,Prince George's,444.0,3306,1.0,10,,0,,,10,3306,3316
7816,7816,7816,7816,7816,7816,7816,7816,7817,2020-12-31 15:00:00+00:00,Prince George's,296.0,3602,1.0,11,,0,,,11,3602,3613
7817,7817,7817,7817,7817,7817,7817,7817,7818,2021-01-01 15:00:00+00:00,Prince George's,126.0,3728,3.0,14,,0,,,14,3728,3742
7818,7818,7818,7818,7818,7818,7818,7818,7819,2021-01-02 15:00:00+00:00,Prince George's,230.0,3958,3.0,17,,0,,,17,3958,3975
7819,7819,7819,7819,7819,7819,7819,7819,7820,2021-01-03 15:00:00+00:00,Prince George's,344.0,4302,,17,,0,,,17,4302,4319
7820,7820,7820,7820,7820,7820,7820,7820,7821,2021-01-04 15:00:00+00:00,Prince George's,749.0,5051,8.0,25,,0,,,25,5051,5076
7821,7821,7821,7821,7821,7821,7821,7821,7822,2021-01-05 15:00:00+00:00,Prince George's,541.0,5592,20.0,45,,0,,,45,5592,5637
7822,7822,7822,7822,7822,7822,7822,7822,7823,2021-01-06 15:00:00+00:00,Prince George's,696.0,6288,21.0,66,,0,,,66,6288,6354
7823,7823,7823,7823,7823,7823,7823,7823,7824,2021-01-07 15:00:00+00:00,Prince George's,643.0,6931,35.0,101,,0,,,101,6931,7032
7824,7824,7824,7824,7824,7824,7824,7824,7825,2021-01-08 15:00:00+00:00,Prince George's,885.0,7816,75.0,176,,0,,,176,7816,7992
7825,7825,7825,7825,7825,7825,7825,7825,7826,2021-01-09 15:00:00+00:00,Prince George's,342.0,8158,23.0,199,,0,,,199,8158,8357
7826,7826,7826,7826,7826,7826,7826,7826,7827,2021-01-10 15:00:00+00:00,Prince George's,474.0,8632,7.0,206,,0,,,206,8632,8838
7827,7827,7827,7827,7827,7827,7827,7827,7828,2021-01-11 15:00:00+00:00,Prince George's,671.0,9303,160.0,366,,0,,,366,9303,9669
7828,7828,7828,7828,7828,7828,7828,7828,7829,2021-04-21 15:00:00+00:00,Worcester,132.0,23072,191.0,17727,,1639,,,19366,24711,40799
7829,7829,7829,7829,7829,7829,7829,7829,7830,2021-04-22 15:00:00+00:00,Worcester,193.0,23265,460.0,18187,,1639,,,19826,24904,41452
7830,7830,7830,7830,7830,7830,7830,7830,7831,2021-04-23 15:00:00+00:00,Worcester,123.0,23388,281.0,18468,,1639,,,20107,25027,41856
7831,7831,7831,7831,7831,7831,7831,7831,7832,2021-04-24 15:00:00+00:00,Worcester,46.0,23434,115.0,18583,,1639,,,20222,25073,42017
7832,7832,7832,7832,7832,7832,7832,7832,7833,2021-04-25 15:00:00+00:00,Worcester,22.0,23456,13.0,18596,,1639,,,20235,25095,42052
7833,7833,7833,7833,7833,7833,7833,7833,7834,2021-04-26 15:00:00+00:00,Worcester,138.0,23594,282.0,18878,4.0,1643,142.0,286.0,20521,25237,42472
7834,7834,7834,7834,7834,7834,7834,7834,7835,2021-04-27 15:00:00+00:00,Worcester,122.0,23716,272.0,19150,27.0,1670,149.0,299.0,20820,25386,42866
7835,7835,7835,7835,7835,7835,7835,7835,7836,2021-04-28 15:00:00+00:00,Worcester,143.0,23859,210.0,19360,6.0,1676,149.0,216.0,21036,25535,43219
7836,7836,7836,7836,7836,7836,7836,7836,7837,2021-04-29 15:00:00+00:00,Worcester,112.0,23971,243.0,19603,21.0,1697,133.0,264.0,21300,25668,43574
7837,7837,7837,7837,7837,7837,7837,7837,7838,2021-04-30 15:00:00+00:00,Worcester,115.0,24086,213.0,19816,14.0,1711,129.0,227.0,21527,25797,43902
7838,7838,7838,7838,7838,7838,7838,7838,7839,2021-05-01 15:00:00+00:00,Worcester,23.0,24109,24.0,19840,4.0,1715,27.0,28.0,21555,25824,43949
7839,7839,7839,7839,7839,7839,7839,7839,7840,2021-05-02 15:00:00+00:00,Worcester,29.0,24138,16.0,19856,10.0,1725,39.0,26.0,21581,25863,43994
7840,7840,7840,7840,7840,7840,7840,7840,7841,2021-05-03 15:00:00+00:00,Worcester,73.0,24211,135.0,19991,17.0,1742,90.0,152.0,21733,25953,44202
7841,7841,7841,7841,7841,7841,7841,7841,7842,2021-05-04 15:00:00+00:00,Worcester,144.0,24355,221.0,20212,30.0,1772,174.0,251.0,21984,26127,44567
7842,7842,7842,7842,7842,7842,7842,7842,7843,2021-05-05 15:00:00+00:00,Worcester,171.0,24526,159.0,20371,7.0,1779,178.0,166.0,22150,26305,44897
7843,7843,7843,7843,7843,7843,7843,7843,7844,2021-05-06 15:00:00+00:00,Worcester,109.0,24635,260.0,20631,30.0,1809,139.0,290.0,22440,26444,45266
7844,7844,7844,7844,7844,7844,7844,7844,7845,2021-05-07 15:00:00+00:00,Worcester,89.0,24724,180.0,20811,30.0,1839,119.0,210.0,22650,26563,45535
7845,7845,7845,7845,7845,7845,7845,7845,7846,2021-05-08 15:00:00+00:00,Worcester,32.0,24756,53.0,20864,16.0,1855,48.0,69.0,22719,26611,45620
7846,7846,7846,7846,7846,7846,7846,7846,7847,2021-05-09 15:00:00+00:00,Worcester,9.0,24765,17.0,20881,4.0,1859,13.0,21.0,22740,26624,45646
7847,7847,7847,7847,7847,7847,7847,7847,7848,2021-05-10 15:00:00+00:00,Worcester,62.0,24827,102.0,20983,12.0,1871,74.0,114.0,22854,26698,45810
7848,7848,7848,7848,7848,7848,7848,7848,7849,2021-05-11 15:00:00+00:00,Worcester,91.0,24918,203.0,21186,27.0,1898,118.0,230.0,23084,26816,46104
7849,7849,7849,7849,7849,7849,7849,7849,7850,2021-05-12 15:00:00+00:00,Worcester,119.0,25037,201.0,21387,10.0,1908,129.0,211.0,23295,26945,46424
7850,7850,7850,7850,7850,7850,7850,7850,7851,2021-05-13 15:00:00+00:00,Worcester,282.0,25319,223.0,21610,15.0,1923,297.0,238.0,23533,27242,46929
7851,7851,7851,7851,7851,7851,7851,7851,7852,2021-05-14 15:00:00+00:00,Worcester,134.0,25453,160.0,21770,12.0,1935,146.0,172.0,23705,27388,47223
7852,7852,7852,7852,7852,7852,7852,7852,7853,2021-05-15 15:00:00+00:00,Worcester,43.0,25496,43.0,21813,2.0,1937,45.0,45.0,23750,27433,47309
7853,7853,7853,7853,7853,7853,7853,7853,7854,2021-05-16 15:00:00+00:00,Worcester,29.0,25525,21.0,21834,6.0,1943,35.0,27.0,23777,27468,47359
7854,7854,7854,7854,7854,7854,7854,7854,7855,2021-05-17 15:00:00+00:00,Worcester,112.0,25637,121.0,21955,20.0,1963,132.0,141.0,23918,27600,47592
7855,7855,7855,7855,7855,7855,7855,7855,7856,2021-05-18 15:00:00+00:00,Worcester,167.0,25804,148.0,22103,16.0,1979,183.0,164.0,24082,27783,47907
7856,7856,7856,7856,7856,7856,7856,7856,7857,2021-01-12 15:00:00+00:00,Prince George's,1096.0,10399,498.0,864,,0,,,864,10399,11263
7857,7857,7857,7857,7857,7857,7857,7857,7858,2021-01-13 15:00:00+00:00,Prince George's,1161.0,11560,206.0,1070,,0,,,1070,11560,12630
7858,7858,7858,7858,7858,7858,7858,7858,7859,2021-01-14 15:00:00+00:00,Prince George's,1007.0,12567,165.0,1235,,0,,,1235,12567,13802
7859,7859,7859,7859,7859,7859,7859,7859,7860,2021-01-15 15:00:00+00:00,Prince George's,1483.0,14050,223.0,1458,,0,,,1458,14050,15508
7860,7860,7860,7860,7860,7860,7860,7860,7861,2021-01-16 15:00:00+00:00,Prince George's,555.0,14605,263.0,1721,,0,,,1721,14605,16326
7861,7861,7861,7861,7861,7861,7861,7861,7862,2021-01-17 15:00:00+00:00,Prince George's,193.0,14798,47.0,1768,,0,,,1768,14798,16566
7862,7862,7862,7862,7862,7862,7862,7862,7863,2021-01-18 15:00:00+00:00,Prince George's,560.0,15358,271.0,2039,,0,,,2039,15358,17397
7863,7863,7863,7863,7863,7863,7863,7863,7864,2021-01-19 15:00:00+00:00,Prince George's,910.0,16268,380.0,2419,,0,,,2419,16268,18687
7864,7864,7864,7864,7864,7864,7864,7864,7865,2021-01-20 15:00:00+00:00,Prince George's,898.0,17166,287.0,2706,,0,,,2706,17166,19872
7865,7865,7865,7865,7865,7865,7865,7865,7866,2021-01-21 15:00:00+00:00,Prince George's,1458.0,18624,168.0,2874,,0,,,2874,18624,21498
7866,7866,7866,7866,7866,7866,7866,7866,7867,2021-01-22 15:00:00+00:00,Prince George's,1864.0,20488,233.0,3107,,0,,,3107,20488,23595
7867,7867,7867,7867,7867,7867,7867,7867,7868,2021-01-23 15:00:00+00:00,Prince George's,725.0,21213,148.0,3255,,0,,,3255,21213,24468
7868,7868,7868,7868,7868,7868,7868,7868,7869,2021-01-24 15:00:00+00:00,Prince George's,314.0,21527,186.0,3441,,0,,,3441,21527,24968
7869,7869,7869,7869,7869,7869,7869,7869,7870,2021-01-25 15:00:00+00:00,Prince George's,1133.0,22660,412.0,3853,,0,,,3853,22660,26513
7870,7870,7870,7870,7870,7870,7870,7870,7871,2021-01-26 15:00:00+00:00,Prince George's,1846.0,24506,248.0,4101,,0,,,4101,24506,28607
7871,7871,7871,7871,7871,7871,7871,7871,7872,2021-01-27 15:00:00+00:00,Prince George's,2171.0,26677,496.0,4597,,0,,,4597,26677,31274
7872,7872,7872,7872,7872,7872,7872,7872,7873,2021-01-28 15:00:00+00:00,Prince George's,2123.0,28800,365.0,4962,,0,,,4962,28800,33762
7873,7873,7873,7873,7873,7873,7873,7873,7874,2021-01-29 15:00:00+00:00,Prince George's,1744.0,30544,277.0,5239,,0,,,5239,30544,35783
7874,7874,7874,7874,7874,7874,7874,7874,7875,2021-01-30 15:00:00+00:00,Prince George's,1316.0,31860,77.0,5316,,0,,,5316,31860,37176
7875,7875,7875,7875,7875,7875,7875,7875,7876,2021-01-31 15:00:00+00:00,Prince George's,658.0,32518,177.0,5493,,0,,,5493,32518,38011
7876,7876,7876,7876,7876,7876,7876,7876,7877,2021-02-01 15:00:00+00:00,Prince George's,565.0,33083,364.0,5857,,0,,,5857,33083,38940
7877,7877,7877,7877,7877,7877,7877,7877,7878,2021-02-02 15:00:00+00:00,Prince George's,1269.0,34352,860.0,6717,,0,,,6717,34352,41069
7878,7878,7878,7878,7878,7878,7878,7878,7879,2021-02-03 15:00:00+00:00,Prince George's,1814.0,36166,780.0,7497,,0,,,7497,36166,43663
7879,7879,7879,7879,7879,7879,7879,7879,7880,2021-02-04 15:00:00+00:00,Prince George's,1879.0,38045,691.0,8188,,0,,,8188,38045,46233
7880,7880,7880,7880,7880,7880,7880,7880,7881,2021-02-05 15:00:00+00:00,Prince George's,1576.0,39621,1487.0,9675,,0,,,9675,39621,49296
7881,7881,7881,7881,7881,7881,7881,7881,7882,2021-02-06 15:00:00+00:00,Prince George's,1059.0,40680,590.0,10265,,0,,,10265,40680,50945
7882,7882,7882,7882,7882,7882,7882,7882,7883,2021-02-07 15:00:00+00:00,Prince George's,819.0,41499,216.0,10481,,0,,,10481,41499,51980
7883,7883,7883,7883,7883,7883,7883,7883,7884,2021-02-08 15:00:00+00:00,Prince George's,1495.0,42994,951.0,11432,,0,,,11432,42994,54426
7884,7884,7884,7884,7884,7884,7884,7884,7885,2021-05-19 15:00:00+00:00,Worcester,166.0,25970,114.0,22217,10.0,1989,176.0,124.0,24206,27959,48187
7885,7885,7885,7885,7885,7885,7885,7885,7886,2021-05-20 15:00:00+00:00,Worcester,128.0,26098,170.0,22387,14.0,2003,142.0,184.0,24390,28101,48485
7886,7886,7886,7886,7886,7886,7886,7886,7887,2021-05-21 15:00:00+00:00,Worcester,142.0,26240,134.0,22521,3.0,2006,145.0,137.0,24527,28246,48761
7887,7887,7887,7887,7887,7887,7887,7887,7888,2021-05-22 15:00:00+00:00,Worcester,50.0,26290,34.0,22555,12.0,2018,62.0,46.0,24573,28308,48845
7888,7888,7888,7888,7888,7888,7888,7888,7889,2021-05-23 15:00:00+00:00,Worcester,21.0,26311,20.0,22575,4.0,2022,25.0,24.0,24597,28333,48886
7889,7889,7889,7889,7889,7889,7889,7889,7890,2021-05-24 15:00:00+00:00,Worcester,80.0,26391,99.0,22674,5.0,2027,85.0,104.0,24701,28418,49065
7890,7890,7890,7890,7890,7890,7890,7890,7891,2021-05-25 15:00:00+00:00,Worcester,76.0,26467,133.0,22807,11.0,2038,87.0,144.0,24845,28505,49274
7891,7891,7891,7891,7891,7891,7891,7891,7892,2021-05-26 15:00:00+00:00,Worcester,68.0,26535,182.0,22989,17.0,2055,85.0,199.0,25044,28590,49524
7892,7892,7892,7892,7892,7892,7892,7892,7893,2021-05-27 15:00:00+00:00,Worcester,77.0,26612,143.0,23132,8.0,2063,85.0,151.0,25195,28675,49744
7893,7893,7893,7893,7893,7893,7893,7893,7894,2021-05-28 15:00:00+00:00,Worcester,46.0,26658,89.0,23221,18.0,2081,64.0,107.0,25302,28739,49879
7894,7894,7894,7894,7894,7894,7894,7894,7895,2021-05-29 15:00:00+00:00,Worcester,31.0,26689,23.0,23244,6.0,2087,37.0,29.0,25331,28776,49933
7895,7895,7895,7895,7895,7895,7895,7895,7896,2021-05-30 15:00:00+00:00,Worcester,18.0,26707,16.0,23260,4.0,2091,22.0,20.0,25351,28798,49967
7896,7896,7896,7896,7896,7896,7896,7896,7897,2021-05-31 15:00:00+00:00,Worcester,30.0,26737,41.0,23301,4.0,2095,34.0,45.0,25396,28832,50038
7897,7897,7897,7897,7897,7897,7897,7897,7898,2021-06-01 15:00:00+00:00,Worcester,60.0,26797,115.0,23416,15.0,2110,75.0,130.0,25526,28907,50213
7898,7898,7898,7898,7898,7898,7898,7898,7899,2021-06-02 15:00:00+00:00,Worcester,65.0,26862,151.0,23567,15.0,2125,80.0,166.0,25692,28987,50429
7899,7899,7899,7899,7899,7899,7899,7899,7900,2021-06-03 15:00:00+00:00,Worcester,60.0,26922,262.0,23829,18.0,2143,78.0,280.0,25972,29065,50751
7900,7900,7900,7900,7900,7900,7900,7900,7901,2021-06-04 15:00:00+00:00,Worcester,25.0,26947,127.0,23956,14.0,2157,39.0,141.0,26113,29104,50903
7901,7901,7901,7901,7901,7901,7901,7901,7902,2021-06-05 15:00:00+00:00,Worcester,11.0,26958,38.0,23994,18.0,2175,29.0,56.0,26169,29133,50952
7902,7902,7902,7902,7902,7902,7902,7902,7903,2021-06-06 15:00:00+00:00,Worcester,13.0,26971,16.0,24010,10.0,2185,23.0,26.0,26195,29156,50981
7903,7903,7903,7903,7903,7903,7903,7903,7904,2021-06-07 15:00:00+00:00,Worcester,53.0,27024,95.0,24105,11.0,2196,64.0,106.0,26301,29220,51129
7904,7904,7904,7904,7904,7904,7904,7904,7905,2021-06-08 15:00:00+00:00,Worcester,77.0,27101,181.0,24286,7.0,2203,84.0,188.0,26489,29304,51387
7905,7905,7905,7905,7905,7905,7905,7905,7906,2021-06-09 15:00:00+00:00,Worcester,49.0,27150,109.0,24395,16.0,2219,65.0,125.0,26614,29369,51545
7906,7906,7906,7906,7906,7906,7906,7906,7907,2021-06-10 15:00:00+00:00,Worcester,41.0,27191,128.0,24523,6.0,2225,47.0,134.0,26748,29416,51714
7907,7907,7907,7907,7907,7907,7907,7907,7908,2021-06-11 15:00:00+00:00,Worcester,36.0,27227,155.0,24678,8.0,2233,44.0,163.0,26911,29460,51905
7908,7908,7908,7908,7908,7908,7908,7908,7909,2021-06-12 15:00:00+00:00,Worcester,12.0,27239,45.0,24723,,2233,,,26956,29472,51962
7909,7909,7909,7909,7909,7909,7909,7909,7910,2021-06-13 15:00:00+00:00,Worcester,4.0,27243,16.0,24739,,2233,,,26972,29476,51982
7910,7910,7910,7910,7910,7910,7910,7910,7911,2021-06-14 15:00:00+00:00,Worcester,41.0,27284,115.0,24854,5.0,2238,46.0,120.0,27092,29522,52138
7911,7911,7911,7911,7911,7911,7911,7911,7912,2021-06-15 15:00:00+00:00,Worcester,45.0,27329,118.0,24972,6.0,2244,51.0,124.0,27216,29573,52301
7912,7912,7912,7912,7912,7912,7912,7912,7913,2021-02-09 15:00:00+00:00,Prince George's,1426.0,44420,1027.0,12459,,0,,,12459,44420,56879
7913,7913,7913,7913,7913,7913,7913,7913,7914,2021-02-10 15:00:00+00:00,Prince George's,1872.0,46292,1200.0,13659,,0,,,13659,46292,59951
7914,7914,7914,7914,7914,7914,7914,7914,7915,2021-02-11 15:00:00+00:00,Prince George's,2126.0,48418,1405.0,15064,,0,,,15064,48418,63482
7915,7915,7915,7915,7915,7915,7915,7915,7916,2021-02-12 15:00:00+00:00,Prince George's,2170.0,50588,1697.0,16761,,0,,,16761,50588,67349
7916,7916,7916,7916,7916,7916,7916,7916,7917,2021-02-13 15:00:00+00:00,Prince George's,1177.0,51765,231.0,16992,,0,,,16992,51765,68757
7917,7917,7917,7917,7917,7917,7917,7917,7918,2021-02-14 15:00:00+00:00,Prince George's,1429.0,53194,206.0,17198,,0,,,17198,53194,70392
7918,7918,7918,7918,7918,7918,7918,7918,7919,2021-02-15 15:00:00+00:00,Prince George's,1492.0,54686,551.0,17749,,0,,,17749,54686,72435
7919,7919,7919,7919,7919,7919,7919,7919,7920,2021-02-16 15:00:00+00:00,Prince George's,2309.0,56995,1460.0,19209,,0,,,19209,56995,76204
7920,7920,7920,7920,7920,7920,7920,7920,7921,2021-02-17 15:00:00+00:00,Prince George's,1959.0,58954,2006.0,21215,,0,,,21215,58954,80169
7921,7921,7921,7921,7921,7921,7921,7921,7922,2021-02-18 15:00:00+00:00,Prince George's,359.0,59313,204.0,21419,,0,,,21419,59313,80732
7922,7922,7922,7922,7922,7922,7922,7922,7923,2021-02-19 15:00:00+00:00,Prince George's,713.0,60026,1712.0,23131,,0,,,23131,60026,83157
7923,7923,7923,7923,7923,7923,7923,7923,7924,2021-02-20 15:00:00+00:00,Prince George's,1272.0,61298,1595.0,24726,,0,,,24726,61298,86024
7924,7924,7924,7924,7924,7924,7924,7924,7925,2021-02-21 15:00:00+00:00,Prince George's,757.0,62055,683.0,25409,,0,,,25409,62055,87464
7925,7925,7925,7925,7925,7925,7925,7925,7926,2021-02-22 15:00:00+00:00,Prince George's,832.0,62887,1379.0,26788,,0,,,26788,62887,89675
7926,7926,7926,7926,7926,7926,7926,7926,7927,2021-02-23 15:00:00+00:00,Prince George's,1520.0,64407,1543.0,28331,,0,,,28331,64407,92738
7927,7927,7927,7927,7927,7927,7927,7927,7928,2021-02-24 15:00:00+00:00,Prince George's,1318.0,65725,1740.0,30071,,0,,,30071,65725,95796
7928,7928,7928,7928,7928,7928,7928,7928,7929,2021-02-25 15:00:00+00:00,Prince George's,2365.0,68090,1714.0,31785,,0,,,31785,68090,99875
7929,7929,7929,7929,7929,7929,7929,7929,7930,2021-02-26 15:00:00+00:00,Prince George's,2527.0,70617,1737.0,33522,,0,,,33522,70617,104139
7930,7930,7930,7930,7930,7930,7930,7930,7931,2021-02-27 15:00:00+00:00,Prince George's,2016.0,72633,973.0,34495,,0,,,34495,72633,107128
7931,7931,7931,7931,7931,7931,7931,7931,7932,2021-02-28 15:00:00+00:00,Prince George's,3514.0,76147,700.0,35195,,0,,,35195,76147,111342
7932,7932,7932,7932,7932,7932,7932,7932,7933,2021-03-01 15:00:00+00:00,Prince George's,3631.0,79778,1198.0,36393,,0,,,36393,79778,116171
7933,7933,7933,7933,7933,7933,7933,7933,7934,2021-03-02 15:00:00+00:00,Prince George's,2681.0,82459,1447.0,37840,3.0,3,2684.0,1450.0,37843,82462,120299
7934,7934,7934,7934,7934,7934,7934,7934,7935,2021-03-03 15:00:00+00:00,Prince George's,2956.0,85415,2063.0,39903,6.0,9,2962.0,2069.0,39912,85424,125318
7935,7935,7935,7935,7935,7935,7935,7935,7936,2021-03-04 15:00:00+00:00,Prince George's,3547.0,88962,1701.0,41604,218.0,227,3765.0,1919.0,41831,89189,130566
7936,7936,7936,7936,7936,7936,7936,7936,7937,2021-03-05 15:00:00+00:00,Prince George's,3273.0,92235,1946.0,43550,901.0,1128,4174.0,2847.0,44678,93363,135785
7937,7937,7937,7937,7937,7937,7937,7937,7938,2021-03-06 15:00:00+00:00,Prince George's,2513.0,94748,1189.0,44739,578.0,1706,3091.0,1767.0,46445,96454,139487
7938,7938,7938,7938,7938,7938,7938,7938,7939,2021-03-07 15:00:00+00:00,Prince George's,1360.0,96108,703.0,45442,625.0,2331,1985.0,1328.0,47773,98439,141550
7939,7939,7939,7939,7939,7939,7939,7939,7940,2021-03-08 15:00:00+00:00,Prince George's,2970.0,99078,950.0,46392,1900.0,4231,4870.0,2850.0,50623,103309,145470
7940,7940,7940,7940,7940,7940,7940,7940,7941,2021-06-16 15:00:00+00:00,Worcester,36.0,27365,116.0,25088,14.0,2258,50.0,130.0,27346,29623,52453
7941,7941,7941,7941,7941,7941,7941,7941,7942,2021-06-17 15:00:00+00:00,Worcester,50.0,27415,74.0,25162,2.0,2260,52.0,76.0,27422,29675,52577
7942,7942,7942,7942,7942,7942,7942,7942,7943,2021-06-18 15:00:00+00:00,Worcester,37.0,27452,50.0,25212,2.0,2262,39.0,52.0,27474,29714,52664
7943,7943,7943,7943,7943,7943,7943,7943,7944,2021-06-19 15:00:00+00:00,Worcester,23.0,27475,34.0,25246,2.0,2264,25.0,36.0,27510,29739,52721
7944,7944,7944,7944,7944,7944,7944,7944,7945,2021-06-20 15:00:00+00:00,Worcester,7.0,27482,18.0,25264,1.0,2265,8.0,19.0,27529,29747,52746
7945,7945,7945,7945,7945,7945,7945,7945,7946,2021-06-21 15:00:00+00:00,Worcester,58.0,27540,62.0,25326,1.0,2266,59.0,63.0,27592,29806,52866
7946,7946,7946,7946,7946,7946,7946,7946,7947,2021-06-22 15:00:00+00:00,Worcester,17.0,27557,72.0,25398,1.0,2267,18.0,73.0,27665,29824,52955
7947,7947,7947,7947,7947,7947,7947,7947,7948,2021-06-23 15:00:00+00:00,Worcester,38.0,27595,48.0,25446,7.0,2274,45.0,55.0,27720,29869,53041
7948,7948,7948,7948,7948,7948,7948,7948,7949,2021-06-24 15:00:00+00:00,Worcester,34.0,27629,61.0,25507,2.0,2276,36.0,63.0,27783,29905,53136
7949,7949,7949,7949,7949,7949,7949,7949,7950,2021-06-25 15:00:00+00:00,Worcester,32.0,27661,35.0,25542,3.0,2279,35.0,38.0,27821,29940,53203
7950,7950,7950,7950,7950,7950,7950,7950,7951,2021-06-26 15:00:00+00:00,Worcester,17.0,27678,14.0,25556,,2279,,,27835,29957,53234
7951,7951,7951,7951,7951,7951,7951,7951,7952,2021-06-27 15:00:00+00:00,Worcester,15.0,27693,15.0,25571,1.0,2280,16.0,16.0,27851,29973,53264
7952,7952,7952,7952,7952,7952,7952,7952,7953,2021-06-28 15:00:00+00:00,Worcester,48.0,27741,53.0,25624,4.0,2284,52.0,57.0,27908,30025,53365
7953,7953,7953,7953,7953,7953,7953,7953,7954,2021-06-29 15:00:00+00:00,Worcester,48.0,27789,63.0,25687,3.0,2287,51.0,66.0,27974,30076,53476
7954,7954,7954,7954,7954,7954,7954,7954,7955,2021-06-30 15:00:00+00:00,Worcester,50.0,27839,60.0,25747,1.0,2288,51.0,61.0,28035,30127,53586
7955,7955,7955,7955,7955,7955,7955,7955,7956,2021-07-01 15:00:00+00:00,Worcester,35.0,27874,40.0,25787,3.0,2291,38.0,43.0,28078,30165,53661
7956,7956,7956,7956,7956,7956,7956,7956,7957,2021-07-02 15:00:00+00:00,Worcester,29.0,27903,19.0,25806,1.0,2292,30.0,20.0,28098,30195,53709
7957,7957,7957,7957,7957,7957,7957,7957,7958,2021-07-03 15:00:00+00:00,Worcester,5.0,27908,7.0,25813,,2292,,,28105,30200,53721
7958,7958,7958,7958,7958,7958,7958,7958,7959,2021-07-04 15:00:00+00:00,Worcester,,27908,,25813,3.0,2295,,,28108,30203,53721
7959,7959,7959,7959,7959,7959,7959,7959,7960,2021-07-05 15:00:00+00:00,Worcester,28.0,27936,41.0,25854,2.0,2297,30.0,43.0,28151,30233,53790
7960,7960,7960,7960,7960,7960,7960,7960,7961,2021-07-06 15:00:00+00:00,Worcester,28.0,27964,56.0,25910,4.0,2301,32.0,60.0,28211,30265,53874
7961,7961,7961,7961,7961,7961,7961,7961,7962,2021-07-07 15:00:00+00:00,Worcester,32.0,27996,37.0,25947,2.0,2303,34.0,39.0,28250,30299,53943
7962,7962,7962,7962,7962,7962,7962,7962,7963,2021-07-08 15:00:00+00:00,Worcester,36.0,28032,42.0,25989,11.0,2314,47.0,53.0,28303,30346,54021
7963,7963,7963,7963,7963,7963,7963,7963,7964,2021-07-09 15:00:00+00:00,Worcester,41.0,28073,35.0,26024,2.0,2316,43.0,37.0,28340,30389,54097
7964,7964,7964,7964,7964,7964,7964,7964,7965,2021-07-10 15:00:00+00:00,Worcester,19.0,28092,21.0,26045,1.0,2317,20.0,22.0,28362,30409,54137
7965,7965,7965,7965,7965,7965,7965,7965,7966,2021-07-11 15:00:00+00:00,Worcester,14.0,28106,9.0,26054,2.0,2319,16.0,11.0,28373,30425,54160
7966,7966,7966,7966,7966,7966,7966,7966,7967,2021-07-12 15:00:00+00:00,Worcester,46.0,28152,42.0,26096,4.0,2323,50.0,46.0,28419,30475,54248
7967,7967,7967,7967,7967,7967,7967,7967,7968,2021-07-13 15:00:00+00:00,Worcester,40.0,28192,28.0,26124,3.0,2326,43.0,31.0,28450,30518,54316
7968,7968,7968,7968,7968,7968,7968,7968,7969,2021-03-09 15:00:00+00:00,Prince George's,3186.0,102264,1633.0,48025,1103.0,5334,4289.0,2736.0,53359,107598,150289
7969,7969,7969,7969,7969,7969,7969,7969,7970,2021-03-10 15:00:00+00:00,Prince George's,3550.0,105814,1458.0,49483,1178.0,6512,4728.0,2636.0,55995,112326,155297
7970,7970,7970,7970,7970,7970,7970,7970,7971,2021-03-11 15:00:00+00:00,Prince George's,4478.0,110292,1347.0,50830,1484.0,7996,5962.0,2831.0,58826,118288,161122
7971,7971,7971,7971,7971,7971,7971,7971,7972,2021-03-12 15:00:00+00:00,Prince George's,4678.0,114970,1295.0,52125,744.0,8740,5422.0,2039.0,60865,123710,167095
7972,7972,7972,7972,7972,7972,7972,7972,7973,2021-03-13 15:00:00+00:00,Prince George's,2755.0,117725,831.0,52956,271.0,9011,3026.0,1102.0,61967,126736,170681
7973,7973,7973,7973,7973,7973,7973,7973,7974,2021-03-14 15:00:00+00:00,Prince George's,2511.0,120236,705.0,53661,236.0,9247,2747.0,941.0,62908,129483,173897
7974,7974,7974,7974,7974,7974,7974,7974,7975,2021-03-15 15:00:00+00:00,Prince George's,4507.0,124743,1390.0,55051,59.0,9306,4566.0,1449.0,64357,134049,179794
7975,7975,7975,7975,7975,7975,7975,7975,7976,2021-03-16 15:00:00+00:00,Prince George's,4809.0,129552,1260.0,56311,73.0,9379,4882.0,1333.0,65690,138931,185863
7976,7976,7976,7976,7976,7976,7976,7976,7977,2021-03-17 15:00:00+00:00,Prince George's,5026.0,134578,1565.0,57876,71.0,9450,5097.0,1636.0,67326,144028,192454
7977,7977,7977,7977,7977,7977,7977,7977,7978,2021-03-18 15:00:00+00:00,Prince George's,6143.0,140721,841.0,58717,148.0,9598,6291.0,989.0,68315,150319,199438
7978,7978,7978,7978,7978,7978,7978,7978,7979,2021-03-19 15:00:00+00:00,Prince George's,5347.0,146068,1943.0,60660,159.0,9757,5506.0,2102.0,70417,155825,206728
7979,7979,7979,7979,7979,7979,7979,7979,7980,2021-03-20 15:00:00+00:00,Prince George's,3989.0,150057,933.0,61593,159.0,9916,4148.0,1092.0,71509,159973,211650
7980,7980,7980,7980,7980,7980,7980,7980,7981,2021-03-21 15:00:00+00:00,Prince George's,2690.0,152747,831.0,62424,20.0,9936,2710.0,851.0,72360,162683,215171
7981,7981,7981,7981,7981,7981,7981,7981,7982,2021-03-22 15:00:00+00:00,Prince George's,5122.0,157869,1554.0,63978,130.0,10066,5252.0,1684.0,74044,167935,221847
7982,7982,7982,7982,7982,7982,7982,7982,7983,2021-03-23 15:00:00+00:00,Prince George's,5143.0,163012,1602.0,65580,271.0,10337,5414.0,1873.0,75917,173349,228592
7983,7983,7983,7983,7983,7983,7983,7983,7984,2021-03-24 15:00:00+00:00,Prince George's,4366.0,167378,1915.0,67495,149.0,10486,4515.0,2064.0,77981,177864,234873
7984,7984,7984,7984,7984,7984,7984,7984,7985,2021-03-25 15:00:00+00:00,Prince George's,5625.0,173003,2330.0,69825,218.0,10704,5843.0,2548.0,80529,183707,242828
7985,7985,7985,7985,7985,7985,7985,7985,7986,2021-03-26 15:00:00+00:00,Prince George's,4648.0,177651,3037.0,72862,293.0,10997,4941.0,3330.0,83859,188648,250513
7986,7986,7986,7986,7986,7986,7986,7986,7987,2021-03-27 15:00:00+00:00,Prince George's,3365.0,181016,2866.0,75728,231.0,11228,3596.0,3097.0,86956,192244,256744
7987,7987,7987,7987,7987,7987,7987,7987,7988,2021-03-28 15:00:00+00:00,Prince George's,2139.0,183155,1894.0,77622,61.0,11289,2200.0,1955.0,88911,194444,260777
7988,7988,7988,7988,7988,7988,7988,7988,7989,2021-03-29 15:00:00+00:00,Prince George's,5283.0,188438,4025.0,81647,124.0,11413,5407.0,4149.0,93060,199851,270085
7989,7989,7989,7989,7989,7989,7989,7989,7990,2021-03-30 15:00:00+00:00,Prince George's,5116.0,193554,3428.0,85075,144.0,11557,5260.0,3572.0,96632,205111,278629
7990,7990,7990,7990,7990,7990,7990,7990,7991,2021-03-31 15:00:00+00:00,Prince George's,4911.0,198465,3838.0,88913,313.0,11870,5224.0,4151.0,100783,210335,287378
7991,7991,7991,7991,7991,7991,7991,7991,7992,2021-04-01 15:00:00+00:00,Prince George's,3912.0,202377,4074.0,92987,356.0,12226,4268.0,4430.0,105213,214603,295364
7992,7992,7992,7992,7992,7992,7992,7992,7993,2021-04-02 15:00:00+00:00,Prince George's,4488.0,206865,4529.0,97516,557.0,12783,5045.0,5086.0,110299,219648,304381
7993,7993,7993,7993,7993,7993,7993,7993,7994,2021-04-03 15:00:00+00:00,Prince George's,2311.0,209176,2726.0,100242,379.0,13162,2690.0,3105.0,113404,222338,309418
7994,7994,7994,7994,7994,7994,7994,7994,7995,2021-04-04 15:00:00+00:00,Prince George's,1011.0,210187,1483.0,101725,78.0,13240,1089.0,1561.0,114965,223427,311912
7995,7995,7995,7995,7995,7995,7995,7995,7996,2021-04-05 15:00:00+00:00,Prince George's,4009.0,214196,4694.0,106419,416.0,13656,4425.0,5110.0,120075,227852,320615
7996,7996,7996,7996,7996,7996,7996,7996,7997,2021-07-14 15:00:00+00:00,Worcester,39.0,28231,30.0,26154,5.0,2331,44.0,35.0,28485,30562,54385
7997,7997,7997,7997,7997,7997,7997,7997,7998,2021-07-15 15:00:00+00:00,Worcester,40.0,28271,47.0,26201,3.0,2334,43.0,50.0,28535,30605,54472
7998,7998,7998,7998,7998,7998,7998,7998,7999,2021-07-16 15:00:00+00:00,Worcester,28.0,28299,32.0,26233,4.0,2338,32.0,36.0,28571,30637,54532
7999,7999,7999,7999,7999,7999,7999,7999,8000,2021-07-17 15:00:00+00:00,Worcester,8.0,28307,14.0,26247,,2338,,,28585,30645,54554
8000,8000,8000,8000,8000,8000,8000,8000,8001,2021-07-18 15:00:00+00:00,Worcester,13.0,28320,5.0,26252,,2338,,,28590,30658,54572
8001,8001,8001,8001,8001,8001,8001,8001,8002,2021-07-19 15:00:00+00:00,Worcester,50.0,28370,46.0,26298,2.0,2340,52.0,48.0,28638,30710,54668
8002,8002,8002,8002,8002,8002,8002,8002,8003,2021-07-20 15:00:00+00:00,Worcester,44.0,28414,32.0,26330,1.0,2341,45.0,33.0,28671,30755,54744
8003,8003,8003,8003,8003,8003,8003,8003,8004,2021-07-21 15:00:00+00:00,Worcester,50.0,28464,36.0,26366,2.0,2343,52.0,38.0,28709,30807,54830
8004,8004,8004,8004,8004,8004,8004,8004,8005,2021-07-22 15:00:00+00:00,Worcester,35.0,28499,36.0,26402,5.0,2348,40.0,41.0,28750,30847,54901
8005,8005,8005,8005,8005,8005,8005,8005,8006,2021-07-23 15:00:00+00:00,Worcester,48.0,28547,28.0,26430,8.0,2356,56.0,36.0,28786,30903,54977
8006,8006,8006,8006,8006,8006,8006,8006,8007,2021-07-24 15:00:00+00:00,Worcester,16.0,28563,9.0,26439,3.0,2359,19.0,12.0,28798,30922,55002
8007,8007,8007,8007,8007,8007,8007,8007,8008,2021-07-25 15:00:00+00:00,Worcester,13.0,28576,4.0,26443,2.0,2361,15.0,6.0,28804,30937,55019
8008,8008,8008,8008,8008,8008,8008,8008,8009,2021-07-26 15:00:00+00:00,Worcester,76.0,28652,36.0,26479,2.0,2363,78.0,38.0,28842,31015,55131
8009,8009,8009,8009,8009,8009,8009,8009,8010,2021-07-27 15:00:00+00:00,Worcester,55.0,28707,39.0,26518,5.0,2368,60.0,44.0,28886,31075,55225
8010,8010,8010,8010,8010,8010,8010,8010,8011,2021-07-28 15:00:00+00:00,Worcester,53.0,28760,40.0,26558,7.0,2375,60.0,47.0,28933,31135,55318
8011,8011,8011,8011,8011,8011,8011,8011,8012,2021-07-29 15:00:00+00:00,Worcester,63.0,28823,42.0,26600,5.0,2380,68.0,47.0,28980,31203,55423
8012,8012,8012,8012,8012,8012,8012,8012,8013,2021-07-30 15:00:00+00:00,Worcester,61.0,28884,36.0,26636,5.0,2385,66.0,41.0,29021,31269,55520
8013,8013,8013,8013,8013,8013,8013,8013,8014,2021-07-31 15:00:00+00:00,Worcester,14.0,28898,7.0,26643,,2385,,,29028,31283,55541
8014,8014,8014,8014,8014,8014,8014,8014,8015,2021-08-01 15:00:00+00:00,Worcester,28.0,28926,10.0,26653,,2385,,,29038,31311,55579
8015,8015,8015,8015,8015,8015,8015,8015,8016,2021-08-02 15:00:00+00:00,Worcester,106.0,29032,30.0,26683,11.0,2396,117.0,41.0,29079,31428,55715
8016,8016,8016,8016,8016,8016,8016,8016,8017,2021-08-03 15:00:00+00:00,Worcester,83.0,29115,29.0,26712,12.0,2408,95.0,41.0,29120,31523,55827
8017,8017,8017,8017,8017,8017,8017,8017,8018,2021-08-04 15:00:00+00:00,Worcester,71.0,29186,28.0,26740,9.0,2417,80.0,37.0,29157,31603,55926
8018,8018,8018,8018,8018,8018,8018,8018,8019,2021-08-05 15:00:00+00:00,Worcester,93.0,29279,41.0,26781,9.0,2426,102.0,50.0,29207,31705,56060
8019,8019,8019,8019,8019,8019,8019,8019,8020,2021-08-06 15:00:00+00:00,Worcester,72.0,29351,28.0,26809,7.0,2433,79.0,35.0,29242,31784,56160
8020,8020,8020,8020,8020,8020,8020,8020,8021,2021-08-07 15:00:00+00:00,Worcester,26.0,29377,11.0,26820,2.0,2435,28.0,13.0,29255,31812,56197
8021,8021,8021,8021,8021,8021,8021,8021,8022,2021-08-08 15:00:00+00:00,Worcester,34.0,29411,15.0,26835,,2435,,,29270,31846,56246
8022,8022,8022,8022,8022,8022,8022,8022,8023,2021-08-09 15:00:00+00:00,Worcester,86.0,29497,45.0,26880,11.0,2446,97.0,56.0,29326,31943,56377
8023,8023,8023,8023,8023,8023,8023,8023,8024,2021-08-10 15:00:00+00:00,Worcester,71.0,29568,40.0,26920,6.0,2452,77.0,46.0,29372,32020,56488
8024,8024,8024,8024,8024,8024,8024,8024,8025,2021-04-06 15:00:00+00:00,Prince George's,5028.0,219224,4395.0,110814,463.0,14119,5491.0,4858.0,124933,233343,330038
8025,8025,8025,8025,8025,8025,8025,8025,8026,2021-04-07 15:00:00+00:00,Prince George's,6281.0,225505,4565.0,115379,837.0,14956,7118.0,5402.0,130335,240461,340884
8026,8026,8026,8026,8026,8026,8026,8026,8027,2021-04-08 15:00:00+00:00,Prince George's,5610.0,231115,4925.0,120304,967.0,15923,6577.0,5892.0,136227,247038,351419
8027,8027,8027,8027,8027,8027,8027,8027,8028,2021-04-09 15:00:00+00:00,Prince George's,5947.0,237062,4517.0,124821,722.0,16645,6669.0,5239.0,141466,253707,361883
8028,8028,8028,8028,8028,8028,8028,8028,8029,2021-04-10 15:00:00+00:00,Prince George's,3366.0,240428,3318.0,128139,758.0,17403,4124.0,4076.0,145542,257831,368567
8029,8029,8029,8029,8029,8029,8029,8029,8030,2021-04-11 15:00:00+00:00,Prince George's,3362.0,243790,2234.0,130373,420.0,17823,3782.0,2654.0,148196,261613,374163
8030,8030,8030,8030,8030,8030,8030,8030,8031,2021-04-12 15:00:00+00:00,Prince George's,5519.0,249309,5147.0,135520,629.0,18452,6148.0,5776.0,153972,267761,384829
8031,8031,8031,8031,8031,8031,8031,8031,8032,2021-04-13 15:00:00+00:00,Prince George's,5440.0,254749,5415.0,140935,16.0,18468,5456.0,5431.0,159403,273217,395684
8032,8032,8032,8032,8032,8032,8032,8032,8033,2021-04-14 15:00:00+00:00,Prince George's,5898.0,260647,4900.0,145835,84.0,18552,5982.0,4984.0,164387,279199,406482
8033,8033,8033,8033,8033,8033,8033,8033,8034,2021-04-15 15:00:00+00:00,Prince George's,5663.0,266310,6063.0,151898,68.0,18620,5731.0,6131.0,170518,284930,418208
8034,8034,8034,8034,8034,8034,8034,8034,8035,2021-04-16 15:00:00+00:00,Prince George's,5843.0,272153,5590.0,157488,1.0,18621,5844.0,5591.0,176109,290774,429641
8035,8035,8035,8035,8035,8035,8035,8035,8036,2021-04-17 15:00:00+00:00,Prince George's,5036.0,277189,2865.0,160353,2.0,18623,5038.0,2867.0,178976,295812,437542
8036,8036,8036,8036,8036,8036,8036,8036,8037,2021-04-18 15:00:00+00:00,Prince George's,4756.0,281945,2064.0,162417,,18623,,,181040,300568,444362
8037,8037,8037,8037,8037,8037,8037,8037,8038,2021-04-19 15:00:00+00:00,Prince George's,4552.0,286497,5118.0,167535,3.0,18626,4555.0,5121.0,186161,305123,454032
8038,8038,8038,8038,8038,8038,8038,8038,8039,2021-04-20 15:00:00+00:00,Prince George's,3532.0,290029,5390.0,172925,,18626,,,191551,308655,462954
8039,8039,8039,8039,8039,8039,8039,8039,8040,2021-04-21 15:00:00+00:00,Prince George's,4295.0,294324,5352.0,178277,1.0,18627,4296.0,5353.0,196904,312951,472601
8040,8040,8040,8040,8040,8040,8040,8040,8041,2021-04-22 15:00:00+00:00,Prince George's,4026.0,298350,4036.0,182313,,18627,,,200940,316977,480663
8041,8041,8041,8041,8041,8041,8041,8041,8042,2021-04-23 15:00:00+00:00,Prince George's,4441.0,302791,4835.0,187148,1.0,18628,4442.0,4836.0,205776,321419,489939
8042,8042,8042,8042,8042,8042,8042,8042,8043,2021-04-24 15:00:00+00:00,Prince George's,4255.0,307046,2793.0,189941,15.0,18643,4270.0,2808.0,208584,325689,496987
8043,8043,8043,8043,8043,8043,8043,8043,8044,2021-04-25 15:00:00+00:00,Prince George's,3408.0,310454,1282.0,191223,,18643,,,209866,329097,501677
8044,8044,8044,8044,8044,8044,8044,8044,8045,2021-04-26 15:00:00+00:00,Prince George's,4337.0,314791,4866.0,196089,31.0,18674,4368.0,4897.0,214763,333465,510880
8045,8045,8045,8045,8045,8045,8045,8045,8046,2021-04-27 15:00:00+00:00,Prince George's,4183.0,318974,4032.0,200121,117.0,18791,4300.0,4149.0,218912,337765,519095
8046,8046,8046,8046,8046,8046,8046,8046,8047,2021-04-28 15:00:00+00:00,Prince George's,3639.0,322613,6803.0,206924,153.0,18944,3792.0,6956.0,225868,341557,529537
8047,8047,8047,8047,8047,8047,8047,8047,8048,2021-04-29 15:00:00+00:00,Prince George's,3750.0,326363,5029.0,211953,181.0,19125,3931.0,5210.0,231078,345488,538316
8048,8048,8048,8048,8048,8048,8048,8048,8049,2021-04-30 15:00:00+00:00,Prince George's,4013.0,330376,5844.0,217797,193.0,19318,4206.0,6037.0,237115,349694,548173
8049,8049,8049,8049,8049,8049,8049,8049,8050,2021-05-01 15:00:00+00:00,Prince George's,3201.0,333577,3664.0,221461,160.0,19478,3361.0,3824.0,240939,353055,555038
8050,8050,8050,8050,8050,8050,8050,8050,8051,2021-05-02 15:00:00+00:00,Prince George's,1685.0,335262,2953.0,224414,150.0,19628,1835.0,3103.0,244042,354890,559676
8051,8051,8051,8051,8051,8051,8051,8051,8052,2021-05-03 15:00:00+00:00,Prince George's,2178.0,337440,5199.0,229613,201.0,19829,2379.0,5400.0,249442,357269,567053
8052,8052,8052,8052,8052,8052,8052,8052,8053,2021-08-11 15:00:00+00:00,Worcester,55.0,29623,36.0,26956,9.0,2461,64.0,45.0,29417,32084,56579
8053,8053,8053,8053,8053,8053,8053,8053,8054,2021-08-12 15:00:00+00:00,Worcester,58.0,29681,41.0,26997,6.0,2467,64.0,47.0,29464,32148,56678
8054,8054,8054,8054,8054,8054,8054,8054,8055,2021-08-13 15:00:00+00:00,Worcester,47.0,29728,26.0,27023,7.0,2474,54.0,33.0,29497,32202,56751
8055,8055,8055,8055,8055,8055,8055,8055,8056,2021-08-14 15:00:00+00:00,Worcester,30.0,29758,6.0,27029,1.0,2475,31.0,7.0,29504,32233,56787
8056,8056,8056,8056,8056,8056,8056,8056,8057,2021-08-15 15:00:00+00:00,Worcester,49.0,29807,7.0,27036,,2475,,,29511,32282,56843
8057,8057,8057,8057,8057,8057,8057,8057,8058,2021-08-16 15:00:00+00:00,Worcester,65.0,29872,29.0,27065,3.0,2478,68.0,32.0,29543,32350,56937
8058,8058,8058,8058,8058,8058,8058,8058,8059,2021-08-17 15:00:00+00:00,Worcester,61.0,29933,47.0,27112,6.0,2484,67.0,53.0,29596,32417,57045
8059,8059,8059,8059,8059,8059,8059,8059,8060,2021-08-18 15:00:00+00:00,Worcester,53.0,29986,42.0,27154,10.0,2494,63.0,52.0,29648,32480,57140
8060,8060,8060,8060,8060,8060,8060,8060,8061,2021-08-19 15:00:00+00:00,Worcester,63.0,30049,42.0,27196,14.0,2508,77.0,56.0,29704,32557,57245
8061,8061,8061,8061,8061,8061,8061,8061,8062,2021-08-20 15:00:00+00:00,Worcester,69.0,30118,54.0,27250,3.0,2511,72.0,57.0,29761,32629,57368
8062,8062,8062,8062,8062,8062,8062,8062,8063,2021-08-21 15:00:00+00:00,Worcester,31.0,30149,14.0,27264,2.0,2513,33.0,16.0,29777,32662,57413
8063,8063,8063,8063,8063,8063,8063,8063,8064,2021-08-22 15:00:00+00:00,Worcester,33.0,30182,20.0,27284,,2513,,,29797,32695,57466
8064,8064,8064,8064,8064,8064,8064,8064,8065,2021-08-23 15:00:00+00:00,Worcester,73.0,30255,107.0,27391,8.0,2521,81.0,115.0,29912,32776,57646
8065,8065,8065,8065,8065,8065,8065,8065,8066,2021-08-24 15:00:00+00:00,Worcester,64.0,30319,60.0,27451,2.0,2523,66.0,62.0,29974,32842,57770
8066,8066,8066,8066,8066,8066,8066,8066,8067,2021-08-25 15:00:00+00:00,Worcester,53.0,30372,65.0,27516,10.0,2533,63.0,75.0,30049,32905,57888
8067,8067,8067,8067,8067,8067,8067,8067,8068,2021-08-26 15:00:00+00:00,Worcester,54.0,30426,76.0,27592,1.0,2534,55.0,77.0,30126,32960,58018
8068,8068,8068,8068,8068,8068,8068,8068,8069,2021-08-27 15:00:00+00:00,Worcester,40.0,30466,47.0,27639,6.0,2540,46.0,53.0,30179,33006,58105
8069,8069,8069,8069,8069,8069,8069,8069,8070,2021-08-28 15:00:00+00:00,Worcester,31.0,30497,26.0,27665,4.0,2544,35.0,30.0,30209,33041,58162
8070,8070,8070,8070,8070,8070,8070,8070,8071,2021-08-29 15:00:00+00:00,Worcester,36.0,30533,26.0,27691,,2544,,,30235,33077,58224
8071,8071,8071,8071,8071,8071,8071,8071,8072,2021-08-30 15:00:00+00:00,Worcester,41.0,30574,60.0,27751,5.0,2549,46.0,65.0,30300,33123,58325
8072,8072,8072,8072,8072,8072,8072,8072,8073,2021-08-31 15:00:00+00:00,Worcester,38.0,30612,71.0,27822,2.0,2551,40.0,73.0,30373,33163,58434
8073,8073,8073,8073,8073,8073,8073,8073,8074,2021-09-01 15:00:00+00:00,Worcester,64.0,30676,54.0,27876,5.0,2556,69.0,59.0,30432,33232,58552
8074,8074,8074,8074,8074,8074,8074,8074,8075,2021-09-02 15:00:00+00:00,Worcester,50.0,30726,66.0,27942,7.0,2563,57.0,73.0,30505,33289,58668
8075,8075,8075,8075,8075,8075,8075,8075,8076,2021-09-03 15:00:00+00:00,Worcester,36.0,30762,43.0,27985,,2563,,,30548,33325,58747
8076,8076,8076,8076,8076,8076,8076,8076,8077,2021-09-04 15:00:00+00:00,Worcester,14.0,30776,20.0,28005,,2563,,,30568,33339,58781
8077,8077,8077,8077,8077,8077,8077,8077,8078,2021-09-05 15:00:00+00:00,Worcester,12.0,30788,38.0,28043,,2563,,,30606,33351,58831
8078,8078,8078,8078,8078,8078,8078,8078,8079,2021-09-06 15:00:00+00:00,Worcester,15.0,30803,30.0,28073,1.0,2564,16.0,31.0,30637,33367,58876
8079,8079,8079,8079,8079,8079,8079,8079,8080,2021-09-07 15:00:00+00:00,Worcester,32.0,30835,66.0,28139,5.0,2569,37.0,71.0,30708,33404,58974
8080,8080,8080,8080,8080,8080,8080,8080,8081,2021-05-04 15:00:00+00:00,Prince George's,2441.0,339881,5335.0,234948,166.0,19995,2607.0,5501.0,254943,359876,574829
8081,8081,8081,8081,8081,8081,8081,8081,8082,2021-05-05 15:00:00+00:00,Prince George's,3072.0,342953,5602.0,240550,247.0,20242,3319.0,5849.0,260792,363195,583503
8082,8082,8082,8082,8082,8082,8082,8082,8083,2021-05-06 15:00:00+00:00,Prince George's,2461.0,345414,6027.0,246577,175.0,20417,2636.0,6202.0,266994,365831,591991
8083,8083,8083,8083,8083,8083,8083,8083,8084,2021-05-07 15:00:00+00:00,Prince George's,3161.0,348575,5825.0,252402,242.0,20659,3403.0,6067.0,273061,369234,600977
8084,8084,8084,8084,8084,8084,8084,8084,8085,2021-05-08 15:00:00+00:00,Prince George's,1845.0,350420,4622.0,257024,165.0,20824,2010.0,4787.0,277848,371244,607444
8085,8085,8085,8085,8085,8085,8085,8085,8086,2021-05-09 15:00:00+00:00,Prince George's,912.0,351332,2716.0,259740,93.0,20917,1005.0,2809.0,280657,372249,611072
8086,8086,8086,8086,8086,8086,8086,8086,8087,2021-05-10 15:00:00+00:00,Prince George's,1511.0,352843,4868.0,264608,169.0,21086,1680.0,5037.0,285694,373929,617451
8087,8087,8087,8087,8087,8087,8087,8087,8088,2021-05-11 15:00:00+00:00,Prince George's,2270.0,355113,3513.0,268121,163.0,21249,2433.0,3676.0,289370,376362,623234
8088,8088,8088,8088,8088,8088,8088,8088,8089,2021-05-12 15:00:00+00:00,Prince George's,2044.0,357157,4077.0,272198,336.0,21585,2380.0,4413.0,293783,378742,629355
8089,8089,8089,8089,8089,8089,8089,8089,8090,2021-05-13 15:00:00+00:00,Prince George's,2441.0,359598,3727.0,275925,166.0,21751,2607.0,3893.0,297676,381349,635523
8090,8090,8090,8090,8090,8090,8090,8090,8091,2021-05-14 15:00:00+00:00,Prince George's,2936.0,362534,4120.0,280045,206.0,21957,3142.0,4326.0,302002,384491,642579
8091,8091,8091,8091,8091,8091,8091,8091,8092,2021-05-15 15:00:00+00:00,Prince George's,2941.0,365475,3728.0,283773,348.0,22305,3289.0,4076.0,306078,387780,649248
8092,8092,8092,8092,8092,8092,8092,8092,8093,2021-05-16 15:00:00+00:00,Prince George's,1107.0,366582,3400.0,287173,206.0,22511,1313.0,3606.0,309684,389093,653755
8093,8093,8093,8093,8093,8093,8093,8093,8094,2021-05-17 15:00:00+00:00,Prince George's,1924.0,368506,4094.0,291267,293.0,22804,2217.0,4387.0,314071,391310,659773
8094,8094,8094,8094,8094,8094,8094,8094,8095,2021-05-18 15:00:00+00:00,Prince George's,3074.0,371580,4246.0,295513,240.0,23044,3314.0,4486.0,318557,394624,667093
8095,8095,8095,8095,8095,8095,8095,8095,8096,2021-05-19 15:00:00+00:00,Prince George's,3650.0,375230,3874.0,299387,240.0,23284,3890.0,4114.0,322671,398514,674617
8096,8096,8096,8096,8096,8096,8096,8096,8097,2021-05-20 15:00:00+00:00,Prince George's,2425.0,377655,3662.0,303049,259.0,23543,2684.0,3921.0,326592,401198,680704
8097,8097,8097,8097,8097,8097,8097,8097,8098,2021-05-21 15:00:00+00:00,Prince George's,2668.0,380323,3922.0,306971,250.0,23793,2918.0,4172.0,330764,404116,687294
8098,8098,8098,8098,8098,8098,8098,8098,8099,2021-05-22 15:00:00+00:00,Prince George's,2930.0,383253,2676.0,309647,290.0,24083,3220.0,2966.0,333730,407336,692900
8099,8099,8099,8099,8099,8099,8099,8099,8100,2021-05-23 15:00:00+00:00,Prince George's,1354.0,384607,1954.0,311601,175.0,24258,1529.0,2129.0,335859,408865,696208
8100,8100,8100,8100,8100,8100,8100,8100,8101,2021-05-24 15:00:00+00:00,Prince George's,2096.0,386703,2885.0,314486,190.0,24448,2286.0,3075.0,338934,411151,701189
8101,8101,8101,8101,8101,8101,8101,8101,8102,2021-05-25 15:00:00+00:00,Prince George's,2178.0,388881,2985.0,317471,184.0,24632,2362.0,3169.0,342103,413513,706352
8102,8102,8102,8102,8102,8102,8102,8102,8103,2021-05-26 15:00:00+00:00,Prince George's,2191.0,391072,2985.0,320456,180.0,24812,2371.0,3165.0,345268,415884,711528
8103,8103,8103,8103,8103,8103,8103,8103,8104,2021-05-27 15:00:00+00:00,Prince George's,1551.0,392623,2531.0,322987,124.0,24936,1675.0,2655.0,347923,417559,715610
8104,8104,8104,8104,8104,8104,8104,8104,8105,2021-05-28 15:00:00+00:00,Prince George's,2169.0,394792,2896.0,325883,171.0,25107,2340.0,3067.0,350990,419899,720675
8105,8105,8105,8105,8105,8105,8105,8105,8106,2021-05-29 15:00:00+00:00,Prince George's,1942.0,396734,1797.0,327680,223.0,25330,2165.0,2020.0,353010,422064,724414
8106,8106,8106,8106,8106,8106,8106,8106,8107,2021-05-30 15:00:00+00:00,Prince George's,900.0,397634,922.0,328602,166.0,25496,1066.0,1088.0,354098,423130,726236
8107,8107,8107,8107,8107,8107,8107,8107,8108,2021-05-31 15:00:00+00:00,Prince George's,239.0,397873,528.0,329130,81.0,25577,320.0,609.0,354707,423450,727003
8108,8108,8108,8108,8108,8108,8108,8108,8109,2021-09-08 15:00:00+00:00,Worcester,43.0,30878,44.0,28183,,2569,,,30752,33447,59061
8109,8109,8109,8109,8109,8109,8109,8109,8110,2021-09-09 15:00:00+00:00,Worcester,45.0,30923,55.0,28238,6.0,2575,51.0,61.0,30813,33498,59161
8110,8110,8110,8110,8110,8110,8110,8110,8111,2021-09-10 15:00:00+00:00,Worcester,29.0,30952,33.0,28271,4.0,2579,33.0,37.0,30850,33531,59223
8111,8111,8111,8111,8111,8111,8111,8111,8112,2021-09-11 15:00:00+00:00,Worcester,23.0,30975,29.0,28300,1.0,2580,24.0,30.0,30880,33555,59275
8112,8112,8112,8112,8112,8112,8112,8112,8113,2021-09-12 15:00:00+00:00,Worcester,20.0,30995,41.0,28341,1.0,2581,21.0,42.0,30922,33576,59336
8113,8113,8113,8113,8113,8113,8113,8113,8114,2021-09-13 15:00:00+00:00,Worcester,47.0,31042,53.0,28394,20.0,2601,67.0,73.0,30995,33643,59436
8114,8114,8114,8114,8114,8114,8114,8114,8115,2021-09-14 15:00:00+00:00,Worcester,26.0,31068,53.0,28447,4.0,2605,30.0,57.0,31052,33673,59515
8115,8115,8115,8115,8115,8115,8115,8115,8116,2021-09-15 15:00:00+00:00,Worcester,28.0,31096,39.0,28486,2.0,2607,30.0,41.0,31093,33703,59582
8116,8116,8116,8116,8116,8116,8116,8116,8117,2021-09-16 15:00:00+00:00,Worcester,41.0,31137,62.0,28548,5.0,2612,46.0,67.0,31160,33749,59685
8117,8117,8117,8117,8117,8117,8117,8117,8118,2021-09-17 15:00:00+00:00,Worcester,32.0,31169,51.0,28599,7.0,2619,39.0,58.0,31218,33788,59768
8118,8118,8118,8118,8118,8118,8118,8118,8119,2021-09-18 15:00:00+00:00,Worcester,27.0,31196,33.0,28632,1.0,2620,28.0,34.0,31252,33816,59828
8119,8119,8119,8119,8119,8119,8119,8119,8120,2021-09-19 15:00:00+00:00,Worcester,15.0,31211,31.0,28663,,2620,,,31283,33831,59874
8120,8120,8120,8120,8120,8120,8120,8120,8121,2021-09-20 15:00:00+00:00,Worcester,28.0,31239,44.0,28707,7.0,2627,35.0,51.0,31334,33866,59946
8121,8121,8121,8121,8121,8121,8121,8121,8122,2021-09-21 15:00:00+00:00,Worcester,22.0,31261,38.0,28745,2.0,2629,24.0,40.0,31374,33890,60006
8122,8122,8122,8122,8122,8122,8122,8122,8123,2021-09-22 15:00:00+00:00,Worcester,33.0,31294,51.0,28796,3.0,2632,36.0,54.0,31428,33926,60090
8123,8123,8123,8123,8123,8123,8123,8123,8124,2021-09-23 15:00:00+00:00,Worcester,34.0,31328,63.0,28859,3.0,2635,37.0,66.0,31494,33963,60187
8124,8124,8124,8124,8124,8124,8124,8124,8125,2021-09-24 15:00:00+00:00,Worcester,37.0,31365,27.0,28886,2.0,2637,39.0,29.0,31523,34002,60251
8125,8125,8125,8125,8125,8125,8125,8125,8126,2021-09-25 15:00:00+00:00,Worcester,33.0,31398,32.0,28918,1.0,2638,34.0,33.0,31556,34036,60316
8126,8126,8126,8126,8126,8126,8126,8126,8127,2021-09-26 15:00:00+00:00,Worcester,20.0,31418,10.0,28928,,2638,,,31566,34056,60346
8127,8127,8127,8127,8127,8127,8127,8127,8128,2021-09-27 15:00:00+00:00,Worcester,37.0,31455,23.0,28951,1.0,2639,38.0,24.0,31590,34094,60406
8128,8128,8128,8128,8128,8128,8128,8128,8129,2021-09-28 15:00:00+00:00,Worcester,31.0,31486,31.0,28982,2.0,2641,33.0,33.0,31623,34127,60468
8129,8129,8129,8129,8129,8129,8129,8129,8130,2021-09-29 15:00:00+00:00,Worcester,42.0,31528,37.0,29019,5.0,2646,47.0,42.0,31665,34174,60547
8130,8130,8130,8130,8130,8130,8130,8130,8131,2021-09-30 15:00:00+00:00,Worcester,32.0,31560,34.0,29053,7.0,2653,39.0,41.0,31706,34213,60613
8131,8131,8131,8131,8131,8131,8131,8131,8132,2021-10-01 15:00:00+00:00,Worcester,41.0,31601,42.0,29095,2.0,2655,43.0,44.0,31750,34256,60696
8132,8132,8132,8132,8132,8132,8132,8132,8133,2021-10-02 15:00:00+00:00,Worcester,15.0,31616,12.0,29107,,2655,,,31762,34271,60723
8133,8133,8133,8133,8133,8133,8133,8133,8134,2021-10-03 15:00:00+00:00,Worcester,8.0,31624,20.0,29127,,2655,,,31782,34279,60751
8134,8134,8134,8134,8134,8134,8134,8134,8135,2021-10-04 15:00:00+00:00,Worcester,33.0,31657,27.0,29154,5.0,2660,38.0,32.0,31814,34317,60811
8135,8135,8135,8135,8135,8135,8135,8135,8136,2021-10-05 15:00:00+00:00,Worcester,24.0,31681,28.0,29182,1.0,2661,25.0,29.0,31843,34342,60863
8136,8136,8136,8136,8136,8136,8136,8136,8137,2021-06-01 15:00:00+00:00,Prince George's,1763.0,399636,3087.0,332217,155.0,25732,1918.0,3242.0,357949,425368,731853
8137,8137,8137,8137,8137,8137,8137,8137,8138,2021-06-02 15:00:00+00:00,Prince George's,1662.0,401298,2081.0,334298,85.0,25817,1747.0,2166.0,360115,427115,735596
8138,8138,8138,8138,8138,8138,8138,8138,8139,2021-06-03 15:00:00+00:00,Prince George's,1318.0,402616,2441.0,336739,83.0,25900,1401.0,2524.0,362639,428516,739355
8139,8139,8139,8139,8139,8139,8139,8139,8140,2021-06-04 15:00:00+00:00,Prince George's,1437.0,404053,2929.0,339668,74.0,25974,1511.0,3003.0,365642,430027,743721
8140,8140,8140,8140,8140,8140,8140,8140,8141,2021-06-05 15:00:00+00:00,Prince George's,1309.0,405362,2492.0,342160,68.0,26042,1377.0,2560.0,368202,431404,747522
8141,8141,8141,8141,8141,8141,8141,8141,8142,2021-06-06 15:00:00+00:00,Prince George's,694.0,406056,863.0,343023,60.0,26102,754.0,923.0,369125,432158,749079
8142,8142,8142,8142,8142,8142,8142,8142,8143,2021-06-07 15:00:00+00:00,Prince George's,1470.0,407526,1560.0,344583,65.0,26167,1535.0,1625.0,370750,433693,752109
8143,8143,8143,8143,8143,8143,8143,8143,8144,2021-06-08 15:00:00+00:00,Prince George's,1195.0,408721,2608.0,347191,110.0,26277,1305.0,2718.0,373468,434998,755912
8144,8144,8144,8144,8144,8144,8144,8144,8145,2021-06-09 15:00:00+00:00,Prince George's,1477.0,410198,3263.0,350454,100.0,26377,1577.0,3363.0,376831,436575,760652
8145,8145,8145,8145,8145,8145,8145,8145,8146,2021-06-10 15:00:00+00:00,Prince George's,1265.0,411463,2040.0,352494,67.0,26444,1332.0,2107.0,378938,437907,763957
8146,8146,8146,8146,8146,8146,8146,8146,8147,2021-06-11 15:00:00+00:00,Prince George's,1682.0,413145,2541.0,355035,145.0,26589,1827.0,2686.0,381624,439734,768180
8147,8147,8147,8147,8147,8147,8147,8147,8148,2021-06-12 15:00:00+00:00,Prince George's,1239.0,414384,2794.0,357829,67.0,26656,1306.0,2861.0,384485,441040,772213
8148,8148,8148,8148,8148,8148,8148,8148,8149,2021-06-13 15:00:00+00:00,Prince George's,378.0,414762,1220.0,359049,46.0,26702,424.0,1266.0,385751,441464,773811
8149,8149,8149,8149,8149,8149,8149,8149,8150,2021-06-14 15:00:00+00:00,Prince George's,1057.0,415819,1677.0,360726,61.0,26763,1118.0,1738.0,387489,442582,776545
8150,8150,8150,8150,8150,8150,8150,8150,8151,2021-06-15 15:00:00+00:00,Prince George's,1024.0,416843,2613.0,363339,78.0,26841,1102.0,2691.0,390180,443684,780182
8151,8151,8151,8151,8151,8151,8151,8151,8152,2021-06-16 15:00:00+00:00,Prince George's,1130.0,417973,2086.0,365425,59.0,26900,1189.0,2145.0,392325,444873,783398
8152,8152,8152,8152,8152,8152,8152,8152,8153,2021-06-17 15:00:00+00:00,Prince George's,1395.0,419368,1632.0,367057,78.0,26978,1473.0,1710.0,394035,446346,786425
8153,8153,8153,8153,8153,8153,8153,8153,8154,2021-06-18 15:00:00+00:00,Prince George's,1249.0,420617,1936.0,368993,61.0,27039,1310.0,1997.0,396032,447656,789610
8154,8154,8154,8154,8154,8154,8154,8154,8155,2021-06-19 15:00:00+00:00,Prince George's,862.0,421479,1712.0,370705,60.0,27099,922.0,1772.0,397804,448578,792184
8155,8155,8155,8155,8155,8155,8155,8155,8156,2021-06-20 15:00:00+00:00,Prince George's,510.0,421989,891.0,371596,78.0,27177,588.0,969.0,398773,449166,793585
8156,8156,8156,8156,8156,8156,8156,8156,8157,2021-06-21 15:00:00+00:00,Prince George's,1084.0,423073,847.0,372443,46.0,27223,1130.0,893.0,399666,450296,795516
8157,8157,8157,8157,8157,8157,8157,8157,8158,2021-06-22 15:00:00+00:00,Prince George's,934.0,424007,1595.0,374038,109.0,27332,1043.0,1704.0,401370,451339,798045
8158,8158,8158,8158,8158,8158,8158,8158,8159,2021-06-23 15:00:00+00:00,Prince George's,1104.0,425111,1497.0,375535,64.0,27396,1168.0,1561.0,402931,452507,800646
8159,8159,8159,8159,8159,8159,8159,8159,8160,2021-06-24 15:00:00+00:00,Prince George's,1007.0,426118,1200.0,376735,94.0,27490,1101.0,1294.0,404225,453608,802853
8160,8160,8160,8160,8160,8160,8160,8160,8161,2021-06-25 15:00:00+00:00,Prince George's,1070.0,427188,1504.0,378239,44.0,27534,1114.0,1548.0,405773,454722,805427
8161,8161,8161,8161,8161,8161,8161,8161,8162,2021-06-26 15:00:00+00:00,Prince George's,766.0,427954,1173.0,379412,66.0,27600,832.0,1239.0,407012,455554,807366
8162,8162,8162,8162,8162,8162,8162,8162,8163,2021-06-27 15:00:00+00:00,Prince George's,591.0,428545,723.0,380135,23.0,27623,614.0,746.0,407758,456168,808680
8163,8163,8163,8163,8163,8163,8163,8163,8164,2021-06-28 15:00:00+00:00,Prince George's,776.0,429321,1170.0,381305,41.0,27664,817.0,1211.0,408969,456985,810626
8164,8164,8164,8164,8164,8164,8164,8164,8165,2021-10-06 15:00:00+00:00,Worcester,35.0,31716,37.0,29219,2.0,2663,37.0,39.0,31882,34379,60935
8165,8165,8165,8165,8165,8165,8165,8165,8166,2021-10-07 15:00:00+00:00,Worcester,37.0,31753,35.0,29254,3.0,2666,40.0,38.0,31920,34419,61007
8166,8166,8166,8166,8166,8166,8166,8166,8167,2021-10-08 15:00:00+00:00,Worcester,26.0,31779,35.0,29289,,2666,,,31955,34445,61068
8167,8167,8167,8167,8167,8167,8167,8167,8168,2021-10-09 15:00:00+00:00,Worcester,13.0,31792,18.0,29307,,2666,,,31973,34458,61099
8168,8168,8168,8168,8168,8168,8168,8168,8169,2021-10-10 15:00:00+00:00,Worcester,9.0,31801,12.0,29319,,2666,,,31985,34467,61120
8169,8169,8169,8169,8169,8169,8169,8169,8170,2021-10-11 15:00:00+00:00,Worcester,13.0,31814,30.0,29349,3.0,2669,16.0,33.0,32018,34483,61163
8170,8170,8170,8170,8170,8170,8170,8170,8171,2021-10-12 15:00:00+00:00,Worcester,29.0,31843,20.0,29369,4.0,2673,33.0,24.0,32042,34516,61212
8171,8171,8171,8171,8171,8171,8171,8171,8172,2021-10-13 15:00:00+00:00,Worcester,17.0,31860,22.0,29391,,2673,,,32064,34533,61251
8172,8172,8172,8172,8172,8172,8172,8172,8173,2021-10-14 15:00:00+00:00,Worcester,24.0,31884,25.0,29416,7.0,2680,31.0,32.0,32096,34564,61300
8173,8173,8173,8173,8173,8173,8173,8173,8174,2021-10-15 15:00:00+00:00,Worcester,29.0,31913,31.0,29447,,2680,,,32127,34593,61360
8174,8174,8174,8174,8174,8174,8174,8174,8175,2021-10-16 15:00:00+00:00,Worcester,4.0,31917,16.0,29463,,2680,,,32143,34597,61380
8175,8175,8175,8175,8175,8175,8175,8175,8176,2021-10-17 15:00:00+00:00,Worcester,11.0,31928,8.0,29471,,2680,,,32151,34608,61399
8176,8176,8176,8176,8176,8176,8176,8176,8177,2021-10-18 15:00:00+00:00,Worcester,30.0,31958,33.0,29504,3.0,2683,33.0,36.0,32187,34641,61462
8177,8177,8177,8177,8177,8177,8177,8177,8178,2021-10-19 15:00:00+00:00,Worcester,23.0,31981,15.0,29519,1.0,2684,24.0,16.0,32203,34665,61500
8178,8178,8178,8178,8178,8178,8178,8178,8179,2021-10-20 15:00:00+00:00,Worcester,23.0,32004,16.0,29535,,2684,,,32219,34688,61539
8179,8179,8179,8179,8179,8179,8179,8179,8180,2021-10-21 15:00:00+00:00,Worcester,17.0,32021,32.0,29567,4.0,2688,21.0,36.0,32255,34709,61588
8180,8180,8180,8180,8180,8180,8180,8180,8181,2021-10-22 15:00:00+00:00,Worcester,28.0,32049,23.0,29590,,2688,,,32278,34737,61639
8181,8181,8181,8181,8181,8181,8181,8181,8182,2021-10-23 15:00:00+00:00,Worcester,23.0,32072,20.0,29610,,2688,,,32298,34760,61682
8182,8182,8182,8182,8182,8182,8182,8182,8183,2021-10-24 15:00:00+00:00,Worcester,20.0,32092,6.0,29616,,2688,,,32304,34780,61708
8183,8183,8183,8183,8183,8183,8183,8183,8184,2021-10-25 15:00:00+00:00,Worcester,36.0,32128,33.0,29649,5.0,2693,41.0,38.0,32342,34821,61777
8184,8184,8184,8184,8184,8184,8184,8184,8185,2021-10-26 15:00:00+00:00,Worcester,35.0,32163,27.0,29676,,2693,,,32369,34856,61839
8185,8185,8185,8185,8185,8185,8185,8185,8186,2021-10-27 15:00:00+00:00,Worcester,44.0,32207,35.0,29711,2.0,2695,46.0,37.0,32406,34902,61918
8186,8186,8186,8186,8186,8186,8186,8186,8187,2021-10-28 15:00:00+00:00,Worcester,36.0,32243,34.0,29745,3.0,2698,39.0,37.0,32443,34941,61988
8187,8187,8187,8187,8187,8187,8187,8187,8188,2021-10-29 15:00:00+00:00,Worcester,39.0,32282,35.0,29780,,2698,,,32478,34980,62062
8188,8188,8188,8188,8188,8188,8188,8188,8189,2021-10-30 15:00:00+00:00,Worcester,9.0,32291,17.0,29797,,2698,,,32495,34989,62088
8189,8189,8189,8189,8189,8189,8189,8189,8190,2021-10-31 15:00:00+00:00,Worcester,8.0,32299,16.0,29813,,2698,,,32511,34997,62112
8190,8190,8190,8190,8190,8190,8190,8190,8191,2021-11-01 15:00:00+00:00,Worcester,45.0,32344,25.0,29838,2.0,2700,47.0,27.0,32538,35044,62182
8191,8191,8191,8191,8191,8191,8191,8191,8192,2021-11-02 15:00:00+00:00,Worcester,29.0,32373,39.0,29877,3.0,2703,32.0,42.0,32580,35076,62250
8192,8192,8192,8192,8192,8192,8192,8192,8193,2021-11-03 15:00:00+00:00,Worcester,38.0,32411,54.0,29931,3.0,2706,41.0,57.0,32637,35117,62342
8193,8193,8193,8193,8193,8193,8193,8193,8194,2021-11-04 15:00:00+00:00,Worcester,40.0,32451,32.0,29963,1.0,2707,41.0,33.0,32670,35158,62414
8194,8194,8194,8194,8194,8194,8194,8194,8195,2021-11-05 15:00:00+00:00,Worcester,29.0,32480,20.0,29983,6.0,2713,35.0,26.0,32696,35193,62463
8195,8195,8195,8195,8195,8195,8195,8195,8196,2021-11-06 15:00:00+00:00,Worcester,11.0,32491,5.0,29988,,2713,,,32701,35204,62479
8196,8196,8196,8196,8196,8196,8196,8196,8197,2021-06-29 15:00:00+00:00,Prince George's,996.0,430317,1249.0,382554,68.0,27732,1064.0,1317.0,410286,458049,812871
8197,8197,8197,8197,8197,8197,8197,8197,8198,2021-06-30 15:00:00+00:00,Prince George's,1011.0,431328,1267.0,383821,54.0,27786,1065.0,1321.0,411607,459114,815149
8198,8198,8198,8198,8198,8198,8198,8198,8199,2021-07-01 15:00:00+00:00,Prince George's,852.0,432180,1071.0,384892,52.0,27838,904.0,1123.0,412730,460018,817072
8199,8199,8199,8199,8199,8199,8199,8199,8200,2021-07-02 15:00:00+00:00,Prince George's,1020.0,433200,1421.0,386313,62.0,27900,1082.0,1483.0,414213,461100,819513
8200,8200,8200,8200,8200,8200,8200,8200,8201,2021-07-03 15:00:00+00:00,Prince George's,691.0,433891,937.0,387250,37.0,27937,728.0,974.0,415187,461828,821141
8201,8201,8201,8201,8201,8201,8201,8201,8202,2021-07-04 15:00:00+00:00,Prince George's,74.0,433965,43.0,387293,1.0,27938,75.0,44.0,415231,461903,821258
8202,8202,8202,8202,8202,8202,8202,8202,8203,2021-07-05 15:00:00+00:00,Prince George's,712.0,434677,651.0,387944,18.0,27956,730.0,669.0,415900,462633,822621
8203,8203,8203,8203,8203,8203,8203,8203,8204,2021-07-06 15:00:00+00:00,Prince George's,815.0,435492,1266.0,389210,40.0,27996,855.0,1306.0,417206,463488,824702
8204,8204,8204,8204,8204,8204,8204,8204,8205,2021-07-07 15:00:00+00:00,Prince George's,877.0,436369,1201.0,390411,54.0,28050,931.0,1255.0,418461,464419,826780
8205,8205,8205,8205,8205,8205,8205,8205,8206,2021-07-08 15:00:00+00:00,Prince George's,871.0,437240,1171.0,391582,102.0,28152,973.0,1273.0,419734,465392,828822
8206,8206,8206,8206,8206,8206,8206,8206,8207,2021-07-09 15:00:00+00:00,Prince George's,1002.0,438242,1197.0,392779,62.0,28214,1064.0,1259.0,420993,466456,831021
8207,8207,8207,8207,8207,8207,8207,8207,8208,2021-07-10 15:00:00+00:00,Prince George's,733.0,438975,910.0,393689,48.0,28262,781.0,958.0,421951,467237,832664
8208,8208,8208,8208,8208,8208,8208,8208,8209,2021-07-11 15:00:00+00:00,Prince George's,639.0,439614,527.0,394216,48.0,28310,687.0,575.0,422526,467924,833830
8209,8209,8209,8209,8209,8209,8209,8209,8210,2021-07-12 15:00:00+00:00,Prince George's,808.0,440422,941.0,395157,34.0,28344,842.0,975.0,423501,468766,835579
8210,8210,8210,8210,8210,8210,8210,8210,8211,2021-07-13 15:00:00+00:00,Prince George's,1108.0,441530,799.0,395956,36.0,28380,1144.0,835.0,424336,469910,837486
8211,8211,8211,8211,8211,8211,8211,8211,8212,2021-07-14 15:00:00+00:00,Prince George's,962.0,442492,999.0,396955,38.0,28418,1000.0,1037.0,425373,470910,839447
8212,8212,8212,8212,8212,8212,8212,8212,8213,2021-07-15 15:00:00+00:00,Prince George's,1085.0,443577,831.0,397786,36.0,28454,1121.0,867.0,426240,472031,841363
8213,8213,8213,8213,8213,8213,8213,8213,8214,2021-07-16 15:00:00+00:00,Prince George's,989.0,444566,928.0,398714,47.0,28501,1036.0,975.0,427215,473067,843280
8214,8214,8214,8214,8214,8214,8214,8214,8215,2021-07-17 15:00:00+00:00,Prince George's,737.0,445303,712.0,399426,26.0,28527,763.0,738.0,427953,473830,844729
8215,8215,8215,8215,8215,8215,8215,8215,8216,2021-07-18 15:00:00+00:00,Prince George's,477.0,445780,473.0,399899,19.0,28546,496.0,492.0,428445,474326,845679
8216,8216,8216,8216,8216,8216,8216,8216,8217,2021-07-19 15:00:00+00:00,Prince George's,935.0,446715,806.0,400705,28.0,28574,963.0,834.0,429279,475289,847420
8217,8217,8217,8217,8217,8217,8217,8217,8218,2021-07-20 15:00:00+00:00,Prince George's,972.0,447687,843.0,401548,26.0,28600,998.0,869.0,430148,476287,849235
8218,8218,8218,8218,8218,8218,8218,8218,8219,2021-07-21 15:00:00+00:00,Prince George's,885.0,448572,841.0,402389,31.0,28631,916.0,872.0,431020,477203,850961
8219,8219,8219,8219,8219,8219,8219,8219,8220,2021-07-22 15:00:00+00:00,Prince George's,938.0,449510,774.0,403163,17.0,28648,955.0,791.0,431811,478158,852673
8220,8220,8220,8220,8220,8220,8220,8220,8221,2021-07-23 15:00:00+00:00,Prince George's,1285.0,450795,970.0,404133,41.0,28689,1326.0,1011.0,432822,479484,854928
8221,8221,8221,8221,8221,8221,8221,8221,8222,2021-07-24 15:00:00+00:00,Prince George's,859.0,451654,675.0,404808,46.0,28735,905.0,721.0,433543,480389,856462
8222,8222,8222,8222,8222,8222,8222,8222,8223,2021-07-25 15:00:00+00:00,Prince George's,724.0,452378,253.0,405061,13.0,28748,737.0,266.0,433809,481126,857439
8223,8223,8223,8223,8223,8223,8223,8223,8224,2021-07-26 15:00:00+00:00,Prince George's,1228.0,453606,693.0,405754,29.0,28777,1257.0,722.0,434531,482383,859360
8224,8224,8224,8224,8224,8224,8224,8224,8225,2021-07-27 15:00:00+00:00,Prince George's,1185.0,454791,705.0,406459,42.0,28819,1227.0,747.0,435278,483610,861250
8225,8225,8225,8225,8225,8225,8225,8225,8226,2021-07-28 15:00:00+00:00,Prince George's,1308.0,456099,684.0,407143,24.0,28843,1332.0,708.0,435986,484942,863242
8226,8226,8226,8226,8226,8226,8226,8226,8227,2021-07-29 15:00:00+00:00,Prince George's,1167.0,457266,681.0,407824,33.0,28876,1200.0,714.0,436700,486142,865090
8227,8227,8227,8227,8227,8227,8227,8227,8228,2021-07-30 15:00:00+00:00,Prince George's,1517.0,458783,780.0,408604,41.0,28917,1558.0,821.0,437521,487700,867387
8228,8228,8228,8228,8228,8228,8228,8228,8229,2021-07-31 15:00:00+00:00,Prince George's,998.0,459781,620.0,409224,34.0,28951,1032.0,654.0,438175,488732,869005
8229,8229,8229,8229,8229,8229,8229,8229,8230,2021-08-01 15:00:00+00:00,Prince George's,781.0,460562,511.0,409735,10.0,28961,791.0,521.0,438696,489523,870297
8230,8230,8230,8230,8230,8230,8230,8230,8231,2021-08-02 15:00:00+00:00,Prince George's,1161.0,461723,678.0,410413,26.0,28987,1187.0,704.0,439400,490710,872136
8231,8231,8231,8231,8231,8231,8231,8231,8232,2021-08-03 15:00:00+00:00,Prince George's,1196.0,462919,846.0,411259,61.0,29048,1257.0,907.0,440307,491967,874178
8232,8232,8232,8232,8232,8232,8232,8232,8233,2021-08-04 15:00:00+00:00,Prince George's,1192.0,464111,837.0,412096,16.0,29064,1208.0,853.0,441160,493175,876207
8233,8233,8233,8233,8233,8233,8233,8233,8234,2021-08-05 15:00:00+00:00,Prince George's,1236.0,465347,854.0,412950,29.0,29093,1265.0,883.0,442043,494440,878297
8234,8234,8234,8234,8234,8234,8234,8234,8235,2021-08-06 15:00:00+00:00,Prince George's,1418.0,466765,903.0,413853,23.0,29116,1441.0,926.0,442969,495881,880618
8235,8235,8235,8235,8235,8235,8235,8235,8236,2021-08-07 15:00:00+00:00,Prince George's,1084.0,467849,611.0,414464,21.0,29137,1105.0,632.0,443601,496986,882313
8236,8236,8236,8236,8236,8236,8236,8236,8237,2021-08-08 15:00:00+00:00,Prince George's,764.0,468613,437.0,414901,13.0,29150,777.0,450.0,444051,497763,883514
8237,8237,8237,8237,8237,8237,8237,8237,8238,2021-08-09 15:00:00+00:00,Prince George's,1136.0,469749,808.0,415709,16.0,29166,1152.0,824.0,444875,498915,885458
8238,8238,8238,8238,8238,8238,8238,8238,8239,2021-08-10 15:00:00+00:00,Prince George's,1345.0,471094,865.0,416574,29.0,29195,1374.0,894.0,445769,500289,887668
8239,8239,8239,8239,8239,8239,8239,8239,8240,2021-08-11 15:00:00+00:00,Prince George's,1306.0,472400,698.0,417272,36.0,29231,1342.0,734.0,446503,501631,889672
8240,8240,8240,8240,8240,8240,8240,8240,8241,2021-08-12 15:00:00+00:00,Prince George's,1145.0,473545,767.0,418039,20.0,29251,1165.0,787.0,447290,502796,891584
8241,8241,8241,8241,8241,8241,8241,8241,8242,2021-08-13 15:00:00+00:00,Prince George's,1181.0,474726,997.0,419036,37.0,29288,1218.0,1034.0,448324,504014,893762
8242,8242,8242,8242,8242,8242,8242,8242,8243,2021-08-14 15:00:00+00:00,Prince George's,989.0,475715,616.0,419652,22.0,29310,1011.0,638.0,448962,505025,895367
8243,8243,8243,8243,8243,8243,8243,8243,8244,2021-08-15 15:00:00+00:00,Prince George's,648.0,476363,602.0,420254,18.0,29328,666.0,620.0,449582,505691,896617
8244,8244,8244,8244,8244,8244,8244,8244,8245,2021-08-16 15:00:00+00:00,Prince George's,961.0,477324,1040.0,421294,32.0,29360,993.0,1072.0,450654,506684,898618
8245,8245,8245,8245,8245,8245,8245,8245,8246,2021-08-17 15:00:00+00:00,Prince George's,1546.0,478870,986.0,422280,29.0,29389,1575.0,1015.0,451669,508259,901150
8246,8246,8246,8246,8246,8246,8246,8246,8247,2021-08-18 15:00:00+00:00,Prince George's,1298.0,480168,1010.0,423290,24.0,29413,1322.0,1034.0,452703,509581,903458
8247,8247,8247,8247,8247,8247,8247,8247,8248,2021-08-19 15:00:00+00:00,Prince George's,991.0,481159,906.0,424196,22.0,29435,1013.0,928.0,453631,510594,905355
8248,8248,8248,8248,8248,8248,8248,8248,8249,2021-08-20 15:00:00+00:00,Prince George's,1312.0,482471,1245.0,425441,23.0,29458,1335.0,1268.0,454899,511929,907912
8249,8249,8249,8249,8249,8249,8249,8249,8250,2021-08-21 15:00:00+00:00,Prince George's,738.0,483209,733.0,426174,17.0,29475,755.0,750.0,455649,512684,909383
8250,8250,8250,8250,8250,8250,8250,8250,8251,2021-08-22 15:00:00+00:00,Prince George's,595.0,483804,655.0,426829,20.0,29495,615.0,675.0,456324,513299,910633
8251,8251,8251,8251,8251,8251,8251,8251,8252,2021-08-23 15:00:00+00:00,Prince George's,1130.0,484934,965.0,427794,28.0,29523,1158.0,993.0,457317,514457,912728
8252,8252,8252,8252,8252,8252,8252,8252,8253,2021-08-24 15:00:00+00:00,Prince George's,1131.0,486065,1062.0,428856,32.0,29555,1163.0,1094.0,458411,515620,914921
8253,8253,8253,8253,8253,8253,8253,8253,8254,2021-08-25 15:00:00+00:00,Prince George's,1217.0,487282,1008.0,429864,35.0,29590,1252.0,1043.0,459454,516872,917146
8254,8254,8254,8254,8254,8254,8254,8254,8255,2021-08-26 15:00:00+00:00,Prince George's,1174.0,488456,1080.0,430944,33.0,29623,1207.0,1113.0,460567,518079,919400
8255,8255,8255,8255,8255,8255,8255,8255,8256,2021-08-27 15:00:00+00:00,Prince George's,1154.0,489610,1215.0,432159,23.0,29646,1177.0,1238.0,461805,519256,921769
8256,8256,8256,8256,8256,8256,8256,8256,8257,2021-08-28 15:00:00+00:00,Prince George's,1021.0,490631,985.0,433144,29.0,29675,1050.0,1014.0,462819,520306,923775
8257,8257,8257,8257,8257,8257,8257,8257,8258,2021-08-29 15:00:00+00:00,Prince George's,618.0,491249,667.0,433811,3.0,29678,621.0,670.0,463489,520927,925060
8258,8258,8258,8258,8258,8258,8258,8258,8259,2021-08-30 15:00:00+00:00,Prince George's,1057.0,492306,1058.0,434869,15.0,29693,1072.0,1073.0,464562,521999,927175
8259,8259,8259,8259,8259,8259,8259,8259,8260,2021-08-31 15:00:00+00:00,Prince George's,1055.0,493361,1090.0,435959,35.0,29728,1090.0,1125.0,465687,523089,929320
8260,8260,8260,8260,8260,8260,8260,8260,8261,2021-09-01 15:00:00+00:00,Prince George's,1060.0,494421,1063.0,437022,15.0,29743,1075.0,1078.0,466765,524164,931443
8261,8261,8261,8261,8261,8261,8261,8261,8262,2021-09-02 15:00:00+00:00,Prince George's,1073.0,495494,988.0,438010,15.0,29758,1088.0,1003.0,467768,525252,933504
8262,8262,8262,8262,8262,8262,8262,8262,8263,2021-09-03 15:00:00+00:00,Prince George's,1155.0,496649,1139.0,439149,25.0,29783,1180.0,1164.0,468932,526432,935798
8263,8263,8263,8263,8263,8263,8263,8263,8264,2021-09-04 15:00:00+00:00,Prince George's,643.0,497292,818.0,439967,13.0,29796,656.0,831.0,469763,527088,937259
8264,8264,8264,8264,8264,8264,8264,8264,8265,2021-09-05 15:00:00+00:00,Prince George's,649.0,497941,573.0,440540,15.0,29811,664.0,588.0,470351,527752,938481
8265,8265,8265,8265,8265,8265,8265,8265,8266,2021-09-06 15:00:00+00:00,Prince George's,156.0,498097,175.0,440715,8.0,29819,164.0,183.0,470534,527916,938812
8266,8266,8266,8266,8266,8266,8266,8266,8267,2021-09-07 15:00:00+00:00,Prince George's,1093.0,499190,1376.0,442091,30.0,29849,1123.0,1406.0,471940,529039,941281
8267,8267,8267,8267,8267,8267,8267,8267,8268,2021-09-08 15:00:00+00:00,Prince George's,882.0,500072,1012.0,443103,31.0,29880,913.0,1043.0,472983,529952,943175
8268,8268,8268,8268,8268,8268,8268,8268,8269,2021-09-09 15:00:00+00:00,Prince George's,822.0,500894,952.0,444055,20.0,29900,842.0,972.0,473955,530794,944949
8269,8269,8269,8269,8269,8269,8269,8269,8270,2021-09-10 15:00:00+00:00,Prince George's,1051.0,501945,1044.0,445099,24.0,29924,1075.0,1068.0,475023,531869,947044
8270,8270,8270,8270,8270,8270,8270,8270,8271,2021-09-11 15:00:00+00:00,Prince George's,672.0,502617,804.0,445903,18.0,29942,690.0,822.0,475845,532559,948520
8271,8271,8271,8271,8271,8271,8271,8271,8272,2021-09-12 15:00:00+00:00,Prince George's,559.0,503176,589.0,446492,17.0,29959,576.0,606.0,476451,533135,949668
8272,8272,8272,8272,8272,8272,8272,8272,8273,2021-09-13 15:00:00+00:00,Prince George's,759.0,503935,792.0,447284,17.0,29976,776.0,809.0,477260,533911,951219
8273,8273,8273,8273,8273,8273,8273,8273,8274,2021-09-14 15:00:00+00:00,Prince George's,825.0,504760,890.0,448174,20.0,29996,845.0,910.0,478170,534756,952934
8274,8274,8274,8274,8274,8274,8274,8274,8275,2021-09-15 15:00:00+00:00,Prince George's,768.0,505528,926.0,449100,22.0,30018,790.0,948.0,479118,535546,954628
8275,8275,8275,8275,8275,8275,8275,8275,8276,2021-09-16 15:00:00+00:00,Prince George's,714.0,506242,852.0,449952,20.0,30038,734.0,872.0,479990,536280,956194
8276,8276,8276,8276,8276,8276,8276,8276,8277,2021-09-17 15:00:00+00:00,Prince George's,791.0,507033,893.0,450845,23.0,30061,814.0,916.0,480906,537094,957878
8277,8277,8277,8277,8277,8277,8277,8277,8278,2021-09-18 15:00:00+00:00,Prince George's,766.0,507799,862.0,451707,12.0,30073,778.0,874.0,481780,537872,959506
8278,8278,8278,8278,8278,8278,8278,8278,8279,2021-09-19 15:00:00+00:00,Prince George's,515.0,508314,492.0,452199,5.0,30078,520.0,497.0,482277,538392,960513
8279,8279,8279,8279,8279,8279,8279,8279,8280,2021-09-20 15:00:00+00:00,Prince George's,690.0,509004,808.0,453007,15.0,30093,705.0,823.0,483100,539097,962011
8280,8280,8280,8280,8280,8280,8280,8280,8281,2021-09-21 15:00:00+00:00,Prince George's,741.0,509745,893.0,453900,25.0,30118,766.0,918.0,484018,539863,963645
8281,8281,8281,8281,8281,8281,8281,8281,8282,2021-09-22 15:00:00+00:00,Prince George's,772.0,510517,875.0,454775,10.0,30128,782.0,885.0,484903,540645,965292
8282,8282,8282,8282,8282,8282,8282,8282,8283,2021-09-23 15:00:00+00:00,Prince George's,752.0,511269,856.0,455631,17.0,30145,769.0,873.0,485776,541414,966900
8283,8283,8283,8283,8283,8283,8283,8283,8284,2021-09-24 15:00:00+00:00,Prince George's,864.0,512133,981.0,456612,23.0,30168,887.0,1004.0,486780,542301,968745
8284,8284,8284,8284,8284,8284,8284,8284,8285,2021-09-25 15:00:00+00:00,Prince George's,628.0,512761,649.0,457261,12.0,30180,640.0,661.0,487441,542941,970022
8285,8285,8285,8285,8285,8285,8285,8285,8286,2021-09-26 15:00:00+00:00,Prince George's,466.0,513227,568.0,457829,3.0,30183,469.0,571.0,488012,543410,971056
8286,8286,8286,8286,8286,8286,8286,8286,8287,2021-09-27 15:00:00+00:00,Prince George's,903.0,514130,471.0,458300,25.0,30208,928.0,496.0,488508,544338,972430
8287,8287,8287,8287,8287,8287,8287,8287,8288,2021-09-28 15:00:00+00:00,Prince George's,847.0,514977,955.0,459255,17.0,30225,864.0,972.0,489480,545202,974232
8288,8288,8288,8288,8288,8288,8288,8288,8289,2021-09-29 15:00:00+00:00,Prince George's,771.0,515748,872.0,460127,19.0,30244,790.0,891.0,490371,545992,975875
8289,8289,8289,8289,8289,8289,8289,8289,8290,2021-09-30 15:00:00+00:00,Prince George's,905.0,516653,775.0,460902,20.0,30264,925.0,795.0,491166,546917,977555
8290,8290,8290,8290,8290,8290,8290,8290,8291,2021-10-01 15:00:00+00:00,Prince George's,967.0,517620,904.0,461806,22.0,30286,989.0,926.0,492092,547906,979426
8291,8291,8291,8291,8291,8291,8291,8291,8292,2021-10-02 15:00:00+00:00,Prince George's,540.0,518160,518.0,462324,8.0,30294,548.0,526.0,492618,548454,980484
8292,8292,8292,8292,8292,8292,8292,8292,8293,2021-10-03 15:00:00+00:00,Prince George's,434.0,518594,500.0,462824,16.0,30310,450.0,516.0,493134,548904,981418
8293,8293,8293,8293,8293,8293,8293,8293,8294,2021-10-04 15:00:00+00:00,Prince George's,785.0,519379,638.0,463462,11.0,30321,796.0,649.0,493783,549700,982841
8294,8294,8294,8294,8294,8294,8294,8294,8295,2021-10-05 15:00:00+00:00,Prince George's,761.0,520140,719.0,464181,12.0,30333,773.0,731.0,494514,550473,984321
8295,8295,8295,8295,8295,8295,8295,8295,8296,2021-10-06 15:00:00+00:00,Prince George's,683.0,520823,640.0,464821,14.0,30347,697.0,654.0,495168,551170,985644
8296,8296,8296,8296,8296,8296,8296,8296,8297,2021-10-07 15:00:00+00:00,Prince George's,727.0,521550,609.0,465430,12.0,30359,739.0,621.0,495789,551909,986980
8297,8297,8297,8297,8297,8297,8297,8297,8298,2021-10-08 15:00:00+00:00,Prince George's,968.0,522518,696.0,466126,22.0,30381,990.0,718.0,496507,552899,988644
8298,8298,8298,8298,8298,8298,8298,8298,8299,2021-10-09 15:00:00+00:00,Prince George's,598.0,523116,609.0,466735,7.0,30388,605.0,616.0,497123,553504,989851
8299,8299,8299,8299,8299,8299,8299,8299,8300,2021-10-10 15:00:00+00:00,Prince George's,390.0,523506,431.0,467166,4.0,30392,394.0,435.0,497558,553898,990672
8300,8300,8300,8300,8300,8300,8300,8300,8301,2021-10-11 15:00:00+00:00,Prince George's,808.0,524314,606.0,467772,19.0,30411,827.0,625.0,498183,554725,992086
8301,8301,8301,8301,8301,8301,8301,8301,8302,2021-10-12 15:00:00+00:00,Prince George's,731.0,525045,630.0,468402,14.0,30425,745.0,644.0,498827,555470,993447
8302,8302,8302,8302,8302,8302,8302,8302,8303,2021-10-13 15:00:00+00:00,Prince George's,732.0,525777,640.0,469042,14.0,30439,746.0,654.0,499481,556216,994819
8303,8303,8303,8303,8303,8303,8303,8303,8304,2021-10-14 15:00:00+00:00,Prince George's,707.0,526484,661.0,469703,21.0,30460,728.0,682.0,500163,556944,996187
8304,8304,8304,8304,8304,8304,8304,8304,8305,2021-10-15 15:00:00+00:00,Prince George's,762.0,527246,686.0,470389,22.0,30482,784.0,708.0,500871,557728,997635
8305,8305,8305,8305,8305,8305,8305,8305,8306,2021-10-16 15:00:00+00:00,Prince George's,495.0,527741,473.0,470862,10.0,30492,505.0,483.0,501354,558233,998603
8306,8306,8306,8306,8306,8306,8306,8306,8307,2021-10-17 15:00:00+00:00,Prince George's,246.0,527987,354.0,471216,1.0,30493,247.0,355.0,501709,558480,999203
8307,8307,8307,8307,8307,8307,8307,8307,8308,2021-10-18 15:00:00+00:00,Prince George's,776.0,528763,784.0,472000,19.0,30512,795.0,803.0,502512,559275,1000763
8308,8308,8308,8308,8308,8308,8308,8308,8309,2021-10-19 15:00:00+00:00,Prince George's,621.0,529384,633.0,472633,14.0,30526,635.0,647.0,503159,559910,1002017
8309,8309,8309,8309,8309,8309,8309,8309,8310,2021-10-20 15:00:00+00:00,Prince George's,608.0,529992,631.0,473264,25.0,30551,633.0,656.0,503815,560543,1003256
8310,8310,8310,8310,8310,8310,8310,8310,8311,2021-10-21 15:00:00+00:00,Prince George's,596.0,530588,642.0,473906,18.0,30569,614.0,660.0,504475,561157,1004494
8311,8311,8311,8311,8311,8311,8311,8311,8312,2021-10-22 15:00:00+00:00,Prince George's,762.0,531350,859.0,474765,17.0,30586,779.0,876.0,505351,561936,1006115
8312,8312,8312,8312,8312,8312,8312,8312,8313,2021-10-23 15:00:00+00:00,Prince George's,492.0,531842,495.0,475260,20.0,30606,512.0,515.0,505866,562448,1007102
8313,8313,8313,8313,8313,8313,8313,8313,8314,2021-10-24 15:00:00+00:00,Prince George's,334.0,532176,360.0,475620,12.0,30618,346.0,372.0,506238,562794,1007796
8314,8314,8314,8314,8314,8314,8314,8314,8315,2021-10-25 15:00:00+00:00,Prince George's,661.0,532837,833.0,476453,26.0,30644,687.0,859.0,507097,563481,1009290
8315,8315,8315,8315,8315,8315,8315,8315,8316,2021-10-26 15:00:00+00:00,Prince George's,710.0,533547,724.0,477177,25.0,30669,735.0,749.0,507846,564216,1010724
8316,8316,8316,8316,8316,8316,8316,8316,8317,2021-10-27 15:00:00+00:00,Prince George's,656.0,534203,717.0,477894,45.0,30714,701.0,762.0,508608,564917,1012097
8317,8317,8317,8317,8317,8317,8317,8317,8318,2021-10-28 15:00:00+00:00,Prince George's,566.0,534769,757.0,478651,28.0,30742,594.0,785.0,509393,565511,1013420
8318,8318,8318,8318,8318,8318,8318,8318,8319,2021-10-29 15:00:00+00:00,Prince George's,669.0,535438,833.0,479484,33.0,30775,702.0,866.0,510259,566213,1014922
8319,8319,8319,8319,8319,8319,8319,8319,8320,2021-10-30 15:00:00+00:00,Prince George's,421.0,535859,519.0,480003,13.0,30788,434.0,532.0,510791,566647,1015862
8320,8320,8320,8320,8320,8320,8320,8320,8321,2021-10-31 15:00:00+00:00,Prince George's,328.0,536187,338.0,480341,8.0,30796,336.0,346.0,511137,566983,1016528
8321,8321,8321,8321,8321,8321,8321,8321,8322,2021-11-01 15:00:00+00:00,Prince George's,675.0,536862,809.0,481150,34.0,30830,709.0,843.0,511980,567692,1018012
8322,8322,8322,8322,8322,8322,8322,8322,8323,2021-11-02 15:00:00+00:00,Prince George's,693.0,537555,800.0,481950,29.0,30859,722.0,829.0,512809,568414,1019505
8323,8323,8323,8323,8323,8323,8323,8323,8324,2021-11-03 15:00:00+00:00,Prince George's,626.0,538181,705.0,482655,41.0,30900,667.0,746.0,513555,569081,1020836
8324,8324,8324,8324,8324,8324,8324,8324,8325,2021-11-04 15:00:00+00:00,Prince George's,515.0,538696,791.0,483446,18.0,30918,533.0,809.0,514364,569614,1022142
8325,8325,8325,8325,8325,8325,8325,8325,8326,2021-11-05 15:00:00+00:00,Prince George's,679.0,539375,826.0,484272,42.0,30960,721.0,868.0,515232,570335,1023647
8326,8326,8326,8326,8326,8326,8326,8326,8327,2021-11-06 15:00:00+00:00,Prince George's,143.0,539518,205.0,484477,15.0,30975,158.0,220.0,515452,570493,1023995
